id,year,review_score,total_positive,total_negative,total_reviews,Players
220,2004,9,54855,1761,56616,8877286
300,2010,8,9014,937,9951,4419447
380,2006,8,6168,352,6520,3917529
400,2007,9,43124,794,43918,9971481
420,2007,9,11237,495,11732,3281382
500,2008,9,14637,731,15368,4604963
630,2010,9,16119,777,16896,6667813
1200,2006,8,1335,176,1511,849053
1250,2009,9,49902,2286,52188,7395545
1520,2006,8,1875,304,2179,708655
1530,2008,8,337,65,402,180479
1840,2012,8,11458,738,12196,1852569
2450,2010,6,598,179,777,118504
2820,2008,8,1523,239,1762,482728
2870,2013,5,2632,3838,6470,343046
3540,2008,8,315,20,335,181811
3590,2009,9,11809,297,12106,1647028
3620,2009,8,367,20,387,75495
3830,2006,9,7378,376,7754,1207186
4920,2012,8,7798,1337,9135,1993899
6120,2010,8,1551,186,1737,312665
6600,2007,5,36,32,68,41006
7520,2011,5,2754,1849,4603,703263
8190,2010,8,29030,2534,31564,4161156
8850,2010,8,7815,831,8646,1558279
8870,2013,9,69661,3237,72898,4563627
8970,2010,6,31,12,43,8860
9500,2007,5,153,91,244,176440
9880,2011,6,1883,701,2584,1691316
9970,2011,3,5,24,29,5660
10180,2009,8,26250,2398,28648,5267226
10220,2012,4,525,919,1444,84486
10500,2009,8,13232,1263,14495,3491439
10680,2010,8,8114,981,9095,1231126
11240,2008,5,287,295,582,68979
11280,2008,8,811,113,924,88249
11330,2009,8,548,120,668,65629
11340,2009,6,493,149,642,57562
12900,2008,9,8586,351,8937,1561882
13000,2008,8,48,4,52,19566
13140,2009,5,1457,679,2136,3014457
13210,2009,8,2179,229,2408,902895
15400,2009,8,85,20,105,34113
15500,2008,6,393,135,528,90431
15520,2009,8,551,98,649,148747
15560,2011,6,714,228,942,156626
15620,2009,8,5238,654,5892,2492053
15740,2010,6,376,131,507,108580
15750,2010,8,682,117,799,153101
16500,2008,7,10,1,11,3261
16600,2008,8,165,33,198,118998
17100,2008,8,161,31,192,48123
17120,2008,8,47,10,57,25293
17140,2008,6,109,36,145,29581
17180,2008,6,15,6,21,5953
17500,2008,8,4607,715,5322,2573292
17570,2010,8,3306,471,3777,1077057
17580,2009,8,680,131,811,410346
17710,2011,6,1575,404,1979,640448
17740,2008,8,586,89,675,174440
18000,2008,8,385,40,425,161617
18020,2008,8,116,20,136,64438
18040,2010,8,504,29,533,91932
18050,2010,8,120,18,138,30765
18070,2011,8,145,36,181,52893
18500,2008,9,3268,104,3372,558114
18600,2009,5,12,10,22,4016
18700,2009,5,727,313,1040,324236
18820,2010,8,612,149,761,795021
19020,2010,5,15,7,22,7589
19030,2010,6,64,18,82,9999
19200,2008,5,214,177,391,39071
19320,2012,5,6,7,13,2751
19500,2008,4,12,46,58,6247
20200,2008,4,6,10,16,5171
20500,2009,8,5896,620,6516,1010775
20570,2010,8,1537,137,1674,1285276
20700,2008,6,48,15,63,14750
20710,2008,8,55,11,66,31070
20820,2010,8,962,61,1023,255073
20920,2012,8,31185,3823,35008,4585616
21100,2011,6,4782,1800,6582,1096875
21300,2008,6,16,5,21,14840
21400,2008,5,9,5,14,7785
21640,2009,6,108,33,141,29726
21690,2009,8,7310,1211,8521,1005089
22000,2008,8,3180,204,3384,986510
22200,2009,8,1876,328,2204,320458
22230,2011,8,2419,210,2629,636120
22310,2009,5,368,209,577,44059
22350,2011,5,3049,2033,5082,1700604
22380,2010,9,55309,2336,57645,5222533
22500,2009,8,125,16,141,20588
22600,2010,8,2278,384,2662,1289109
22610,2010,6,687,272,959,199888
22650,2010,5,432,204,636,157346
22670,2010,6,207,75,282,57440
23150,2010,6,12,5,17,3440
23530,2011,8,702,69,771,87316
24200,2011,8,8966,2239,11205,2863993
24240,2011,8,31919,2223,34142,4944712
24420,2008,8,975,121,1096,163102
24480,2012,5,172,156,328,98328
25700,2009,8,183,39,222,281079
26000,2009,8,153,33,186,42072
26300,2009,4,11,29,40,7562
26500,2009,8,646,81,727,377806
26800,2009,8,6137,354,6491,1012406
27330,2010,4,123,193,316,60463
27600,2009,7,21,2,23,1938
27920,2010,5,87,91,178,227125
27940,2011,4,196,398,594,99822
28000,2010,5,2271,1480,3751,448371
29180,2009,8,820,98,918,413551
31280,2010,8,5506,833,6339,952378
31700,2008,8,304,51,355,74779
31980,2009,5,12,8,20,8543
32150,2009,8,299,6,305,19656
32160,2009,8,215,38,253,33774
32200,2009,5,76,44,120,34954
32410,2009,6,37,15,52,19433
32460,2010,9,1082,49,1131,288297
33390,2011,6,24,7,31,6783
33650,2010,8,284,38,322,35897
33660,2010,6,21,8,29,4418
33670,2010,5,161,123,284,86037
33680,2010,8,904,81,985,52081
33930,2010,8,16375,1305,17680,4514397
33980,2010,5,74,44,118,13367
34030,2010,8,7309,621,7930,2178916
34270,2010,8,1267,305,1572,1514485
34500,2009,7,31,7,38,10161
34830,2010,5,1759,1374,3133,934745
34870,2013,6,5362,2096,7458,1089080
34900,2009,6,9475,2723,12198,476787
34920,2010,4,47,149,196,23507
35130,2010,8,2309,194,2503,550882
35140,2010,9,17684,659,18343,2240464
35320,2012,8,292,58,350,28646
35450,2011,8,24118,1958,26076,3501161
35460,2010,6,578,192,770,186933
35480,2011,6,569,156,725,202488
35600,2009,5,43,35,78,16686
35700,2009,9,8516,351,8867,1604101
35720,2013,9,14968,588,15556,2791654
36000,2009,5,176,103,279,72409
37500,2009,6,32,9,41,10680
37800,2009,5,25,12,37,35950
38230,2010,5,54,77,131,36667
38600,2010,8,2071,192,2263,214039
38700,2010,8,1562,210,1772,352195
38720,2010,8,996,111,1107,248133
39110,2010,6,145,39,184,24628
39140,2013,8,10623,755,11378,1136100
39150,2013,8,4876,559,5435,581505
39160,2011,5,992,634,1626,638566
39800,2009,8,1944,247,2191,877968
40100,2010,8,4738,781,5519,1048307
40390,2012,6,2681,785,3466,713807
40400,2009,8,956,168,1124,371287
40420,2010,5,126,63,189,60328
40700,2009,9,4544,211,4755,609675
40800,2010,9,21448,1041,22489,2970487
40930,2010,8,319,38,357,127810
41000,2009,8,3374,220,3594,1025064
41070,2011,8,13693,1671,15364,2029621
41300,2009,8,1436,106,1542,1321782
41740,2011,6,252,64,316,37887
41900,2009,6,586,168,754,158667
42000,2011,5,8,5,13,3829
42120,2010,6,1293,470,1763,1107457
42140,2011,5,167,79,246,61329
42170,2012,5,412,309,721,179546
42500,2010,5,229,141,370,176883
42700,2010,8,12481,1532,14013,3759377
42910,2011,8,19454,1409,20863,4976290
42990,2012,5,323,425,748,108612
43000,2010,5,432,290,722,134789
43190,2011,8,464,69,533,69196
43600,2010,7,36,4,40,13164
44100,2010,8,73,9,82,35059
45000,2010,8,286,29,315,405082
45100,2010,8,1273,248,1521,145021
45300,2010,5,299,131,430,156274
45400,2010,8,764,66,830,87234
45410,2011,5,142,107,249,36605
45450,2011,8,442,42,484,71018
45730,2010,5,123,127,250,23630
45740,2010,6,2294,783,3077,627795
45770,2011,6,1142,315,1457,263656
46000,2010,6,71,29,100,50047
46450,2010,5,202,127,329,93777
46520,2011,5,158,117,275,32134
46570,2011,5,96,79,175,33667
46600,2010,6,39,12,51,21596
46770,2010,6,185,55,240,34741
47000,2010,8,524,85,609,38574
47540,2010,8,250,49,299,73522
48000,2011,8,27176,1657,28833,3207480
48700,2010,9,64072,1698,65770,4219791
48720,2011,8,5157,796,5953,1231509
48950,2010,8,392,61,453,167621
49300,2010,5,57,66,123,56215
49320,2010,5,29,25,54,16197
49330,2011,5,75,43,118,43817
49470,2011,8,720,93,813,377401
49600,2010,9,6028,292,6320,601573
49810,2011,8,105,23,128,16752
49900,2010,5,178,78,256,149111
50000,2010,8,180,10,190,39982
50130,2011,8,26419,1541,27960,2312872
50510,2010,5,57,85,142,58147
50620,2010,8,8038,906,8944,1683431
51060,2011,8,73,11,84,10000
55020,2010,5,39,28,67,11879
55040,2011,8,1385,164,1549,316352
55100,2011,5,4496,3003,7499,1182312
55110,2011,6,2451,886,3337,785298
55140,2010,8,1427,316,1743,307610
55150,2011,8,7279,574,7853,1099682
55230,2011,9,38409,1416,39825,5143189
57000,2010,8,83,9,92,24562
57200,2010,8,395,37,432,77794
57300,2010,8,17767,958,18725,2609222
57680,2011,6,421,177,598,56157
57690,2011,8,8081,724,8805,2000449
57700,2011,6,97,39,136,20891
57800,2010,5,73,86,159,62506
57900,2011,5,4097,2017,6114,886514
58200,2010,8,247,30,277,49520
58230,2012,8,79,15,94,26568
58400,2010,4,42,80,122,33305
58550,2011,4,192,399,591,168535
58610,2012,6,1766,510,2276,621393
60350,2011,8,67,9,76,14082
60600,2010,5,27,21,48,16997
60700,2010,4,9,25,34,6871
61100,2011,6,163,51,214,46438
61600,2010,8,415,58,473,114745
61700,2011,8,1191,108,1299,309591
61730,2012,8,245,13,258,32972
62000,2010,8,407,33,440,108722
62100,2010,8,581,38,619,106325
63000,2011,8,648,159,807,239813
63200,2011,6,709,192,901,708500
63700,2010,8,600,140,740,267116
63710,2011,8,2921,457,3378,647721
63940,2011,5,347,211,558,131229
64000,2011,8,2609,351,2960,409681
65300,2012,8,1519,197,1716,2490746
65400,2010,8,85,17,102,13158
65710,2010,8,253,48,301,17001
65800,2011,8,10202,847,11049,2483252
67000,2010,6,334,106,440,154963
67370,2012,8,9732,1009,10741,1145131
70000,2011,8,11018,2113,13131,2364083
70120,2011,4,157,282,439,118551
70300,2010,9,6175,233,6408,763558
70500,2010,6,31,12,43,14906
70600,2011,8,1760,235,1995,486841
70620,2011,8,360,79,439,132903
71230,2011,8,860,215,1075,148830
71240,2011,8,260,50,310,58500
71250,2011,8,2210,440,2650,291205
71260,2011,8,495,71,566,51418
71340,2011,8,5887,434,6321,647871
72000,2012,8,649,94,743,192454
72200,2011,8,2203,489,2692,752402
72400,2010,6,219,66,285,97328
72500,2010,5,35,38,73,8589
72900,2010,5,132,73,205,39498
73010,2011,6,576,161,737,237970
73060,2012,4,32,64,96,24228
78000,2010,9,2373,99,2472,295211
80000,2011,4,44,109,153,45758
80200,2011,6,258,65,323,81723
80310,2011,8,1141,114,1255,130615
80330,2012,8,789,96,885,79474
80340,2012,8,322,21,343,52347
80350,2012,8,258,14,272,49385
80360,2012,8,282,10,292,46844
90200,2010,8,312,54,366,99303
90500,2010,5,61,89,150,43341
91100,2011,8,725,87,812,120532
91200,2011,8,3132,420,3552,567765
91600,2011,8,2469,271,2740,2088528
91700,2011,8,4113,795,4908,768052
91800,2011,8,68,8,76,11099
91810,2011,6,19,7,26,7392
92000,2011,5,1241,776,2017,186396
92100,2011,5,1034,611,1645,341194
92200,2011,8,117,7,124,28454
92210,2011,8,130,25,155,26273
92220,2011,8,113,21,134,31444
92300,2011,6,561,236,797,107351
92600,2011,6,123,39,162,36670
92800,2011,8,3525,300,3825,682706
93200,2011,8,807,143,950,340794
94200,2011,9,1935,100,2035,413206
95000,2013,6,114,34,148,54626
95300,2011,6,682,195,877,246235
95900,2011,5,153,99,252,48356
96800,2012,5,165,95,260,404730
96900,2013,5,21,16,37,17482
97000,2011,8,1484,150,1634,339780
97330,2012,8,906,114,1020,452484
98200,2011,8,1952,399,2351,1065406
98300,2012,8,968,101,1069,213463
98400,2012,8,2970,548,3518,335265
98600,2011,8,196,49,245,88003
98800,2011,8,3799,218,4017,554550
98900,2011,5,126,75,201,15773
99100,2011,4,96,269,365,114696
99120,2011,5,30,18,48,3388
99200,2011,8,97,10,107,16240
99300,2011,8,1628,261,1889,297463
99400,2011,5,146,158,304,28250
99700,2011,8,713,93,806,223790
99900,2011,8,13847,2717,16564,5226655
99910,2011,8,922,212,1134,469196
102200,2011,6,251,76,327,72893
102400,2011,5,20,9,29,14275
102600,2011,9,5168,154,5322,1105153
102810,2011,8,81,18,99,24340
104000,2011,6,142,45,187,56863
104020,2012,6,87,35,122,18474
104900,2013,6,20385,6841,27226,4419554
105000,2012,6,898,291,1189,108523
105300,2011,6,282,73,355,67693
105420,2013,6,154,42,196,25827
105700,2011,5,70,47,117,31754
105800,2012,8,536,127,663,154398
107100,2011,9,25848,899,26747,2577876
107200,2011,8,2296,178,2474,753148
107410,2013,8,89908,9762,99670,6404450
107800,2011,8,1416,124,1540,211829
108200,2012,8,1262,227,1489,295151
108210,2011,5,169,100,269,163923
108500,2012,8,515,66,581,150153
108700,2012,6,357,147,504,370163
108710,2012,8,19943,1754,21697,1804210
109700,2011,5,53,30,83,11021
110500,2011,5,51,24,75,11517
110600,2011,5,27,26,53,10550
110610,2011,6,47,17,64,9532
110630,2012,5,23,15,38,6409
110800,2011,8,12349,1856,14205,1596369
111100,2012,8,340,75,415,89897
111300,2011,6,21,8,29,5726
111400,2011,5,181,199,380,160728
111600,2011,8,476,77,553,138384
111800,2011,6,536,148,684,210782
111900,2013,4,271,991,1262,205359
112100,2011,8,321,70,391,120153
113020,2013,8,6583,653,7236,2153213
113200,2011,9,40199,1673,41872,7172818
113400,2011,5,17657,10053,27710,5874946
113420,2012,5,3637,2788,6425,2139999
115100,2011,8,2459,177,2636,341308
115110,2012,8,1187,135,1322,248039
115120,2012,8,510,108,618,109286
116120,2011,6,106,28,134,23805
200010,2012,8,1107,196,1303,215834
200020,2011,5,116,169,285,19246
200130,2011,6,145,45,190,22225
200170,2012,8,3428,597,4025,1730275
200190,2011,5,65,39,104,24241
200210,2012,8,20195,3857,24052,3757613
200260,2012,9,22372,994,23366,2467996
200370,2012,5,266,154,420,81571
200410,2012,5,45,45,90,28307
200550,2011,4,60,102,162,74874
200710,2012,8,27172,1507,28679,4963949
200900,2011,9,4698,217,4915,590104
200910,2011,8,1095,165,1260,150501
200940,2012,8,1918,197,2115,241011
201420,2013,8,620,119,739,147483
201510,2011,1,236,1662,1898,126375
201570,2012,6,1366,430,1796,355611
202070,2012,8,178,37,215,32935
202130,2013,5,171,199,370,83551
202310,2012,5,476,400,876,133909
202370,2012,5,31,20,51,8726
202410,2012,8,103,20,123,28405
202530,2012,5,530,609,1139,144813
202730,2012,8,334,54,388,63976
202750,2012,6,3171,1257,4428,521355
202970,2012,8,22831,3964,26795,2998561
203140,2012,8,19955,2076,22031,2805822
203160,2013,9,77826,3230,81056,5495033
203210,2012,8,759,72,831,98665
203290,2013,6,5651,1655,7306,1823295
203350,2012,8,653,138,791,163165
203560,2012,8,197,44,241,29542
203650,2012,6,558,165,723,83454
203750,2012,8,3971,637,4608,306463
203770,2012,8,24221,3111,27332,3170312
203830,2012,8,1123,172,1295,188342
203990,2011,8,196,22,218,32140
204060,2012,6,1705,444,2149,439828
204100,2012,8,19080,3783,22863,1740909
204220,2012,6,155,63,218,108508
204240,2013,8,2636,331,2967,320817
204360,2012,9,42208,1596,43804,5555066
204440,2012,8,110,24,134,15198
204580,2012,7,21,4,25,4536
204760,2012,4,50,137,187,7091
204840,2012,5,47,48,95,21722
204860,2012,5,164,84,248,62294
204880,2012,8,7007,480,7487,1092043
205060,2012,5,63,47,110,32433
205070,2012,6,49,18,67,27186
205080,2013,5,62,39,101,28966
205100,2012,9,36528,1046,37574,3700352
205230,2012,8,2490,385,2875,415904
205530,2012,5,46,35,81,40835
205610,2012,5,422,186,608,203151
205650,2012,8,1399,249,1648,188089
205690,2012,6,220,60,280,22579
205730,2012,8,520,70,590,112625
205810,2012,5,103,69,172,53980
205830,2012,8,169,14,183,15944
205910,2012,8,3255,273,3528,360126
205950,2012,8,2892,517,3409,533153
206190,2013,9,9542,233,9775,702654
206210,2012,8,8363,1511,9874,2982059
206230,2012,5,24,15,39,2259
206370,2012,8,506,52,558,78881
206420,2013,8,47037,3961,50998,5275914
206440,2012,9,37990,1214,39204,1086773
206690,2012,8,402,80,482,102379
207000,2013,5,78,50,128,13444
207020,2012,6,293,75,368,37217
207040,2012,8,724,156,880,137200
207080,2012,8,1455,115,1570,184842
207170,2012,8,4305,239,4544,762137
207190,2012,5,64,64,128,15159
207250,2012,6,326,120,446,145843
207420,2012,6,512,214,726,148590
207430,2012,5,326,318,644,125071
207610,2012,9,40968,1341,42309,2846244
207670,2012,5,27,34,61,11525
207690,2012,9,3241,110,3351,330330
207710,2012,5,24,15,39,4400
207730,2012,4,123,246,369,36181
207750,2012,8,1104,193,1297,149580
207930,2013,5,592,255,847,160193
208140,2012,8,5361,1269,6630,1549005
208200,2012,8,3448,680,4128,604250
208400,2012,8,617,48,665,76233
208460,2012,4,11,35,46,12183
208520,2013,5,956,581,1537,275454
208580,2012,8,7015,800,7815,1529038
208600,2012,8,452,87,539,97537
208620,2012,5,52,27,79,13565
208630,2012,6,51,14,65,11789
208640,2012,7,44,5,49,11140
208670,2012,8,1213,283,1496,151143
208710,2012,5,23,10,33,6328
208730,2012,6,1339,544,1883,272599
209000,2013,8,17958,2944,20902,1851868
209080,2012,8,11778,1031,12809,2424726
209230,2012,8,184,37,221,18909
209330,2012,5,258,167,425,130087
209360,2012,6,39,12,51,14751
209370,2012,8,1795,116,1911,111483
209390,2012,4,15,50,65,17225
209610,2012,5,58,46,104,15167
209630,2013,8,239,42,281,21062
209670,2012,5,2479,1149,3628,841552
209690,2012,5,119,76,195,54947
209730,2012,5,265,290,555,122753
209790,2012,8,456,56,512,123113
209850,2013,5,31,18,49,9382
209870,2012,6,11300,3699,14999,4268464
209950,2012,8,546,50,596,58044
210170,2012,6,137,54,191,81780
210490,2012,3,1,47,48,5183
210770,2013,8,10689,1112,11801,2602292
210870,2013,8,159,15,174,24244
210950,2012,8,487,35,522,45117
211160,2012,5,755,907,1662,300593
211180,2012,8,355,26,381,41357
211260,2012,8,1828,286,2114,215520
211280,2013,5,165,117,282,39209
211340,2012,8,749,86,835,65990
211360,2012,8,430,89,519,147698
211400,2012,8,8581,2134,10715,795749
211420,2012,8,59608,5624,65232,3289250
211440,2012,8,907,142,1049,102718
211580,2012,5,239,221,460,178229
211800,2012,6,88,29,117,23741
212010,2012,6,965,336,1301,144458
212030,2012,6,761,195,956,87591
212050,2012,8,335,28,363,37904
212070,2013,6,7738,2335,10073,1960641
212110,2012,6,134,47,181,33044
212480,2013,9,9416,493,9909,1232451
212700,2012,5,92,86,178,46642
212780,2012,5,183,101,284,24499
213610,2012,8,3814,658,4472,416375
213650,2012,8,1229,202,1431,720104
213850,2013,8,3492,746,4238,945492
214100,2012,5,27,25,52,13942
214130,2012,5,82,45,127,14219
214340,2012,8,6368,709,7077,743347
214360,2012,6,1138,409,1547,393962
214510,2012,8,3107,320,3427,582228
214570,2012,6,175,51,226,42020
214590,2012,8,838,131,969,99774
214630,2012,5,123,90,213,39096
214730,2013,9,2903,141,3044,168841
214770,2013,8,4607,299,4906,538061
214790,2012,8,736,128,864,246622
214830,2012,8,1083,157,1240,309617
214870,2012,6,1997,602,2599,625428
214910,2012,5,159,189,348,61698
214950,2013,6,27397,7235,34632,3350407
214970,2012,8,893,173,1066,175830
215390,2012,5,6,6,12,3445
215470,2012,6,4027,1167,5194,731052
215510,2012,6,1912,503,2415,286849
215530,2013,8,4786,966,5752,726646
215630,2013,5,442,214,656,86817
215670,2012,5,1013,480,1493,183321
215690,2013,6,719,231,950,146186
215710,2013,8,259,53,312,51792
215770,2012,5,50,42,92,17947
215870,2013,5,143,212,355,229648
216090,2013,8,326,18,344,27792
216110,2012,8,644,152,796,81320
216130,2012,4,28,97,125,28943
216290,2012,8,165,13,178,20286
216890,2012,8,1074,255,1329,253538
216910,2012,6,791,304,1095,128256
217100,2013,5,391,446,837,50745
217140,2013,5,1351,617,1968,272986
217270,2012,6,120,47,167,14384
217290,2012,8,123,21,144,19651
217690,2013,5,836,445,1281,163293
217790,2012,6,348,138,486,68917
218060,2013,8,2447,203,2650,358624
218410,2012,9,2571,85,2656,179979
218510,2012,6,381,163,544,325744
218640,2012,8,4934,1180,6114,596725
218660,2012,6,107,27,134,20457
218680,2012,8,5742,460,6202,1296525
218740,2012,8,1894,333,2227,278689
219150,2012,9,39104,959,40063,2584720
219190,2013,8,512,54,566,66302
219200,2013,8,253,49,302,61886
219340,2013,6,553,182,735,346032
219640,2012,8,46448,9497,55945,8260157
219830,2013,8,2743,547,3290,348064
219910,2012,8,1456,135,1591,219442
219950,2012,8,465,65,530,63403
220260,2013,8,3769,342,4111,590518
220440,2013,8,12340,704,13044,987543
220460,2012,8,601,132,733,102678
220740,2012,8,1228,106,1334,249600
220780,2012,8,7140,390,7530,581719
220820,2012,8,1883,340,2223,228360
220900,2013,5,203,121,324,58672
221040,2013,8,12281,3024,15305,1317100
221380,2013,8,45226,2622,47848,5824316
221640,2012,9,18102,542,18644,1045138
221810,2013,8,1528,231,1759,271663
221830,2012,8,244,46,290,40059
222140,2012,6,303,113,416,99411
222480,2013,8,4238,771,5009,503330
222640,2013,6,445,131,576,50924
222660,2013,8,277,44,321,49592
222730,2013,8,3340,808,4148,897320
222940,2013,8,3772,468,4240,456361
223000,2012,8,139,23,162,13944
223220,2012,6,1192,301,1493,335909
223330,2012,6,824,236,1060,41558
223430,2012,4,104,200,304,58437
223450,2013,6,162,46,208,24535
223470,2012,9,29051,1427,30478,1911217
223510,2012,6,695,195,890,92256
223730,2012,8,365,57,422,75324
223810,2013,8,964,119,1083,140737
224260,2013,8,42230,4850,47080,7144320
224460,2013,8,3661,374,4035,182422
224760,2013,8,9685,816,10501,1276275
224820,2013,9,1184,43,1227,126909
224860,2013,4,222,463,685,112755
224900,2012,5,293,212,505,241819
225080,2013,9,29593,1509,31102,1056557
225160,2013,8,1601,126,1727,278226
225260,2013,8,11241,748,11989,1235714
225360,2013,5,410,445,855,79909
225420,2013,5,1040,793,1833,451407
226620,2013,8,993,92,1085,122321
226720,2013,5,1441,909,2350,279675
226780,2013,5,35,41,76,9808
226820,2013,8,53,4,57,10960
227000,2012,9,1643,38,1681,83704
227020,2013,5,177,133,310,66332
227080,2013,8,2296,147,2443,127734
227100,2013,8,2962,391,3353,577105
227180,2013,5,1556,759,2315,359640
227200,2012,8,877,104,981,84676
227220,2013,8,1413,188,1601,193849
227300,2012,9,133355,3620,136975,5982548
227380,2013,6,288,75,363,50466
227400,2013,5,313,302,615,219519
227480,2013,6,1576,669,2245,322132
227580,2013,8,1481,172,1653,132502
227600,2013,8,1136,109,1245,123527
227800,2013,6,114,39,153,100395
228280,2013,8,3652,593,4245,745407
228300,2013,8,8042,1523,9565,587213
228320,2013,5,88,91,179,56578
228400,2013,5,2482,1772,4254,527228
228440,2013,6,131,53,184,60640
228960,2013,8,448,54,502,121166
229480,2013,8,694,160,854,169249
229520,2013,5,306,173,479,77010
229890,2013,8,61,12,73,22281
230050,2013,8,5099,665,5764,425947
230150,2013,6,219,86,305,64688
230650,2013,5,112,130,242,41411
230700,2013,8,1349,285,1634,193073
231020,2013,6,62,25,87,13973
231160,2013,9,5330,210,5540,484015
231310,2013,5,259,165,424,58523
231330,2013,6,1309,497,1806,252514
231430,2013,6,27036,8955,35991,4654955
231720,2013,4,118,232,350,46803
231740,2013,8,2148,395,2543,342008
231910,2013,8,312,78,390,56138
232050,2013,5,1187,582,1769,595663
232430,2013,6,11281,3367,14648,538219
232750,2013,6,1299,470,1769,191401
232770,1997,8,1965,436,2401,258861
232950,2013,5,309,323,632,110174
232970,2013,8,355,57,412,46979
233110,2013,4,58,90,148,19264
233130,2013,8,16645,1170,17815,1648323
233190,2013,8,678,123,801,131849
233210,2013,4,54,157,211,20857
233230,2013,6,1055,357,1412,107362
233310,2013,8,101,17,118,19579
233470,2013,8,4184,822,5006,431669
233510,2009,5,101,53,154,30085
233550,2013,8,1083,209,1292,89421
233700,2013,8,1003,149,1152,192814
233720,2013,8,10068,2097,12165,1879150
233740,2013,8,2031,258,2289,359935
233840,2013,6,1519,498,2017,840770
234080,2013,8,3425,805,4230,379043
234160,2013,8,425,70,495,133318
234290,2013,5,239,129,368,46491
234390,2013,8,2015,329,2344,453247
234490,2013,5,515,325,840,120088
234670,2013,8,7542,769,8311,671888
234710,2013,8,4157,735,4892,671540
234820,2013,6,169,70,239,9892
234900,2013,8,799,148,947,117410
234940,2013,6,899,279,1178,162206
235070,2013,5,128,102,230,12329
235250,2013,8,1214,155,1369,154250
235360,2013,6,634,190,824,94101
235720,2013,6,311,96,407,53469
235820,2013,8,476,94,570,66045
235980,2013,8,350,10,360,32924
236090,2013,9,14207,554,14761,943681
236290,2013,6,19,5,24,2893
236370,2013,5,4198,2715,6913,1140120
236390,2013,8,67266,16297,83563,9536732
236450,2013,9,5481,262,5743,1102937
236490,2013,5,16,12,28,5199
236730,2013,8,445,99,544,147089
236790,2013,4,136,464,600,49982
236850,2013,8,31870,6296,38166,1983657
237370,2013,6,252,106,358,14572
237430,2013,8,835,188,1023,130612
237470,2013,5,148,73,221,36396
237550,2013,5,157,130,287,34258
237630,2013,8,2897,462,3359,255766
237740,2013,8,2231,271,2502,137144
237760,2013,8,330,25,355,29074
238010,2013,8,10996,981,11977,1358070
238260,2013,6,2046,728,2774,555716
238280,2013,6,1028,359,1387,208032
238320,2013,9,38528,1565,40093,2813619
238430,2013,6,8427,3205,11632,1616994
238530,2013,8,340,31,371,37103
238630,2013,6,174,58,232,31943
238870,2013,2,59,341,400,36837
238890,2013,5,119,154,273,73154
238910,2013,6,623,203,826,215330
238960,2013,8,53700,4554,58254,7634137
239030,2013,9,21692,888,22580,2306775
239070,2013,8,4750,512,5262,957659
239090,2013,8,318,20,338,23969
239200,2013,5,3561,1832,5393,554955
239350,2013,8,7501,704,8205,906689
239660,2013,6,1543,393,1936,552866
239700,2013,8,425,65,490,38130
239720,2013,8,111,25,136,10365
239800,2013,8,1517,109,1626,118588
239820,2013,9,23837,1125,24962,1696896
240340,2013,8,72,7,79,6999
240360,2013,7,40,9,49,5436
240600,2013,6,359,136,495,46800
240660,2013,5,100,43,143,7998
241320,2013,8,885,60,945,84014
241410,2013,8,1066,120,1186,169190
241540,2013,8,14475,2620,17095,1083514
241600,2013,8,12925,803,13728,1479581
241720,2013,5,554,572,1126,119191
241910,2013,8,1161,144,1305,168319
242110,2013,5,192,139,331,138895
242530,2013,5,187,103,290,54172
242700,2013,8,7907,1259,9166,1279176
242780,2013,8,468,86,554,54814
242820,2013,8,3040,203,3243,136754
243200,2013,8,1165,117,1282,186812
243280,2013,6,145,39,184,26669
243450,2013,8,1094,251,1345,144452
243780,2013,6,583,173,756,142088
243800,2013,8,2232,342,2574,225513
243950,2013,6,1174,368,1542,265816
244050,2013,5,644,547,1191,202778
244070,2013,5,371,164,535,159001
244090,2013,5,195,109,304,126366
244690,2013,5,148,67,215,41186
244730,2013,8,1328,241,1569,201978
244810,2013,8,454,98,552,84629
244870,2013,8,2824,273,3097,192896
244890,2013,6,129,37,166,33398
245170,2013,8,12074,735,12809,1621794
245280,2013,8,3304,582,3886,242618
245470,2013,6,4074,1377,5451,688243
246300,2013,5,266,145,411,32036
246580,2013,8,2175,318,2493,244364
246840,2013,8,755,68,823,82615
246960,2013,8,245,47,292,66040
247020,2013,8,3916,208,4124,384598
247140,2013,8,526,50,576,51526
247240,2013,8,1588,356,1944,203278
247310,2013,5,34,49,83,18258
247370,2013,6,292,99,391,47605
247660,2013,5,1823,812,2635,149712
247870,2013,5,147,208,355,28391
247910,2013,8,2832,493,3325,485909
248190,2013,8,259,38,297,47072
248290,2013,5,211,93,304,27168
248410,2013,4,74,187,261,22483
248450,2013,5,133,75,208,21683
248470,2013,5,334,171,505,60783
248550,2013,8,792,88,880,72851
248630,2013,5,455,559,1014,55436
248650,2013,6,719,227,946,132320
248710,2013,4,179,433,612,39151
248730,2013,8,285,63,348,17686
248800,2013,6,585,173,758,30160
248820,2013,8,20449,1261,21710,1825993
248970,2013,8,484,79,563,36519
249130,2013,8,7658,548,8206,991243
249330,2013,8,1061,121,1182,142244
249360,2013,5,268,121,389,39750
249590,2013,8,1294,187,1481,136458
249680,2013,8,1608,131,1739,68424
249870,2013,8,1107,220,1327,226289
249990,2013,6,1726,569,2295,603718
250320,2013,9,19561,472,20033,1011210
250340,2013,6,3083,1219,4302,226915
250380,2013,8,825,124,949,70847
250460,2013,6,763,249,1012,247455
250660,2013,5,198,96,294,23337
251410,2013,5,73,103,176,17359
251430,2013,8,510,35,545,56620
251530,2013,6,388,100,488,95497
251570,2013,8,51025,10923,61948,4184553
251690,2013,5,323,177,500,78056
251830,2013,9,517,26,543,26673
251850,2013,6,449,129,578,45793
251910,2013,6,200,61,261,74075
251990,2013,8,5307,281,5588,369384
252030,2013,8,1828,300,2128,163754
252170,2013,8,227,53,280,65310
252270,2013,5,150,85,235,40491
252310,2013,8,514,88,602,72227
252330,2013,8,3705,470,4175,354224
252370,2013,8,428,94,522,38128
252410,2013,8,3741,273,4014,367286
252630,2013,8,1407,189,1596,186765
252710,2013,8,158,30,188,20296
252890,2013,8,91,18,109,10460
253030,2013,8,4800,305,5105,615654
253110,2013,8,3109,219,3328,116526
253310,2013,6,76,20,96,6098
253350,2013,8,163,27,190,18091
253370,2013,5,223,115,338,55809
253650,2013,6,1288,483,1771,228198
253690,2013,6,304,85,389,60734
254440,2013,8,2193,230,2423,255171
255300,2013,8,903,117,1020,91947
255320,2013,8,623,138,761,137882
255520,2013,8,2091,500,2591,2418851
255870,2013,8,409,39,448,91301
256070,2013,6,120,45,165,10853
256330,2013,5,526,294,820,61200
257050,2013,5,391,368,759,81026
257120,2013,6,401,101,502,99729
257350,2013,8,2185,358,2543,420031
257750,2013,8,2117,389,2506,380476
257770,2013,5,45,29,74,8132
257830,2013,5,417,241,658,113871
257990,2013,8,524,87,611,56336
258090,2013,5,200,144,344,47240
258220,2013,5,369,250,619,46327
258890,2013,6,1069,269,1338,90983
258950,2013,5,230,155,385,35112
259080,2013,8,10771,946,11717,2625503
259430,2013,6,167,57,224,26688
259510,2013,8,399,70,469,118220
259530,2013,8,2292,157,2449,139558
259550,2013,8,2633,212,2845,128807
259600,2013,8,668,137,805,66126
259680,2013,9,2450,108,2558,176493
259700,2013,4,79,137,216,18918
259830,2013,5,59,45,104,16273
260250,2013,5,339,220,559,49146
261030,2013,9,19248,846,20094,1054661
261700,2013,8,1021,143,1164,50275
261940,2013,6,55,20,75,7379
262300,2012,5,30,18,48,9740
262940,2013,8,1359,185,1544,152508
265210,2013,8,3086,317,3403,555426
267060,2013,5,250,156,406,58483
