id,year,review_score,total_positive,total_negative,total_reviews,Players
40980,2016,6,320,92,412,248308
45420,2016,7,10,1,11,314
96100,2016,8,7045,1108,8153,754043
115800,2016,8,3002,415,3417,251798
210970,2016,8,5493,1046,6539,494237
219990,2016,8,21546,1725,23271,1464229
223100,2016,5,5434,4415,9849,600976
230270,2016,9,1389,62,1451,118689
232450,2016,5,748,381,1129,237212
236010,2016,5,16,13,29,4923
236870,2016,6,17138,4724,21862,1534824
237870,2016,5,3587,1598,5185,369351
240440,2016,8,392,42,434,26507
241760,2016,6,107,34,141,10282
251110,2016,8,527,68,595,16562
251230,2016,6,260,78,338,28088
251270,2016,8,364,26,390,24226
251450,2016,4,66,104,170,36062
252850,2016,6,1405,518,1923,249845
253190,2016,5,582,306,888,64602
253840,2016,8,1501,136,1637,73427
254300,2016,6,124,48,172,36236
257850,2016,8,9406,565,9971,595090
262120,2016,6,454,152,606,70300
262510,2016,6,28,11,39,1371
262630,2016,7,12,2,14,501
263980,2016,8,5641,397,6038,521927
265000,2016,8,434,63,497,38487
265470,2016,8,95,14,109,2148
268360,2016,5,149,68,217,14600
269170,2016,8,596,51,647,63858
269310,2016,5,406,194,600,48803
269710,2016,6,506,132,638,161430
270070,2016,5,30,14,44,1343
270130,2016,8,1108,163,1271,92049
270210,2016,8,3748,255,4003,156009
270270,2016,5,320,145,465,25521
270410,2016,5,22,26,48,3830
271240,2016,6,2512,801,3313,499550
271920,2016,8,255,38,293,106888
271970,2016,8,134,13,147,8280
273800,2016,5,37,53,90,11336
273890,2016,3,4,25,29,1360
274270,2016,8,1358,181,1539,146959
274500,2016,8,1309,89,1398,94477
275850,2016,5,43397,41797,85194,1396577
277390,2016,8,98,16,114,6649
277700,2016,8,113,12,125,13159
278100,2016,8,527,73,600,76653
279070,2016,8,76,11,87,7217
279900,2016,5,120,53,173,15864
280160,2016,8,3058,370,3428,287729
280520,2016,8,677,165,842,76215
281200,2016,5,213,104,317,51949
281610,2016,6,2451,642,3093,102014
281640,2016,8,1405,134,1539,154166
281990,2016,8,26902,6152,33054,1967015
282560,2016,4,1072,3341,4413,180587
283160,2016,8,848,90,938,52810
283640,2016,8,6030,474,6504,400674
284100,2016,5,80,47,127,8944
284410,2016,6,40,16,56,7705
285070,2016,6,490,135,625,108601
286240,2016,8,246,19,265,16563
288100,2016,5,10,7,17,1150
288140,2016,5,393,234,627,29063
288220,2016,8,166,16,182,14314
290000,2016,6,176,45,221,20426
290870,2016,6,58,17,75,3656
291010,2016,5,2185,1023,3208,320602
291410,2016,8,3109,688,3797,538747
292730,2016,5,6740,9520,16260,869560
296030,2016,7,27,5,32,2716
297450,2016,5,79,56,135,8049
297660,2016,7,38,4,42,2048
298050,2016,6,2679,1117,3796,243222
298420,2016,6,11,3,14,651
298560,2016,8,209,38,247,29606
298900,2016,5,2889,2542,5431,236698
299250,2016,4,194,298,492,50077
299340,2016,5,92,102,194,27685
299380,2016,7,10,1,11,189
299480,2016,6,559,233,792,80072
299800,2016,8,50,3,53,7307
300060,2016,5,691,546,1237,81212
300630,2016,5,57,28,85,5017
301650,2016,8,444,39,483,38993
301930,2016,7,18,2,20,1690
303310,2016,8,374,7,381,8530
303720,2016,5,31,15,46,31878
304430,2016,9,16902,786,17688,669904
306000,2016,5,38,44,82,7218
306760,2016,8,1595,370,1965,129459
307940,2016,6,227,75,302,13838
311010,2016,8,501,58,559,22816
311240,2016,8,1247,106,1353,38650
311690,2016,8,14732,969,15701,1144928
312560,2016,8,156,16,172,8093
312980,2016,8,216,29,245,11249
313630,2016,8,1651,394,2045,140276
314010,2016,8,480,117,597,133835
314180,2016,8,247,6,253,25164
314240,2016,5,256,180,436,32705
314330,2016,7,41,5,46,3530
314370,2016,6,77,23,100,1269
314450,2016,8,1262,256,1518,295982
314710,2016,5,1244,1246,2490,106427
314790,2016,8,813,133,946,69338
314970,2016,6,977,254,1231,257484
315430,2016,8,3605,852,4457,392114
317060,2016,5,48,51,99,7900
317280,2016,6,94,29,123,18849
317320,2016,8,111,6,117,3464
317530,2016,5,73,49,122,5536
318090,2016,5,129,60,189,8572
318600,2016,6,2654,818,3472,561716
319760,2016,8,116,16,132,9903
320040,2016,6,1098,328,1426,170583
321270,2016,6,445,124,569,30900
322190,2016,9,2215,89,2304,232902
322500,2016,8,11942,1757,13699,842122
322630,2016,5,26,30,56,2269
323060,2016,5,1319,582,1901,127534
323850,2016,8,6322,872,7194,952680
324090,2016,5,70,42,112,6992
324310,2016,5,1218,776,1994,151645
324520,2016,8,137,31,168,8184
324650,2016,6,234,68,302,11167
324740,2016,6,302,85,387,62365
324810,2016,6,3427,1028,4455,575390
325730,2016,6,143,46,189,15417
325930,2016,8,152,18,170,14172
326110,2016,5,9,13,22,817
326520,2016,6,69,18,87,15264
326840,2016,8,272,57,329,15792
327030,2016,8,1661,404,2065,286591
327070,2016,5,1636,765,2401,102616
327510,2016,6,666,214,880,77315
327560,2016,8,434,43,477,14506
328000,2016,5,6,6,12,2059
329280,2016,5,66,49,115,15970
329340,2016,7,10,2,12,483
330100,2016,6,134,38,172,15356
330770,2016,8,104,22,126,8575
332410,2016,8,92,15,107,6596
333340,2016,5,63,74,137,3888
333420,2016,6,3706,1237,4943,360956
334210,2016,6,564,171,735,568944
334280,2016,5,33,20,53,3414
336030,2016,7,35,7,42,10741
336130,2016,8,240,25,265,11451
336210,2016,5,14,17,31,450
336240,2016,8,237,29,266,15991
337000,2016,5,13241,6096,19337,1155405
337360,2016,5,70,62,132,18795
337490,2016,8,148,25,173,5467
337720,2016,8,126,2,128,2765
337820,2016,6,153,39,192,10977
338040,2016,6,39,15,54,1906
338130,2016,5,101,45,146,25402
338170,2016,8,1835,328,2163,324272
338310,2016,8,46,6,52,6188
338390,2016,5,1094,490,1584,100047
339110,2016,5,15,14,29,5775
339340,2016,8,1677,253,1930,199427
339440,2016,8,168,15,183,8893
339580,2016,6,390,115,505,41288
339710,2016,5,6,4,10,2242
340000,2016,8,488,49,537,44476
340030,2016,3,6,38,44,11312
340490,2016,8,597,125,722,74553
340560,2016,5,4,6,10,431
340680,2016,7,9,2,11,1158
340770,2016,6,221,57,278,24606
341000,2016,8,2814,296,3110,176745
341270,2016,5,13,10,23,1941
341290,2016,7,13,2,15,723
342130,2016,5,19,10,29,5952
342180,2016,8,2584,400,2984,168513
342480,2016,5,653,299,952,241759
342550,2016,5,112,72,184,4951
342970,2016,5,147,69,216,63213
345010,2016,6,215,87,302,11661
345480,2016,6,55,17,72,4214
345700,2016,5,75,40,115,4474
345990,2016,6,27,9,36,3019
346610,2016,5,38,27,65,4253
347060,2016,5,36,34,70,5043
347280,2016,6,26,11,37,1197
347330,2016,7,10,1,11,1842
347720,2016,8,187,18,205,6253
348030,2016,5,176,129,305,10204
348460,2016,5,239,275,514,101843
348670,2016,5,772,544,1316,143017
348740,2016,7,8,2,10,2664
349040,2016,8,12999,2719,15718,965482
350090,2016,5,18,14,32,3012
350110,2016,5,181,216,397,39288
350480,2016,7,30,6,36,1122
350600,2016,5,115,57,172,6422
350640,2016,6,1673,570,2243,144312
350740,2016,8,864,77,941,57122
351320,2016,7,14,2,16,392
351330,2016,7,23,4,27,1029
351630,2016,5,88,94,182,45681
351720,2016,7,31,7,38,21144
351730,2016,5,72,46,118,7541
351920,2016,9,2053,67,2120,88976
351940,2016,8,1127,175,1302,633209
351990,2016,8,1035,177,1212,51129
352240,2016,5,76,46,122,6719
352370,2016,6,31,11,42,2896
352790,2016,6,12,5,17,1826
352890,2016,6,192,61,253,19612
353130,2016,5,990,506,1496,402752
353190,2016,5,151,84,235,9210
353580,2016,8,118,17,135,6060
353630,2016,5,72,67,139,14452
353700,2016,8,821,100,921,61366
353890,2016,6,54,14,68,2953
354280,2016,7,14,2,16,754
354400,2016,8,205,8,213,8642
354740,2016,8,75,5,80,6386
354860,2016,6,266,82,348,69112
355060,2016,5,237,221,458,26820
355310,2016,5,27,14,41,1116
355510,2016,5,11,16,27,1460
355690,2016,7,14,2,16,1008
355800,2016,5,439,246,685,73251
355920,2016,8,187,23,210,106799
356400,2016,8,1481,114,1595,95420
356460,2016,7,23,5,28,1124
357010,2016,7,29,6,35,2048
357030,2016,6,16,6,22,1953
357120,2016,6,123,34,157,19142
357340,2016,8,488,47,535,38592
357490,2016,7,14,2,16,2433
357670,2016,6,115,49,164,18658
358080,2016,5,107,78,185,165616
358130,2016,8,1404,158,1562,124777
358460,2016,6,157,62,219,28318
358750,2016,8,471,83,554,42444
358760,2016,7,14,3,17,448
358830,2016,8,168,23,191,15166
359140,2016,8,339,15,354,12562
359350,2016,8,246,53,299,27778
359870,2016,8,5453,506,5959,568989
360880,2016,5,19,23,42,7388
361040,2016,8,214,11,225,6631
361280,2016,8,2637,291,2928,452658
361300,2016,8,2149,352,2501,157371
361350,2016,8,57,7,64,3150
362380,2016,7,17,2,19,4132
362960,2016,8,5133,802,5935,562631
363270,2016,5,35,22,57,7312
363420,2016,8,279,25,304,20602
363520,2016,6,164,69,233,17630
363530,2016,4,62,184,246,5592
363680,2016,5,2763,1239,4002,321637
363930,2016,8,2383,487,2870,122734
364200,2016,7,43,5,48,3954
364230,2016,8,192,6,198,15643
364300,2016,5,209,95,304,13915
364390,2016,8,428,30,458,12578
364720,2016,7,10,1,11,835
364830,2016,8,50,3,53,5025
364910,2016,5,61,66,127,58611
365190,2016,8,164,28,192,20949
365200,2016,4,5,10,15,448
365300,2016,8,6727,416,7143,625220
365440,2016,5,21,10,31,3616
366180,2016,5,43,20,63,8003
366230,2016,6,28,10,38,6226
366240,2016,6,87,25,112,5045
366260,2016,8,158,25,183,21016
366270,2016,7,42,7,49,6224
366280,2016,6,72,19,91,8061
366320,2016,8,1062,209,1271,98326
366440,2016,5,762,571,1333,105183
366620,2016,7,31,5,36,6461
366690,2016,6,61,18,79,4240
366760,2016,6,465,164,629,180595
366780,2016,7,25,1,26,2041
367140,2016,7,38,3,41,1216
367450,2016,8,2802,325,3127,806360
367500,2016,8,10682,1263,11945,970603
368080,2016,6,138,58,196,21510
368430,2016,6,337,105,442,16808
368570,2016,8,231,13,244,8129
368640,2016,8,196,41,237,14141
368680,2016,8,68,2,70,3687
368740,2016,6,144,54,198,14810
368800,2016,8,111,17,128,8051
369030,2016,5,136,91,227,23830
369070,2016,6,830,334,1164,61787
369230,2016,5,21,16,37,1394
369550,2016,8,138,23,161,7859
369990,2016,8,2463,375,2838,211874
370060,2016,8,185,33,218,14412
370130,2016,5,19,16,35,10020
370280,2016,8,1223,71,1294,19363
370670,2016,8,88,2,90,1360
370840,2016,5,40,29,69,2688
370910,2016,8,968,61,1029,49640
370940,2016,7,45,4,49,8043
371010,2016,5,94,46,140,7708
371200,2016,8,1012,189,1201,125302
371880,2016,6,42,11,53,4251
372160,2016,5,10,13,23,489
372350,2016,8,78,10,88,3009
372360,2016,8,1629,372,2001,221667
372430,2016,4,5,10,15,398
372490,2016,5,64,38,102,59606
372540,2016,5,1021,478,1499,42192
372690,2016,8,149,31,180,7106
372750,2016,5,58,86,144,32912
373480,2016,5,92,55,147,13878
373650,2016,6,72,26,98,7438
373720,2016,5,175,100,275,62827
373770,2016,9,2083,74,2157,101532
373880,2016,4,9,17,26,711
373920,2016,5,121,97,218,7148
373990,2016,6,120,47,167,19193
374030,2016,5,1091,530,1621,49839
374050,2016,5,35,26,61,4253
374150,2016,7,17,2,19,1986
374170,2016,5,15,12,27,1328
374520,2016,5,60,63,123,7333
374670,2016,8,790,142,932,60741
374900,2016,6,549,147,696,66443
375210,2016,8,46,5,51,2054
375230,2016,5,4851,5089,9940,502562
375680,2016,4,86,198,284,159054
376250,2016,6,32,10,42,5444
376310,2016,4,187,336,523,24995
376450,2016,5,32,15,47,2807
376520,2016,8,260,32,292,22421
376570,2016,6,2824,1158,3982,857109
376880,2016,6,43,16,59,3666
377140,2016,5,334,244,578,20087
377480,2016,5,82,39,121,6239
377690,2016,8,134,8,142,8126
377840,2016,8,3430,261,3691,333922
377880,2016,8,132,21,153,7768
377980,2016,5,34,30,64,9041
378070,2016,6,37,11,48,1344
378260,2016,6,61,19,80,7766
378700,2016,5,21,10,31,510
378800,2016,5,192,104,296,18471
378810,2016,7,32,8,40,7750
378930,2016,5,69,32,101,8135
379420,2016,8,94,13,107,7665
379610,2016,7,36,4,40,2039
380100,2016,7,12,1,13,1610
380220,2016,5,482,222,704,60211
380660,2016,8,56,7,63,1738
380670,2016,8,303,15,318,31446
380750,2016,6,286,112,398,20773
381120,2016,5,1379,839,2218,193100
381320,2016,8,53,13,66,5496
381340,2016,7,18,1,19,409
381880,2016,8,64,7,71,4611
382050,2016,8,492,59,551,68385
382260,2016,8,237,18,255,15765
382420,2016,5,107,96,203,10032
383020,2016,5,7,6,13,555
383070,2016,5,16,20,36,2191
383150,2016,6,2372,948,3320,335791
383180,2016,5,526,268,794,117625
383230,2016,6,1259,390,1649,106207
383270,2016,8,608,38,646,28775
383790,2016,5,295,212,507,51261
383870,2016,8,28348,4871,33219,959053
383930,2016,8,297,54,351,36687
384080,2016,5,140,91,231,18891
384100,2016,7,30,7,37,1662
384180,2016,6,1205,328,1533,247520
384190,2016,8,13482,1051,14533,577340
384330,2016,6,38,16,54,3111
384480,2016,8,66,7,73,18651
384490,2016,5,2179,1140,3319,180526
384500,2016,8,476,72,548,25829
384750,2016,5,132,140,272,16340
384940,2016,6,19,5,24,7083
385240,2016,8,628,138,766,80668
385370,2016,8,1925,315,2240,154848
385560,2016,8,498,88,586,71503
385730,2016,5,1598,938,2536,141022
385760,2016,5,4097,3570,7667,501303
385950,2016,4,7,13,20,4697
386080,2016,8,129,30,159,8483
386490,2016,5,81,54,135,35737
386650,2016,5,68,54,122,5525
386690,2016,6,188,51,239,98151
386750,2016,6,37,15,52,6997
386940,2016,9,5401,284,5685,770483
387090,2016,5,17,13,30,1710
387290,2016,9,12030,454,12484,764826
387340,2016,8,2086,141,2227,108610
387370,2016,6,241,94,335,29848
387400,2016,3,3,15,18,598
388210,2016,9,2167,57,2224,265169
388320,2016,6,533,160,693,23358
388750,2016,8,1755,152,1907,176322
388880,2016,8,5274,365,5639,280771
388900,2016,6,78,24,102,6570
389040,2016,5,866,602,1468,45174
389050,2016,6,115,30,145,5389
389120,2016,6,12,5,17,774
389170,2016,8,748,68,816,23221
389190,2016,6,52,19,71,5643
389510,2016,8,1148,101,1249,24581
390040,2016,6,177,67,244,14004
390310,2016,5,88,43,131,6929
390330,2016,6,43,12,55,3475
390340,2016,4,523,1440,1963,79802
390460,2016,5,11,8,19,6841
390680,2016,7,39,1,40,3372
390720,2016,8,225,11,236,15074
390730,2016,8,207,12,219,12100
390930,2016,7,36,5,41,1145
391040,2016,8,3016,551,3567,318467
391310,2016,5,103,47,150,57739
391550,2016,5,13,8,21,571
391600,2016,6,84,33,117,35685
391720,2016,8,10917,1172,12089,1203631
391730,2016,8,1376,204,1580,112130
391820,2016,5,17,20,37,9709
392000,2016,6,216,57,273,12659
392030,2016,8,56,2,58,3988
392120,2016,5,11,12,23,8748
392190,2016,6,68,24,92,6851
392260,2016,6,132,34,166,10395
392410,2016,6,186,77,263,23968
392580,2016,6,408,127,535,45755
392680,2016,6,28,10,38,6630
392970,2016,8,145,10,155,7041
393200,2016,8,427,80,507,19637
393230,2016,4,9,33,42,18953
393430,2016,8,702,126,828,113121
393460,2016,5,35,24,59,10459
393530,2016,5,1283,636,1919,310042
393750,2016,5,106,55,161,5204
393790,2016,6,68,20,88,17344
393820,2016,5,21,30,51,1283
393860,2016,5,16,8,24,1909
393930,2016,5,251,139,390,121719
394130,2016,8,119,6,125,15129
394160,2016,8,179,41,220,44054
394230,2016,5,5233,3224,8457,492052
394260,2016,6,28,10,38,7498
394310,2016,6,5316,1464,6780,541121
394360,2016,8,19863,3491,23354,1352834
394540,2016,6,306,82,388,128550
394690,2016,8,3715,601,4316,229619
394700,2016,8,243,43,286,24002
394760,2016,6,868,313,1181,86791
394970,2016,9,1845,88,1933,123529
395100,2016,7,11,2,13,4622
395350,2016,5,180,103,283,12817
395470,2016,5,25,12,37,1210
395500,2016,8,183,29,212,4538
395570,2016,6,387,158,545,35242
395620,2016,8,106,17,123,3964
395850,2016,8,315,57,372,14195
396320,2016,5,15,10,25,4129
396480,2016,8,450,98,548,37826
396650,2016,9,852,35,887,21258
396660,2016,8,74,18,92,2172
396680,2016,6,34,11,45,2926
396700,2016,7,20,1,21,191
397090,2016,8,53,10,63,5128
397150,2016,6,371,107,478,36201
397390,2016,6,103,38,141,13400
397730,2016,5,23,18,41,1196
397820,2016,5,22,17,39,2123
397860,2016,7,16,2,18,692
397950,2016,8,3521,370,3891,368787
398120,2016,5,14,19,33,2194
398150,2016,5,24,18,42,9021
398170,2016,8,200,45,245,17066
398670,2016,5,6,6,12,638
398680,2016,5,451,215,666,106560
398850,2016,9,2761,120,2881,167656
398890,2016,7,16,4,20,1244
399130,2016,5,63,72,135,22591
399530,2016,7,10,2,12,4781
399600,2016,8,289,10,299,6414
399820,2016,8,1046,229,1275,94463
400020,2016,6,253,68,321,38154
400030,2016,5,108,90,198,51883
400180,2016,8,487,112,599,89332
400360,2016,5,74,35,109,5240
400450,2016,8,232,51,283,20385
400510,2016,5,127,117,244,36990
400630,2016,9,1142,44,1186,70101
400800,2016,6,259,101,360,26799
400880,2016,4,6,18,24,1658
400910,2016,9,5359,110,5469,153932
401360,2016,6,198,58,256,12607
401510,2016,7,14,1,15,283
401680,2016,8,894,93,987,55987
401820,2016,6,83,29,112,4466
401890,2016,6,126,48,174,8931
402040,2016,8,294,72,366,19291
402060,2016,6,125,49,174,5358
402150,2016,6,36,12,48,3340
402260,2016,8,286,64,350,22012
402310,2016,8,314,56,370,19052
402340,2016,8,67,8,75,5735
402430,2016,8,556,47,603,66375
402530,2016,8,270,16,286,21984
402560,2016,5,344,274,618,263899
402570,2016,8,3555,788,4343,707718
402750,2016,5,164,72,236,22438
402880,2016,6,285,77,362,11997
403290,2016,6,90,24,114,3779
403400,2016,6,126,36,162,33672
403430,2016,8,202,34,236,45606
403590,2016,4,57,95,152,5920
403640,2016,8,17614,4161,21775,1127089
403940,2016,8,313,64,377,23784
403970,2016,6,683,197,880,43647
404180,2016,8,77,18,95,14066
404510,2016,8,52,10,62,7893
404620,2016,6,456,140,596,63353
404640,2016,5,115,103,218,27929
404700,2016,8,104,19,123,18105
404770,2016,5,191,112,303,71631
404820,2016,8,129,13,142,13624
405000,2016,8,96,12,108,5258
405310,2016,8,1447,293,1740,211964
405440,2016,5,6,7,13,22252
405500,2016,5,228,276,504,47177
405540,2016,7,37,9,46,3265
405550,2016,7,36,5,41,4574
405640,2016,9,8094,348,8442,334799
405720,2016,6,62,20,82,6952
405760,2016,6,41,17,58,6853
405900,2016,8,1900,248,2148,169503
405960,2016,5,21,19,40,1247
405970,2016,8,124,26,150,16515
406120,2016,5,9,6,15,5458
406170,2016,5,191,128,319,14230
406220,2016,8,46,9,55,3489
406290,2016,8,677,101,778,68306
406310,2016,5,101,57,158,14836
406550,2016,8,236,5,241,9133
406720,2016,5,145,88,233,8234
406850,2016,8,210,39,249,21939
406870,2016,8,368,17,385,34880
406940,2016,6,132,50,182,7918
406970,2016,8,745,165,910,33684
407330,2016,8,814,67,881,107936
407340,2016,8,73,4,77,3453
407560,2016,6,564,236,800,55427
407780,2016,8,173,22,195,10327
407810,2016,8,566,114,680,59432
407830,2016,4,5,9,14,1472
407840,2016,5,1868,1468,3336,275847
407880,2016,8,87,5,92,10469
407940,2016,8,69,2,71,21745
408110,2016,8,91,19,110,61839
408250,2016,5,116,52,168,13642
408640,2016,5,114,75,189,14198
408650,2016,8,304,22,326,10727
408760,2016,5,172,120,292,48819
408920,2016,5,105,62,167,6832
408960,2016,8,99,23,122,5469
409000,2016,5,134,71,205,10748
409040,2016,5,28,14,42,2742
409290,2016,5,29,15,44,6555
409320,2016,5,117,54,171,4934
409340,2016,5,67,33,100,11451
409390,2016,6,35,14,49,3361
409460,2016,5,19,9,28,904
409520,2016,5,31,15,46,1722
409560,2016,6,65,17,82,10654
409660,2016,8,445,47,492,22630
409710,2016,5,6304,4186,10490,1289273
409730,2016,8,83,19,102,12776
409870,2016,8,179,9,188,24630
409890,2016,6,217,87,304,26902
410000,2016,7,11,2,13,606
410320,2016,9,3170,132,3302,202538
410570,2016,8,137,33,170,19101
410820,2016,8,351,19,370,35368
411130,2016,5,30,22,52,912
411370,2016,8,933,80,1013,81464
411600,2016,5,33,20,53,2826
411610,2016,7,33,5,38,5261
411620,2016,5,20,13,33,2290
411750,2016,6,31,9,40,2172
411830,2016,9,2633,132,2765,120376
411960,2016,9,1491,16,1507,60953
412400,2016,1,248,1006,1254,101100
412450,2016,5,907,634,1541,15180
412460,2016,5,133,124,257,16973
412490,2016,5,20,9,29,6902
412540,2016,6,16,6,22,5642
412660,2016,8,69,14,83,2779
412790,2016,6,84,27,111,4773
412830,2016,9,4274,104,4378,160015
413410,2016,9,4204,120,4324,234336
413420,2016,9,3435,88,3523,178510
413480,2016,7,25,6,31,1089
413500,2016,8,57,8,65,3462
413700,2016,7,16,1,17,723
413830,2016,5,10,5,15,2286
413870,2016,8,84,6,90,7928
414090,2016,5,9,6,15,369
414190,2016,8,203,43,246,18930
414370,2016,8,53,4,57,7425
414510,2016,8,222,34,256,16256
414730,2016,5,391,187,578,144330
415010,2016,5,41,47,88,1015
415150,2016,8,115,22,137,14837
415200,2016,8,3613,383,3996,330158
415240,2016,6,85,22,107,8598
415270,2016,8,1395,313,1708,100051
415350,2016,8,367,37,404,25583
415480,2016,8,481,99,580,42408
415530,2016,7,10,1,11,3630
415610,2016,8,338,22,360,16134
415670,2016,8,58,4,62,8855
415740,2016,8,168,38,206,13002
415840,2016,5,71,35,106,62379
415860,2016,5,485,520,1005,218644
415960,2016,6,144,45,189,238706
416040,2016,4,69,108,177,132997
416110,2016,8,77,11,88,8992
416180,2016,7,31,4,35,1338
416250,2016,7,15,3,18,2274
416450,2016,5,220,131,351,89737
416610,2016,5,34,17,51,120462
416680,2016,8,847,46,893,66546
416720,2016,5,20,15,35,1293
416790,2016,8,188,21,209,16107
416850,2016,7,12,2,14,1012
417310,2016,6,14,6,20,1133
417430,2016,5,425,211,636,54966
417480,2016,6,14,4,18,4434
417880,2016,5,584,264,848,34561
417900,2016,7,22,1,23,888
417910,2016,5,860,652,1512,290227
418120,2016,8,305,64,369,28914
418180,2016,6,1063,418,1481,150883
418210,2016,7,42,5,47,1228
418240,2016,9,7170,260,7430,405980
418270,2016,6,63,22,85,10941
418340,2016,8,7769,1508,9277,387405
418610,2016,5,54,52,106,117621
418670,2016,8,158,30,188,7152
418950,2016,8,332,79,411,43330
419080,2016,6,56,20,76,14464
419590,2016,6,29,10,39,28641
419810,2016,7,24,2,26,3213
420060,2016,8,275,36,311,18790
420110,2016,9,7531,193,7724,318426
420160,2016,5,8,4,12,476
420360,2016,7,36,6,42,12186
420380,2016,6,14,4,18,1523
420500,2016,6,13,4,17,335
420530,2016,9,7376,117,7493,176242
420570,2016,7,23,3,26,1078
420790,2016,6,621,180,801,189535
420850,2016,6,78,27,105,13130
420900,2016,6,10,3,13,1638
420930,2016,8,297,59,356,36071
421040,2016,8,3200,425,3625,166125
421050,2016,8,1600,213,1813,123013
421060,2016,5,119,65,184,102505
421120,2016,9,1616,85,1701,114359
421140,2016,6,10,4,14,3386
421600,2016,5,36,31,67,6361
421610,2016,7,36,6,42,2036
421660,2016,8,290,7,297,7324
421670,2016,8,734,101,835,106536
421740,2016,8,172,36,208,23890
421870,2016,7,12,3,15,3470
422110,2016,8,119,5,124,6435
422270,2016,4,8,17,25,1423
422590,2016,4,9,28,37,1922
422610,2016,5,21,12,33,3454
422650,2016,6,56,16,72,11057
422900,2016,8,409,36,445,36823
422910,2016,8,88,6,94,12431
422920,2016,7,46,3,49,9617
422970,2016,9,3797,190,3987,102656
422980,2016,7,23,4,27,4119
423220,2016,7,19,1,20,1796
423230,2016,8,2954,295,3249,218506
423270,2016,6,29,9,38,1443
423550,2016,6,60,21,81,44497
423580,2016,8,1380,321,1701,246461
423590,2016,8,239,33,272,14057
423610,2016,6,112,31,143,8330
423620,2016,6,320,92,412,25817
423650,2016,5,40,24,64,8921
423700,2016,5,27,37,64,4175
423710,2016,5,100,133,233,323181
423720,2016,7,11,1,12,2096
423800,2016,6,31,13,44,2869
423810,2016,6,334,134,468,47487
423870,2016,7,25,6,31,4446
423950,2016,5,374,173,547,37167
424010,2016,7,18,2,20,730
424250,2016,6,241,65,306,23771
424260,2016,5,37,26,63,1574
424280,2016,9,11633,206,11839,1154435
424640,2016,7,34,6,40,5169
424760,2016,6,26,10,36,4335
424830,2016,4,90,287,377,74642
425070,2016,7,35,5,40,1510
425160,2016,8,61,7,68,9157
425210,2016,6,499,146,645,51119
425220,2016,6,1253,392,1645,131305
425300,2016,6,57,18,75,3975
425310,2016,4,10,17,27,841
425410,2016,8,239,30,269,41756
425580,2016,9,5729,126,5855,199346
425600,2016,8,69,9,78,3043
425650,2016,8,98,7,105,2509
425670,2016,8,333,53,386,21724
425720,2016,8,219,41,260,37955
425820,2016,8,49,8,57,5563
425900,2016,7,18,3,21,201
426000,2016,8,2650,553,3203,320028
426010,2016,4,16,28,44,2594
426170,2016,5,26,13,39,4103
426240,2016,7,18,1,19,335
426290,2016,6,43,13,56,7899
426790,2016,8,755,86,841,70248
427030,2016,6,726,232,958,29768
427050,2016,6,8,3,11,309
427100,2016,5,1218,1015,2233,118947
427250,2016,8,1220,280,1500,123076
427470,2016,6,164,67,231,34890
427510,2016,6,170,50,220,24344
427550,2016,5,76,42,118,14697
427660,2016,5,112,78,190,5838
427730,2016,6,7938,2892,10830,1305248
427770,2016,7,40,3,43,16744
427810,2016,6,220,68,288,6551
427820,2016,8,612,118,730,58049
427860,2016,6,58,22,80,4331
427910,2016,6,244,72,316,26069
427930,2016,5,33,26,59,44138
427980,2016,6,322,87,409,65431
428100,2016,8,74,2,76,5740
428110,2016,5,14,9,23,3900
428220,2016,8,236,39,275,9855
428350,2016,8,52,10,62,8126
428410,2016,7,23,2,25,1035
428440,2016,5,137,82,219,3649
428530,2016,5,18,11,29,5942
428550,2016,9,4399,202,4601,246833
428590,2016,5,7,9,16,4740
428740,2016,4,7,11,18,1403
428750,2016,8,637,46,683,85022
428830,2016,8,109,12,121,19424
428880,2016,8,214,33,247,15649
428900,2016,8,634,95,729,129612
428920,2016,6,11,3,14,3694
429020,2016,4,21,42,63,7209
429050,2016,6,818,302,1120,151025
429060,2016,5,38,36,74,11425
429120,2016,6,18,7,25,1239
429200,2016,5,22,14,36,7297
429220,2016,6,37,13,50,3999
429250,2016,7,17,4,21,1984
429330,2016,8,256,38,294,39048
429350,2016,7,24,1,25,4698
429390,2016,5,32,17,49,2039
429430,2016,4,8,18,26,5919
429570,2016,6,3184,957,4141,197450
429580,2016,5,117,100,217,32523
429600,2016,5,112,75,187,22491
429610,2016,8,169,33,202,22107
429620,2016,6,521,181,702,41331
429680,2016,6,833,291,1124,137325
429690,2016,7,29,3,32,1314
429700,2016,5,244,115,359,114736
429720,2016,8,452,43,495,15935
429940,2016,8,487,43,530,24192
430170,2016,6,58,23,81,1139
430230,2016,7,13,3,16,732
430240,2016,5,7,5,12,158
430290,2016,7,29,2,31,2709
430300,2016,5,7,4,11,494
431180,2016,8,652,91,743,50468
431200,2016,7,33,4,37,22101
431220,2016,5,68,72,140,32383
431230,2016,8,90,21,111,12878
431250,2016,8,236,56,292,33903
431260,2016,6,346,94,440,25654
431290,2016,5,25,11,36,9986
431370,2016,7,11,2,13,2849
431410,2016,7,22,4,26,1300
431510,2016,8,250,50,300,35333
431540,2016,8,932,109,1041,72959
431590,2016,8,253,32,285,19144
431600,2016,8,799,107,906,48672
431630,2016,7,20,4,24,694
431640,2016,5,45,47,92,37470
431680,2016,5,11,13,24,5976
431710,2016,8,279,42,321,152788
431740,2016,5,22,13,35,13020
431750,2016,6,29,10,39,45950
431810,2016,5,113,50,163,10662
431830,2016,7,26,5,31,2163
431840,2016,5,74,54,128,21527
431850,2016,8,49,9,58,4205
431870,2016,6,48,16,64,3795
431910,2016,6,154,40,194,10209
432010,2016,8,368,79,447,31135
432100,2016,8,307,51,358,47218
432130,2016,7,23,4,27,558
432180,2016,7,20,4,24,5752
432190,2016,8,80,11,91,8333
432230,2016,7,25,5,30,1337
432260,2016,6,45,12,57,9880
432290,2016,5,68,54,122,35978
432330,2016,6,38,15,53,6473
432380,2016,7,15,1,16,1476
432470,2016,5,96,124,220,232598
432480,2016,7,18,2,20,172
432590,2016,5,19,14,33,960
432640,2016,5,17,21,38,962
432720,2016,6,45,17,62,2214
432870,2016,6,36,10,46,2503
432980,2016,8,121,8,129,15925
432990,2016,7,36,3,39,20938
433100,2016,8,565,139,704,26994
433110,2016,5,13,11,24,4015
433210,2016,5,34,51,85,41485
433300,2016,5,220,171,391,22027
433320,2016,5,119,135,254,20337
433350,2016,5,1060,968,2028,553384
433380,2016,5,42,23,65,1245
433400,2016,8,49,6,55,1858
433450,2016,5,41,19,60,2453
433490,2016,7,22,3,25,872
433570,2016,6,7,3,10,206
433590,2016,7,30,7,37,1200
433600,2016,8,151,30,181,13136
433660,2016,7,10,2,12,674
433670,2016,4,55,106,161,33752
433840,2016,5,35,16,51,1925
433890,2016,7,29,4,33,1768
433910,2016,8,858,200,1058,64909
433950,2016,9,4292,106,4398,263361
434000,2016,8,276,31,307,18386
434020,2016,8,210,37,247,12959
434050,2016,8,525,121,646,42602
434130,2016,7,34,3,37,2555
434170,2016,8,578,33,611,319411
434210,2016,8,502,46,548,224555
434220,2016,7,31,4,35,34825
434230,2016,7,16,2,18,4930
434240,2016,7,13,2,15,1638
434250,2016,5,868,376,1244,153543
434260,2016,8,1623,372,1995,53461
434290,2016,5,67,31,98,13160
434390,2016,6,11,3,14,2429
434410,2016,8,186,8,194,7895
434420,2016,6,630,261,891,141688
434530,2016,7,22,3,25,4584
434570,2016,9,13474,704,14178,842105
434620,2016,6,159,48,207,7119
434650,2016,8,10543,1130,11673,864412
434680,2016,5,99,64,163,11498
434700,2016,7,13,3,16,606
434730,2016,8,1831,449,2280,282077
434740,2016,8,68,12,80,4555
434750,2016,7,21,2,23,655
434790,2016,6,10,4,14,138
434820,2016,8,48,10,58,9532
434860,2016,7,12,3,15,155
434870,2016,5,5,5,10,415
434880,2016,5,79,37,116,6248
434930,2016,5,9,10,19,374
434960,2016,5,4,6,10,298
435010,2016,5,16,19,35,3550
435030,2016,8,3522,274,3796,68466
435040,2016,6,31,9,40,6714
435260,2016,7,20,3,23,1332
435300,2016,8,281,23,304,9670
435360,2016,7,38,5,43,2039
435460,2016,8,49,6,55,4182
435480,2016,5,73,41,114,5146
435490,2016,8,190,13,203,15932
435530,2016,8,2874,510,3384,145897
435600,2016,5,18,10,28,1606
435790,2016,8,112,16,128,10822
435800,2016,8,51,4,55,5778
435840,2016,7,24,4,28,774
436000,2016,6,63,20,83,2930
436060,2016,5,13,6,19,2523
436140,2016,5,26,12,38,25362
436150,2016,6,1665,616,2281,479096
436220,2016,8,133,8,141,12141
436260,2016,5,109,89,198,1630
436270,2016,5,14,9,23,4417
436280,2016,6,45,19,64,7298
436390,2016,8,209,18,227,14925
436410,2016,4,5,14,19,319
436480,2016,5,25,14,39,5052
436490,2016,8,144,34,178,9106
436500,2016,6,285,82,367,23326
436530,2016,6,197,53,250,12702
436940,2016,8,46,5,51,4319
437000,2016,6,78,30,108,10504
437060,2016,7,19,2,21,1831
437080,2016,6,51,14,65,1740
437090,2016,7,39,5,44,5313
437100,2016,8,60,5,65,4157
437160,2016,8,1261,81,1342,103237
437180,2016,5,16,7,23,31444
437420,2016,8,135,17,152,20939
437520,2016,8,60,1,61,1300
437530,2016,8,122,30,152,9803
437550,2016,7,31,6,37,2067
437570,2016,8,612,93,705,75642
437710,2016,7,10,2,12,411
437870,2016,5,78,68,146,11664
437880,2016,6,11,4,15,4803
437920,2016,8,2007,231,2238,314191
438020,2016,4,66,171,237,206563
438080,2016,8,377,91,468,64972
438130,2016,8,210,15,225,26201
438220,2016,6,9,3,12,329
438260,2016,7,13,3,16,173
438300,2016,5,12,10,22,706
438310,2016,5,15,20,35,394
438340,2016,5,72,44,116,4450
438420,2016,6,226,88,314,11300
438430,2016,6,192,52,244,18552
438480,2016,8,436,94,530,54215
438490,2016,6,2207,589,2796,243065
438640,2016,8,1469,336,1805,245948
438680,2016,8,837,148,985,209616
438720,2016,5,22,24,46,4803
438730,2016,5,14,11,25,883
438920,2016,8,190,46,236,20857
438940,2016,7,10,2,12,589
439190,2016,8,2894,448,3342,660285
439250,2016,8,192,33,225,138504
439310,2016,6,65,17,82,4075
439440,2016,6,62,20,82,5595
439550,2016,5,29,27,56,11062
439720,2016,6,59,25,84,5907
439730,2016,7,13,1,14,1000
439740,2016,7,10,2,12,522
439750,2016,7,23,5,28,3345
439770,2016,7,38,9,47,4398
439800,2016,7,39,8,47,3014
439880,2016,7,17,4,21,3148
439910,2016,8,207,49,256,56986
439920,2016,6,179,45,224,16467
439940,2016,8,678,57,735,50663
440020,2016,5,80,107,187,7400
440100,2016,7,10,1,11,95
440340,2016,5,62,30,92,8964
440420,2016,8,229,25,254,9123
440450,2016,5,28,16,44,1336
440470,2016,4,6,15,21,344
440550,2016,8,141,18,159,8628
440630,2016,8,608,82,690,74964
440690,2016,6,48,14,62,1015
440720,2016,5,8,8,16,196
440740,2016,5,160,128,288,97765
440750,2016,5,13,6,19,19402
440790,2016,5,5,6,11,11176
440800,2016,7,25,4,29,791
440810,2016,5,31,45,76,1567
440880,2016,9,562,28,590,29167
440950,2016,5,27,16,43,5261
441050,2016,8,336,15,351,12481
441060,2016,7,15,2,17,564
441230,2016,7,26,3,29,1485
441250,2016,5,31,14,45,1879
441280,2016,8,151,10,161,7230
441350,2016,5,46,20,66,2770
441510,2016,7,35,3,38,3435
441670,2016,6,112,33,145,10885
441830,2016,6,769,267,1036,70256
442070,2016,8,203,23,226,122221
442140,2016,5,8,4,12,723
442190,2016,5,10,11,21,554
442220,2016,5,38,35,73,12950
442260,2016,6,33,9,42,699
442290,2016,5,67,57,124,6074
442500,2016,6,395,100,495,38927
442710,2016,6,276,96,372,99194
442770,2016,6,13,5,18,407
442810,2016,5,227,190,417,90063
442890,2016,5,33,31,64,3348
443250,2016,7,23,5,28,1537
443260,2016,5,35,21,56,3955
443360,2016,8,112,10,122,6158
443420,2016,8,153,23,176,17964
443450,2016,8,47,8,55,3699
443460,2016,8,44,7,51,6159
443570,2016,5,29,31,60,5400
443580,2016,6,1387,501,1888,137385
443630,2016,8,61,7,68,3432
443650,2016,7,40,6,46,1780
443810,2016,8,4190,812,5002,376582
443830,2016,5,11,9,20,1228
443850,2016,5,11,6,17,371
443860,2016,8,126,18,144,9108
444000,2016,8,72,11,83,1691
444130,2016,8,55,12,67,2948
444140,2016,8,336,28,364,23894
444160,2016,5,77,60,137,34485
444180,2016,5,73,32,105,2027
444210,2016,4,4,11,15,824
444220,2016,5,349,164,513,127104
444260,2016,5,218,104,322,70170
444270,2016,7,37,5,42,3089
444280,2016,8,72,14,86,40862
444350,2016,4,30,103,133,3921
444420,2016,4,19,48,67,2746
444440,2016,5,32,24,56,7240
444520,2016,6,75,20,95,46706
444550,2016,7,22,5,27,951
444590,2016,8,171,31,202,9881
444620,2016,4,26,41,67,19950
444640,2016,8,4575,876,5451,1410438
444670,2016,8,60,8,68,3228
444690,2016,5,56,36,92,2771
444720,2016,5,189,88,277,24304
444740,2016,5,6,5,11,475
444770,2016,8,206,10,216,11170
444800,2016,8,158,21,179,10312
444870,2016,7,8,2,10,1512
444880,2016,5,115,69,184,19986
444930,2016,6,225,68,293,48795
444940,2016,8,174,13,187,12967
445070,2016,7,16,2,18,1145
445110,2016,8,174,17,191,25837
445130,2016,8,593,140,733,51025
445230,2016,8,649,146,795,49841
445600,2016,8,44,11,55,3283
445770,2016,8,155,31,186,16045
446040,2016,8,102,20,122,6842
446070,2016,7,19,2,21,669
446100,2016,6,74,20,94,4983
446240,2016,5,19,9,28,680
446250,2016,5,32,15,47,3022
446310,2016,8,70,4,74,4208
446330,2016,8,48,2,50,3341
446390,2016,6,332,100,432,19323
446540,2016,5,95,62,157,16758
446600,2016,6,52,14,66,7132
446640,2016,8,199,22,221,138730
446770,2016,6,96,28,124,75301
446800,2016,6,3506,949,4455,337931
446870,2016,4,4,14,18,2015
446910,2016,8,54,5,59,8811
446990,2016,6,168,57,225,21389
447010,2016,7,19,1,20,2874
447020,2016,8,8546,698,9244,796543
447170,2016,6,114,30,144,5098
447180,2016,5,53,27,80,3964
447190,2016,8,95,12,107,3985
447200,2016,8,92,10,102,7131
447310,2016,6,56,18,74,9469
447530,2016,9,8906,209,9115,290658
447570,2016,8,250,41,291,21650
447780,2016,8,181,34,215,25250
447800,2016,8,69,12,81,7497
447860,2016,5,34,20,54,8162
447890,2016,8,429,71,500,65918
447950,2016,8,75,4,79,14477
447960,2016,5,29,14,43,2977
447990,2016,5,11,6,17,11453
448000,2016,5,127,112,239,42836
448010,2016,7,27,3,30,20964
448050,2016,7,34,3,37,1811
448070,2016,5,287,215,502,204293
448090,2016,5,14,10,24,6382
448110,2016,5,20,12,32,4249
448160,2016,7,41,3,44,1595
448240,2016,5,150,104,254,26115
448280,2016,8,914,127,1041,203196
448370,2016,8,876,49,925,24334
448380,2016,7,24,3,27,1079
448440,2016,5,185,138,323,82542
448470,2016,5,131,97,228,222993
448480,2016,5,25,15,40,16045
448500,2016,7,25,2,27,9974
448510,2016,8,4876,418,5294,600140
448520,2016,7,28,1,29,5475
448550,2016,7,16,1,17,1437
448560,2016,6,96,35,131,10797
448570,2016,6,75,30,105,13853
448620,2016,5,52,32,84,9694
448630,2016,4,35,53,88,192449
448640,2016,5,54,31,85,293115
448720,2016,6,23,6,29,1374
448730,2016,5,8,4,12,411
448790,2016,5,21,10,31,41006
448910,2016,8,64,12,76,7428
449020,2016,8,347,50,397,48516
449050,2016,5,191,192,383,40244
449060,2016,8,93,18,111,7395
449090,2016,6,44,17,61,2582
449120,2016,5,10,5,15,23929
449170,2016,7,30,1,31,40350
449180,2016,7,25,1,26,1630
449220,2016,5,558,341,899,232984
449250,2016,8,147,11,158,7591
449300,2016,5,211,134,345,20787
449310,2016,7,20,2,22,540
449320,2016,5,11,6,17,420
449340,2016,5,23,11,34,16288
449350,2016,5,8,4,12,595
449450,2016,7,39,3,42,1057
449530,2016,6,339,88,427,253400
449540,2016,8,2797,390,3187,294984
449550,2016,8,71,4,75,7878
449680,2016,8,1769,311,2080,388554
449690,2016,6,42,13,55,1931
449710,2016,6,238,88,326,26076
449730,2016,8,125,10,135,15441
449800,2016,8,2225,433,2658,119678
449820,2016,5,36,28,64,3159
450060,2016,5,24,21,45,2664
450110,2016,6,73,30,103,20442
450190,2016,6,137,37,174,38895
450250,2016,5,17,11,28,1041
450290,2016,5,16,12,28,2635
450440,2016,8,79,6,85,3304
450500,2016,8,208,19,227,16659
450540,2016,9,1721,50,1771,9766
450650,2016,7,18,2,20,3969
450670,2016,6,281,90,371,27120
450760,2016,7,14,1,15,1413
451010,2016,8,112,11,123,8117
451100,2016,7,29,1,30,4295
451400,2016,6,60,23,83,4656
451570,2016,8,114,14,128,4834
451640,2016,7,27,5,32,1808
451760,2016,8,789,43,832,41053
451780,2016,6,206,67,273,25108
451800,2016,5,6,5,11,366
451840,2016,8,481,71,552,35371
451880,2016,6,319,121,440,349290
451990,2016,6,63,26,89,2321
452120,2016,8,41,9,50,4975
452230,2016,5,179,109,288,75066
452420,2016,8,160,22,182,12961
452450,2016,5,58,31,89,7011
452510,2016,8,551,31,582,44801
452860,2016,8,162,14,176,8373
452920,2016,7,29,3,32,3699
452930,2016,4,5,8,13,701
452970,2016,5,63,30,93,4756
453030,2016,6,11,3,14,553
453100,2016,8,172,33,205,42885
453130,2016,7,24,2,26,2176
453290,2016,6,136,36,172,4687
453300,2016,8,65,16,81,7592
453340,2016,8,605,36,641,24411
453650,2016,7,13,3,16,621
453660,2016,5,10,5,15,3517
453710,2016,8,80,19,99,6358
453720,2016,6,86,32,118,7288
453730,2016,5,16,10,26,3529
453740,2016,7,20,2,22,3690
453750,2016,6,199,58,257,27106
453770,2016,5,25,11,36,4394
453780,2016,7,17,1,18,685
453790,2016,8,94,19,113,1814
453810,2016,5,17,11,28,4223
453830,2016,7,9,1,10,5071
453850,2016,5,163,85,248,222892
454060,2016,8,686,144,830,80417
454070,2016,5,147,107,254,11256
454100,2016,8,308,77,385,27255
454130,2016,7,21,4,25,1933
454160,2016,8,109,5,114,2425
454180,2016,5,121,63,184,84274
454190,2016,8,109,10,119,3323
454220,2016,6,62,16,78,26515
454250,2016,8,160,23,183,12260
454320,2016,8,101,7,108,10790
454420,2016,6,15,4,19,4060
454520,2016,6,24,9,33,597
454600,2016,5,269,216,485,120414
454610,2016,5,30,14,44,3327
454630,2016,7,13,1,14,271
454650,2016,6,7107,1898,9005,535273
454700,2016,5,8,10,18,4655
454720,2016,7,13,2,15,1219
454890,2016,8,307,60,367,310160
454900,2016,8,57,5,62,6881
454970,2016,7,28,4,32,5705
455000,2016,5,38,23,61,46323
455110,2016,6,22,7,29,10004
455120,2016,5,171,136,307,26135
455400,2016,8,684,69,753,80832
455490,2016,5,35,24,59,3659
455640,2016,7,12,2,14,1599
455700,2016,5,17,15,32,2921
455830,2016,6,10,3,13,582
455960,2016,5,22,10,32,2397
456130,2016,7,19,2,21,5356
456430,2016,8,166,24,190,11343
456690,2016,7,22,3,25,4460
456780,2016,5,54,29,83,5070
456810,2016,6,107,38,145,34699
456830,2016,7,15,2,17,1861
457210,2016,9,704,35,739,41246
457320,2016,8,383,35,418,28414
457450,2016,6,22,7,29,5878
457480,2016,8,162,25,187,12854
457490,2016,8,142,21,163,28693
457520,2016,5,68,33,101,8392
457530,2016,8,88,18,106,3736
457600,2016,6,83,33,116,4488
457680,2016,8,468,76,544,12623
457690,2016,4,8,28,36,544
457710,2016,4,111,269,380,263944
457770,2016,7,20,3,23,2492
457820,2016,5,69,38,107,287010
457960,2016,8,579,50,629,60792
457980,2016,7,15,3,18,198
458000,2016,6,336,100,436,17202
458030,2016,5,18,14,32,2535
458370,2016,7,20,4,24,5471
458450,2016,4,14,28,42,2334
458470,2016,8,296,23,319,32591
458480,2016,8,132,17,149,22246
458510,2016,7,18,4,22,3711
458630,2016,6,77,25,102,9957
458710,2016,9,1864,64,1928,113038
458730,2016,8,323,48,371,24861
458770,2016,5,297,213,510,33760
458830,2016,5,95,66,161,10089
458920,2016,6,93,29,122,9904
458960,2016,5,300,169,469,102051
459090,2016,8,207,15,222,6077
459130,2016,5,29,13,42,12395
459170,2016,5,21,17,38,9486
459310,2016,5,68,37,105,3049
459440,2016,4,30,53,83,3272
459820,2016,8,5370,717,6087,535661
459940,2016,6,172,68,240,4045
460120,2016,9,1987,71,2058,75376
460150,2016,6,47,16,63,11723
460190,2016,6,34,10,44,12152
460220,2016,8,58,7,65,3643
460340,2016,8,296,31,327,9673
460560,2016,7,20,4,24,3780
460630,2016,8,66,4,70,4638
460640,2016,5,69,47,116,4499
460650,2016,6,31,8,39,1623
460700,2016,8,431,92,523,46714
460750,2016,8,54,11,65,5803
460780,2016,8,67,4,71,3314
460910,2016,8,84,19,103,28651
460960,2016,8,210,32,242,58181
460970,2016,7,23,1,24,2994
461010,2016,6,150,41,191,43190
461030,2016,5,19,11,30,4320
461230,2016,8,138,15,153,12188
461360,2016,8,64,8,72,5471
461480,2016,7,36,4,40,4649
461490,2016,5,52,37,89,8615
461560,2016,8,4078,220,4298,326618
461620,2016,8,945,80,1025,47924
461640,2016,8,558,92,650,130570
461650,2016,5,9,5,14,1113
461680,2016,4,45,88,133,12792
461700,2016,8,207,17,224,13365
461710,2016,7,40,8,48,11507
461750,2016,6,78,31,109,34088
461760,2016,6,42,12,54,31866
461810,2016,7,21,1,22,683
461830,2016,6,12,4,16,4940
461840,2016,9,2048,90,2138,7447
461850,2016,5,42,19,61,20166
461860,2016,5,15,12,27,3046
461880,2016,5,81,68,149,178564
461910,2016,6,1904,534,2438,207263
461940,2016,5,39,31,70,13947
461970,2016,4,53,82,135,50087
462000,2016,8,90,12,102,7356
462070,2016,5,6,5,11,262
462100,2016,8,157,24,181,5539
462130,2016,6,14,5,19,4081
462480,2016,7,38,6,44,2187
462520,2016,7,25,2,27,2011
462620,2016,8,62,1,63,2917
462680,2016,6,174,52,226,22513
462700,2016,5,32,18,50,7986
462730,2016,5,37,22,59,21330
462780,2016,8,3492,557,4049,596551
462830,2016,4,13,32,45,2032
462860,2016,6,28,9,37,2418
462950,2016,5,24,24,48,2718
462960,2016,5,274,139,413,93014
462990,2016,8,179,9,188,9473
463030,2016,5,140,78,218,7982
463060,2016,6,404,128,532,32389
463150,2016,8,1404,208,1612,194090
463160,2016,6,80,22,102,8213
463180,2016,6,71,22,93,36936
463210,2016,8,676,113,789,340127
463220,2016,6,284,81,365,307976
463270,2016,8,1186,86,1272,47745
463320,2016,5,9,13,22,1252
463350,2016,6,292,99,391,93092
463390,2016,8,650,64,714,3090
463460,2016,6,25,7,32,820
463470,2016,5,18,10,28,751
463540,2016,7,15,2,17,204
463760,2016,8,78,16,94,5373
463830,2016,5,5,6,11,179
463860,2016,5,111,59,170,8661
463870,2016,5,11,15,26,4257
463930,2016,8,309,24,333,41512
463980,2016,8,134,16,150,8800
464000,2016,6,30,9,39,2112
464050,2016,6,30,9,39,3624
464230,2016,8,50,11,61,9025
464240,2016,5,14,8,22,669
464380,2016,4,3,9,12,664
464440,2016,5,35,22,57,8009
464450,2016,8,347,10,357,21323
464470,2016,5,182,128,310,9154
464620,2016,8,368,27,395,14584
464650,2016,7,28,4,32,3345
464670,2016,7,15,1,16,1500
464700,2016,5,141,155,296,79707
464800,2016,5,45,47,92,28231
464960,2016,8,193,19,212,190974
465130,2016,8,63,10,73,3653
465170,2016,6,129,55,184,21679
465180,2016,8,59,3,62,3479
465280,2016,8,158,27,185,16846
465440,2016,7,24,6,30,11121
465520,2016,8,3708,196,3904,199147
465660,2016,5,51,39,90,9061
465670,2016,6,13,5,18,4060
465720,2016,5,62,29,91,14930
465750,2016,6,8,3,11,3190
465760,2016,6,180,65,245,20913
465780,2016,8,288,59,347,20818
465840,2016,5,59,26,85,6250
465870,2016,5,17,16,33,2619
466170,2016,8,352,58,410,59270
466270,2016,8,422,56,478,41326
466350,2016,5,61,33,94,5549
466420,2016,6,46,19,65,24957
466430,2016,7,43,1,44,3514
466490,2016,5,37,35,72,10033
466500,2016,6,1692,715,2407,93861
466520,2016,5,19,13,32,2099
466720,2016,8,53,4,57,11090
466730,2016,5,179,100,279,98551
466740,2016,6,269,85,354,16996
466770,2016,7,14,1,15,199
466780,2016,6,41,13,54,7772
466800,2016,6,120,31,151,9796
466820,2016,7,39,6,45,3650
466830,2016,5,34,26,60,10726
466870,2016,8,210,38,248,10277
466920,2016,8,40,10,50,4014
467010,2016,5,37,47,84,283367
467210,2016,8,245,13,258,6360
467310,2016,8,45,11,56,151788
467320,2016,6,51,13,64,8650
467330,2016,7,25,6,31,4073
467350,2016,4,3,8,11,14850
467360,2016,8,657,113,770,73247
467370,2016,5,205,240,445,326346
467380,2016,9,754,34,788,39726
467390,2016,5,143,71,214,121356
467490,2016,7,18,3,21,1169
467520,2016,5,289,263,552,18054
467780,2016,8,66,2,68,1838
467850,2016,5,69,33,102,2818
467930,2016,6,344,111,455,32385
467940,2016,7,15,2,17,1136
467950,2016,6,140,52,192,76580
467960,2016,8,3277,449,3726,267054
468100,2016,6,50,14,64,1602
468490,2016,8,272,66,338,90569
468530,2016,8,806,120,926,26991
468560,2016,5,619,559,1178,179688
468570,2016,5,42,34,76,21575
468700,2016,6,373,96,469,190329
468930,2016,5,76,44,120,14231
469890,2016,8,160,35,195,64256
469980,2016,5,20,15,35,8268
470030,2016,6,18,5,23,746
470060,2016,8,76,19,95,3871
470140,2016,5,6,6,12,3702
470260,2016,8,1164,285,1449,79625
470270,2016,6,194,49,243,167302
470300,2016,6,28,11,39,2535
470440,2016,8,60,1,61,749
470480,2016,6,17,6,23,3980
470590,2016,6,40,14,54,8124
471160,2016,7,15,2,17,1804
471170,2016,5,45,20,65,24956
471270,2016,7,8,2,10,1907
471330,2016,8,291,71,362,55280
471380,2016,6,29,10,39,4157
471730,2016,6,15,5,20,1441
471920,2016,8,88,6,94,3626
472060,2016,8,99,22,121,16627
472420,2016,8,92,18,110,3057
472680,2016,6,443,120,563,82084
472690,2016,5,21,18,39,5195
472830,2016,5,8,5,13,572
472870,2016,8,129,2,131,14157
473050,2016,3,2,15,17,2879
473140,2016,5,38,22,60,49447
473450,2016,8,81,15,96,7926
473460,2016,8,483,41,524,7752
473480,2016,5,9,7,16,3107
473540,2016,4,4,7,11,8330
473670,2016,5,88,101,189,35328
473720,2016,7,12,1,13,260
473910,2016,5,109,58,167,11923
473970,2016,6,105,35,140,14745
474010,2016,5,198,111,309,37636
474050,2016,5,41,38,79,98042
474210,2016,8,468,48,516,25010
474620,2016,6,11,3,14,275
474730,2016,5,6,7,13,2170
474750,2016,8,4094,458,4552,496869
474910,2016,5,86,51,137,33584
474980,2016,8,57,6,63,2076
475150,2016,8,8737,730,9467,1041965
475490,2016,8,286,71,357,13561
475520,2016,6,7,3,10,495
476240,2016,8,392,17,409,24941
476370,2016,7,12,3,15,355
476450,2016,5,24,16,40,787
476460,2016,8,469,47,516,51501
476490,2016,8,70,6,76,6171
476510,2016,5,80,36,116,3869
476530,2016,8,211,17,228,9268
476650,2016,8,145,17,162,11056
476710,2016,5,16,9,25,2081
476920,2016,5,71,39,110,5653
476930,2016,6,44,15,59,3680
477140,2016,5,21,27,48,4731
477170,2016,5,28,13,41,2005
477310,2016,7,37,2,39,3168
477770,2016,8,1012,174,1186,71503
477870,2016,8,572,103,675,37769
477950,2016,7,13,3,16,665
478210,2016,5,34,33,67,1576
479040,2016,5,20,9,29,506
479110,2016,6,25,10,35,2886
479140,2016,7,12,2,14,640
479990,2016,5,31,14,45,2862
480410,2016,7,11,1,12,1335
480450,2016,8,207,12,219,16213
480480,2016,8,188,26,214,58424
480650,2016,8,1513,278,1791,178059
480900,2016,8,78,11,89,2915
481110,2016,6,337,95,432,11277
481180,2016,8,79,8,87,3027
481420,2016,5,21,17,38,11500
482300,2016,6,403,124,527,22083
482330,2016,6,37,10,47,2956
482450,2016,8,320,32,352,20609
482990,2016,7,32,1,33,1192
483420,2016,8,418,32,450,16734
483960,2016,5,160,77,237,11263
483980,2016,9,826,28,854,35910
484950,2016,6,705,218,923,107165
485040,2016,8,400,26,426,10234
485080,2016,5,49,22,71,22228
485160,2016,7,27,3,30,1392
485260,2016,7,31,4,35,3270
485340,2016,6,12,5,17,598
485350,2016,8,338,64,402,139393
485360,2016,8,45,8,53,7803
485370,2016,5,199,90,289,18782
485380,2016,8,1112,225,1337,98409
485430,2016,5,7,5,12,5503
485450,2016,5,132,68,200,37149
485600,2016,7,31,3,34,1539
485620,2016,6,29,10,39,2546
485630,2016,5,17,22,39,1806
485650,2016,5,140,175,315,88435
485690,2016,6,218,69,287,13817
485730,2016,6,117,46,163,68606
485750,2016,5,11,6,17,365
485800,2016,6,57,19,76,4507
485860,2016,6,154,58,212,9874
485870,2016,6,256,69,325,87797
485890,2016,5,497,343,840,30384
485920,2016,7,28,5,33,3068
485970,2016,7,32,2,34,1122
486120,2016,5,23,13,36,8170
486130,2016,5,12,8,20,336
486290,2016,7,25,2,27,6066
486310,2016,8,3065,361,3426,187799
486350,2016,7,14,2,16,887
486470,2016,5,9,9,18,480
486500,2016,5,18,9,27,17421
486510,2016,8,190,42,232,5376
486540,2016,6,123,48,171,15818
486640,2016,5,10,9,19,3629
486720,2016,8,273,32,305,20231
486780,2016,8,387,55,442,75228
486810,2016,7,21,4,25,7405
486850,2016,6,55,15,70,6144
486880,2016,4,45,82,127,28151
487030,2016,6,50,18,68,12519
487160,2016,8,53,5,58,3099
487180,2016,6,143,61,204,215899
487220,2016,6,846,280,1126,411391
487330,2016,8,66,15,81,5730
487350,2016,5,72,44,116,20721
487370,2016,8,140,19,159,117137
487380,2016,7,11,2,13,718
487430,2016,8,1023,98,1121,70540
487530,2016,8,54,12,66,72714
487630,2016,5,28,14,42,2623
487770,2016,8,44,9,53,6530
488040,2016,7,43,4,47,4363
488070,2016,5,6,4,10,614
488220,2016,6,15,5,20,4378
488280,2016,8,415,42,457,31334
488300,2016,8,163,27,190,5830
488330,2016,5,10,5,15,19599
488460,2016,6,17,6,23,9062
488660,2016,8,147,32,179,16938
488770,2016,8,147,32,179,5491
488910,2016,5,147,65,212,25840
488960,2016,7,36,2,38,1448
489000,2016,5,95,51,146,23613
489050,2016,4,3,7,10,234
489170,2016,5,110,51,161,6332
489360,2016,8,555,104,659,40530
489400,2016,6,12,5,17,629
489440,2016,6,27,8,35,1257
489460,2016,6,296,83,379,47986
489580,2016,6,50,17,67,20335
489610,2016,8,370,17,387,14683
489660,2016,8,98,10,108,5490
489720,2016,7,35,3,38,1459
489760,2016,7,29,3,32,1099
490230,2016,8,278,26,304,26082
490300,2016,6,17,7,24,5358
490820,2016,8,223,48,271,44814
490860,2016,6,27,8,35,7990
490870,2016,8,69,14,83,5061
490880,2016,7,32,6,38,13885
490910,2016,5,6,9,15,5915
490950,2016,8,66,3,69,1983
490980,2016,6,80,21,101,166257
491000,2016,8,261,45,306,23827
491040,2016,9,557,22,579,21604
491060,2016,7,13,2,15,2651
491090,2016,5,79,55,134,8080
491130,2016,8,1435,154,1589,208613
491160,2016,6,73,22,95,14490
491220,2016,8,97,10,107,3791
491260,2016,5,122,73,195,264026
491330,2016,8,210,22,232,24715
491350,2016,7,24,1,25,371
491530,2016,5,534,363,897,65408
491560,2016,5,12,9,21,1744
491620,2016,6,54,14,68,5957
491650,2016,5,109,48,157,244440
491670,2016,7,13,3,16,1856
491710,2016,3,2,10,12,524
491720,2016,7,21,5,26,6253
491830,2016,6,17,5,22,497
491950,2016,8,4050,318,4368,228284
492090,2016,6,39,12,51,9068
492170,2016,5,37,17,54,11694
492220,2016,6,100,27,127,8346
492270,2016,8,169,34,203,17449
492280,2016,7,16,4,20,3137
492370,2016,6,37,11,48,3458
492430,2016,6,70,29,99,8313
492500,2016,6,150,46,196,6201
492600,2016,5,11,9,20,25672
492610,2016,4,6,13,19,4163
492630,2016,8,564,74,638,39763
492710,2016,8,98,19,117,7549
492800,2016,5,205,160,365,85793
492870,2016,6,42,13,55,4684
493100,2016,7,28,5,33,617
493340,2016,8,18366,2076,20442,1682734
493370,2016,6,659,274,933,175778
493380,2016,5,9,4,13,966
493620,2016,7,10,2,12,460
493650,2016,4,74,188,262,260100
493720,2016,6,132,42,174,8393
493780,2016,5,16,7,23,22431
493980,2016,6,22,7,29,5318
494100,2016,7,46,1,47,1487
494230,2016,8,486,35,521,27826
494290,2016,4,16,31,47,31467
494350,2016,5,7,9,16,865
494440,2016,5,41,22,63,3132
494450,2016,5,25,26,51,2941
494460,2016,5,19,22,41,2654
494470,2016,5,30,25,55,3269
494600,2016,8,92,22,114,6865
494810,2016,8,171,27,198,14172
494980,2016,5,6,8,14,378
494990,2016,6,15,5,20,1438
495010,2016,4,17,29,46,4863
495090,2016,6,31,11,42,5933
495110,2016,8,346,27,373,32704
495570,2016,6,28,12,40,22116
495680,2016,7,23,3,26,891
495720,2016,8,111,18,129,3617
495730,2016,4,2,8,10,321
495890,2016,9,8446,403,8849,288782
495910,2016,6,1388,408,1796,531876
495960,2016,5,21,12,33,3687
495980,2016,6,81,22,103,4764
495990,2016,8,666,127,793,12612
496250,2016,8,195,24,219,10100
496260,2016,8,143,9,152,8882
496300,2016,8,3407,538,3945,509466
496320,2016,7,12,2,14,6892
496390,2016,7,16,2,18,603
496400,2016,5,25,13,38,1657
496450,2016,7,39,5,44,859
496480,2016,7,14,3,17,411
496490,2016,5,35,29,64,990
496590,2016,7,21,4,25,6392
496630,2016,8,49,6,55,2189
496680,2016,5,161,187,348,217895
496730,2016,5,116,71,187,17114
496810,2016,8,849,97,946,50373
496850,2016,7,10,2,12,378
496890,2016,8,2044,274,2318,108051
496930,2016,8,97,22,119,5434
496980,2016,7,9,2,11,4110
497020,2016,5,15,16,31,29314
497040,2016,6,30,11,41,1491
497080,2016,8,50,12,62,6028
497100,2016,5,53,24,77,67843
497180,2016,8,917,220,1137,55408
497400,2016,6,288,83,371,46785
497420,2016,7,22,4,26,4133
497460,2016,8,49,1,50,2279
497470,2016,5,20,22,42,2281
497510,2016,7,10,1,11,730
497580,2016,5,72,31,103,9079
497640,2016,9,1289,49,1338,142959
497680,2016,6,33,9,42,1169
497700,2016,8,116,17,133,12031
497720,2016,5,22,26,48,5967
497780,2016,8,125,1,126,3145
497850,2016,8,299,62,361,47119
498190,2016,6,116,33,149,5741
498240,2016,6,5119,1615,6734,272720
498330,2016,8,353,41,394,18171
498470,2016,7,33,1,34,768
498570,2016,8,123,25,148,6724
498580,2016,6,23,9,32,858
498660,2016,8,314,78,392,182258
498680,2016,7,10,2,12,104
498830,2016,7,26,6,32,3638
498850,2016,6,19,6,25,1858
499340,2016,7,38,2,40,2973
499440,2016,9,3065,79,3144,91525
499520,2016,8,2312,357,2669,127992
499540,2016,8,62,10,72,20377
499610,2016,6,39,16,55,3118
499620,2016,8,181,44,225,23253
499900,2016,5,9,4,13,2244
499910,2016,7,43,1,44,752
500180,2016,7,9,1,10,256
500320,2016,6,20,6,26,3675
500420,2016,8,47,10,57,4623
500660,2016,5,15,11,26,6435
500690,2016,7,28,3,31,879
500870,2016,6,110,29,139,6084
500940,2016,7,16,4,20,24818
501110,2016,6,48,17,65,5227
501120,2016,8,289,31,320,18685
501190,2016,6,85,26,111,4561
501440,2016,5,11,5,16,1465
501740,2016,5,21,16,37,1156
501860,2016,5,36,20,56,1284
501930,2016,6,53,14,67,138841
501940,2016,5,24,12,36,1793
502100,2016,5,22,16,38,3844
502140,2016,5,94,88,182,286567
502150,2016,7,21,3,24,15018
502200,2016,5,7,6,13,11002
502210,2016,7,36,8,44,1839
502300,2016,5,27,19,46,2491
502320,2016,6,36,11,47,2704
502380,2016,6,26,7,33,5312
502400,2016,6,128,49,177,8523
502410,2016,4,7,20,27,2505
502420,2016,4,12,26,38,3055
502430,2016,4,3,7,10,1026
502440,2016,4,4,7,11,1413
502450,2016,3,2,15,17,1942
502600,2016,7,9,2,11,350
502650,2016,6,22,6,28,1345
502770,2016,6,325,105,430,30281
502810,2016,5,11,8,19,294
502880,2016,4,22,64,86,3302
502940,2016,8,427,65,492,29097
503140,2016,6,15,4,19,1016
503210,2016,8,69,17,86,3318
503300,2016,8,2485,605,3090,192077
503340,2016,8,95,4,99,6042
503450,2016,5,28,25,53,3442
503460,2016,8,119,7,126,4510
503480,2016,5,70,34,104,14304
503680,2016,5,6,4,10,196
503860,2016,7,30,2,32,674
503950,2016,7,33,7,40,6753
503960,2016,6,26,7,33,3046
503980,2016,7,8,2,10,938
504000,2016,8,65,3,68,11813
504010,2016,5,22,12,34,968
504130,2016,8,419,70,489,35530
504210,2016,9,1293,36,1329,112807
504280,2016,5,14,7,21,848
504310,2016,6,72,25,97,45239
504380,2016,7,30,3,33,2776
504390,2016,8,177,9,186,4597
504400,2016,8,144,22,166,19116
504420,2016,6,19,5,24,954
504470,2016,5,6,8,14,207
504810,2016,5,22,14,36,2975
504850,2016,7,10,2,12,550
504880,2016,6,30,11,41,27652
505070,2016,7,22,2,24,1609
505170,2016,6,1060,314,1374,71855
505210,2016,6,172,55,227,84744
505550,2016,5,6,6,12,314
505750,2016,5,368,200,568,147206
506470,2016,7,9,2,11,789
506590,2016,5,49,26,75,7310
506760,2016,4,9,16,25,2667
506830,2016,6,13,4,17,3347
506840,2016,5,11,5,16,3100
507010,2016,6,1379,464,1843,153734
507030,2016,5,10,5,15,3022
507050,2016,6,40,17,57,2729
507060,2016,7,16,1,17,281
507490,2016,6,1186,329,1515,163931
508170,2016,6,265,68,333,48609
508180,2016,6,103,44,147,81306
508230,2016,5,34,16,50,7145
508390,2016,6,536,175,711,110091
508730,2016,6,11,3,14,473
508740,2016,5,48,25,73,3361
508760,2016,6,24,9,33,98740
508790,2016,8,213,23,236,27902
508820,2016,5,24,13,37,10442
508840,2016,6,17,7,24,4915
508990,2016,8,103,6,109,6344
509110,2016,8,258,55,313,248909
509160,2016,7,23,1,24,264
509170,2016,5,7,7,14,1014
509190,2016,5,30,27,57,5402
509210,2016,5,29,13,42,3047
509220,2016,8,1160,130,1290,99497
509290,2016,6,24,9,33,851
509420,2016,5,219,101,320,74643
509600,2016,6,88,25,113,33118
509820,2016,7,9,1,10,207
509960,2016,5,20,21,41,12328
510040,2016,7,23,1,24,991
510290,2016,7,29,6,35,1861
510570,2016,5,29,18,47,1932
510620,2016,8,173,30,203,14481
510650,2016,6,73,19,92,14848
511010,2016,5,18,11,29,1224
511070,2016,5,6,8,14,1038
511090,2016,8,171,26,197,6029
511140,2016,8,119,11,130,6360
511160,2016,6,79,27,106,36571
511190,2016,5,19,13,32,903
511330,2016,5,9,9,18,41280
511350,2016,8,126,6,132,7327
511380,2016,7,19,1,20,3069
511460,2016,6,10,4,14,307
511470,2016,9,1262,24,1286,35594
511490,2016,5,20,9,29,35342
511500,2016,7,29,6,35,841
511630,2016,8,63,12,75,5341
511700,2016,7,11,1,12,276
511740,2016,8,1001,170,1171,70444
511750,2016,6,40,14,54,9934
511820,2016,7,13,2,15,4206
512170,2016,5,47,26,73,1319
512230,2016,8,130,12,142,5271
512240,2016,7,37,2,39,1984
512250,2016,8,2122,184,2306,231286
512260,2016,7,23,2,25,1282
512300,2016,8,320,62,382,43652
512550,2016,6,17,7,24,29018
512560,2016,5,38,37,75,7453
512740,2016,8,49,2,51,26529
512770,2016,5,18,8,26,32528
512790,2016,8,781,54,835,32402
513210,2016,6,33,12,45,4354
513230,2016,8,963,164,1127,16075
513320,2016,5,56,64,120,5416
513340,2016,8,48,2,50,19018
513370,2016,5,44,46,90,5201
513440,2016,5,73,65,138,51360
513450,2016,8,889,103,992,246280
513460,2016,5,19,25,44,1561
513510,2016,8,1216,171,1387,111346
513580,2016,5,16,7,23,5934
513590,2016,4,30,65,95,170384
513620,2016,5,71,59,130,167127
513780,2016,6,863,252,1115,534698
513820,2016,6,25,7,32,26799
513880,2016,5,37,16,53,32403
513980,2016,6,33,9,42,19979
513990,2016,5,29,16,45,1278
514090,2016,8,79,12,91,5849
514240,2016,5,50,58,108,7594
514310,2016,8,362,22,384,20860
514570,2016,5,5,7,12,325
514640,2016,7,10,2,12,339
514650,2016,7,35,5,40,6089
514660,2016,5,104,45,149,187505
514670,2016,5,37,23,60,3329
514780,2016,5,7,7,14,786
514890,2016,8,56,7,63,5082
515040,2016,8,1317,175,1492,87399
515470,2016,5,105,130,235,258593
515570,2016,8,132,10,142,10932
515650,2016,8,86,5,91,7441
515690,2016,5,51,61,112,242938
515740,2016,7,12,3,15,305
515910,2016,5,77,34,111,99536
516010,2016,7,14,1,15,13717
516040,2016,5,11,7,18,799
516120,2016,7,9,1,10,212
516750,2016,8,9472,894,10366,416575
516840,2016,7,44,4,48,3600
516890,2016,7,18,3,21,1007
516920,2016,5,6,4,10,3308
516940,2016,7,18,3,21,2347
517140,2016,6,12,5,17,525
517230,2016,7,13,1,14,518
517330,2016,8,47,7,54,4883
517350,2016,8,51,9,60,6434
517360,2016,6,57,17,74,13566
517370,2016,8,111,27,138,11141
517470,2016,7,19,2,21,5498
517620,2016,7,8,2,10,407
517680,2016,6,18,7,25,1730
517710,2016,8,1989,280,2269,141173
517910,2016,8,611,41,652,20739
517930,2016,7,18,1,19,821
517970,2016,7,16,1,17,335
518120,2016,6,98,32,130,8538
518320,2016,6,19,8,27,1904
518620,2016,4,50,106,156,35115
518650,2016,7,22,2,24,4033
518660,2016,5,286,231,517,95736
518670,2016,8,137,19,156,8993
518730,2016,8,171,18,189,11656
518920,2016,5,71,37,108,19264
519020,2016,5,8,6,14,695
519990,2016,3,2,10,12,4584
520150,2016,7,18,3,21,1929
520290,2016,5,18,8,26,1619
520440,2016,8,1688,106,1794,124487
520470,2016,6,36,15,51,2406
520530,2016,5,658,283,941,59797
520610,2016,7,31,6,37,3378
520850,2016,8,128,8,136,3600
520910,2016,8,62,3,65,5909
520930,2016,7,14,1,15,333
521130,2016,8,57,4,61,31939
521200,2016,9,628,30,658,87341
521280,2016,7,20,4,24,3347
521340,2016,5,855,405,1260,152034
521540,2016,7,20,3,23,1038
521580,2016,6,46,14,60,3697
521630,2016,8,229,45,274,62350
522010,2016,7,30,4,34,29107
522030,2016,5,67,35,102,5023
522090,2016,4,45,84,129,63906
522200,2016,4,10,21,31,450
522340,2016,7,27,1,28,952
522490,2016,8,77,2,79,7575
522570,2016,4,211,372,583,359502
522990,2016,7,16,2,18,2674
523000,2016,8,415,35,450,32094
523090,2016,7,43,6,49,2690
523150,2016,7,22,4,26,42629
523160,2016,6,68,22,90,38716
523680,2016,6,25,7,32,3745
523730,2016,5,37,16,53,10277
523760,2016,7,22,5,27,1136
523810,2016,6,43,14,57,2134
524540,2016,7,26,4,30,3680
524560,2016,7,28,2,30,2686
524660,2016,6,127,35,162,8765
524850,2016,8,291,36,327,23364
524970,2016,5,230,292,522,114929
525190,2016,5,17,22,39,26637
525300,2016,5,20,16,36,58355
525350,2016,5,10,11,21,1567
525370,2016,6,35,10,45,2142
525450,2016,7,30,3,33,2233
525500,2016,7,27,6,33,2108
525610,2016,5,82,58,140,5203
525740,2016,7,18,1,19,928
526430,2016,5,46,22,68,6288
526490,2016,8,88,3,91,12326
526510,2016,7,21,3,24,296
526540,2016,5,129,68,197,36651
526590,2016,5,13,9,22,861
526800,2016,7,41,3,44,1644
526980,2016,5,14,14,28,2650
527210,2016,6,14,6,20,626
527420,2016,8,55,9,64,11551
527470,2016,8,47,8,55,3596
527730,2016,5,11,13,24,1477
527740,2016,7,36,5,41,1891
527760,2016,5,108,95,203,198381
527770,2016,5,79,87,166,208002
527790,2016,5,17,15,32,82123
527820,2016,7,19,1,20,2147
527990,2016,6,85,33,118,34210
528070,2016,6,19,7,26,40452
528110,2016,7,17,4,21,2559
528120,2016,5,9,4,13,1747
528250,2016,7,24,5,29,1899
528270,2016,7,28,3,31,381
528300,2016,6,125,38,163,23878
528510,2016,5,157,76,233,285208
528660,2016,6,226,60,286,81872
528720,2016,8,98,20,118,12430
528730,2016,5,31,19,50,1432
528740,2016,5,98,145,243,57027
528770,2016,7,13,1,14,2979
528820,2016,5,64,47,111,16145
528950,2016,7,12,1,13,2939
528990,2016,7,11,1,12,548
529130,2016,5,40,20,60,4371
529150,2016,8,316,7,323,30050
529160,2016,8,209,22,231,16958
529280,2016,5,9,9,18,322
529410,2016,7,30,5,35,1413
529420,2016,5,7,5,12,3717
529480,2016,6,37,13,50,11010
529500,2016,5,23,12,35,3323
529580,2016,7,9,2,11,995
529590,2016,8,120,15,135,18767
529780,2016,8,1092,79,1171,83420
529900,2016,8,95,15,110,14407
529950,2016,8,153,22,175,14308
530040,2016,5,102,79,181,6358
530390,2016,9,503,16,519,38453
530540,2016,5,32,25,57,84360
530740,2016,6,12,4,16,4163
530890,2016,8,2026,358,2384,131975
530960,2016,5,72,36,108,4862
531110,2016,7,15,3,18,1403
531240,2016,5,14,12,26,26807
531480,2016,7,14,2,16,344
531540,2016,6,32,10,42,2791
531680,2016,8,182,39,221,28037
531730,2016,8,97,4,101,5805
531740,2016,6,45,14,59,4163
531890,2016,6,73,26,99,5635
531910,2016,7,28,3,31,2149
531930,2016,6,205,52,257,16140
531960,2016,6,629,183,812,119133
531990,2016,7,33,1,34,7172
532030,2016,5,41,37,78,48988
532110,2016,9,1512,71,1583,103841
532270,2016,8,84,10,94,4861
532290,2016,8,81,17,98,7400
532660,2016,5,14,13,27,4625
532700,2016,5,9,5,14,3296
533010,2016,6,47,17,64,2927
533180,2016,4,11,31,42,37782
533260,2016,6,14,6,20,583
533300,2016,8,4876,306,5182,179370
533320,2016,5,15,13,28,4826
533330,2016,5,39,32,71,21422
533690,2016,6,160,64,224,44119
533820,2016,6,64,24,88,277061
533860,2016,4,34,52,86,121128
533890,2016,5,13,6,19,4392
533950,2016,8,117,18,135,5222
534200,2016,6,12,4,16,4364
534230,2016,8,68,15,83,2425
534290,2016,8,237,41,278,38531
534320,2016,5,6,6,12,1361
534440,2016,7,19,4,23,877
534570,2016,5,25,14,39,6227
534910,2016,5,19,10,29,781
535000,2016,7,23,1,24,1076
535380,2016,7,10,1,11,882
535440,2016,4,6,16,22,1655
535630,2016,7,27,6,33,1202
535700,2016,5,23,10,33,3248
535750,2016,6,7,3,10,1287
535890,2016,7,13,3,16,1603
535910,2016,7,19,1,20,1105
535980,2016,7,31,2,33,1442
536040,2016,5,44,20,64,3636
536220,2016,6,5776,1809,7585,278042
536320,2016,5,16,23,39,6025
536430,2016,7,22,5,27,2578
536490,2016,7,18,4,22,2504
536530,2016,5,10,7,17,596
536630,2016,5,14,14,28,709
536640,2016,5,31,36,67,3034
536750,2016,7,32,8,40,3474
536780,2016,8,57,8,65,8174
536990,2016,8,59,12,71,3541
537200,2016,5,22,16,38,8323
537990,2016,5,300,168,468,12390
538060,2016,5,45,38,83,25642
538550,2016,7,17,4,21,1528
538590,2016,4,68,123,191,243018
538710,2016,7,31,1,32,1574
538790,2016,5,7,10,17,625
538920,2016,5,11,13,24,2944
538950,2016,7,31,6,37,13654
539370,2016,7,24,5,29,2479
539380,2016,6,52,16,68,8493
539460,2016,7,19,3,22,121776
539640,2016,5,130,99,229,51259
539670,2016,8,178,23,201,36606
539720,2016,8,361,47,408,51888
539750,2016,6,47,16,63,23261
540020,2016,5,46,59,105,256959
540060,2016,8,42,10,52,2495
540100,2016,5,98,51,149,14562
540150,2016,5,6,4,10,501
540550,2016,5,8,8,16,411
540610,2016,8,962,144,1106,63983
540640,2016,6,13,5,18,72237
540660,2016,7,13,3,16,1456
540840,2016,8,828,87,915,72299
540880,2016,8,83,6,89,2608
541160,2016,7,10,2,12,310
541370,2016,4,93,217,310,171048
541380,2016,4,15,24,39,9221
541570,2016,9,726,30,756,28751
541720,2016,5,18,13,31,2816
542260,2016,8,303,16,319,19072
542340,2016,5,528,560,1088,201881
542350,2016,8,106,22,128,17386
542550,2016,5,31,15,46,32377
542680,2016,5,7,7,14,733
542930,2016,4,6,10,16,37799
543140,2016,8,405,92,497,35780
543360,2016,5,49,37,86,56898
543430,2016,5,14,8,22,2584
543650,2016,5,19,16,35,132308
543710,2016,6,11,3,14,489
543980,2016,8,65,7,72,3607
544180,2016,8,166,1,167,35266
544190,2016,7,38,8,46,6984
544530,2016,7,38,3,41,4165
544600,2016,8,68,9,77,4937
544650,2016,7,17,4,21,1987
544710,2016,7,19,2,21,2506
544800,2016,5,7,10,17,1019
544840,2016,6,37,14,51,10601
544870,2016,5,17,16,33,4671
545030,2016,7,46,2,48,6237
545050,2016,5,128,83,211,4485
545330,2016,5,13,19,32,1408
545570,2016,5,19,14,33,3518
545580,2016,6,97,41,138,51051
545690,2016,8,383,22,405,20149
545820,2016,5,75,66,141,10929
545860,2016,5,46,29,75,39410
545960,2016,8,60,6,66,5638
546030,2016,5,5,6,11,239
546080,2016,8,248,16,264,8169
546090,2016,8,87,7,94,3513
546170,2016,7,14,2,16,8728
546180,2016,5,10,5,15,599
546200,2016,7,16,1,17,41969
546330,2016,7,9,1,10,534
546490,2016,5,27,31,58,12445
546550,2016,8,56,7,63,2634
546660,2016,5,28,36,64,105386
546700,2016,5,77,49,126,170502
546780,2016,7,20,3,23,924
546790,2016,5,8,4,12,320
547010,2016,5,57,45,102,15681
547090,2016,5,11,5,16,29531
547260,2016,6,43,11,54,4592
547310,2016,5,46,30,76,21057
547340,2016,8,144,22,166,17905
547410,2016,5,449,257,706,21760
547540,2016,8,48,6,54,5943
547590,2016,8,135,27,162,7127
547730,2016,6,10,3,13,472
547900,2016,8,96,23,119,5864
547960,2016,5,244,227,471,337145
547980,2016,7,32,1,33,663
547990,2016,5,6,4,10,982
548050,2016,7,11,2,13,674
548080,2016,6,16,6,22,34392
548230,2016,8,51,7,58,6681
548330,2016,7,44,1,45,3098
548340,2016,8,204,12,216,7617
548710,2016,5,6,7,13,73852
548860,2016,6,21,6,27,691
549400,2016,7,13,3,16,767
549670,2016,4,7,11,18,985
549740,2016,8,47,4,51,1494
549770,2016,4,13,34,47,2074
549860,2016,8,324,31,355,21217
550010,2016,8,664,134,798,147158
550240,2016,5,15,8,23,474
550310,2016,8,218,23,241,9227
550450,2016,5,12,7,19,1548
550810,2016,8,52,3,55,4141
551110,2016,8,441,49,490,47511
551190,2016,8,53,9,62,1887
551320,2016,5,9,4,13,278
551520,2016,7,31,6,37,12104
551580,2016,7,44,5,49,1148
551720,2016,6,22,9,31,2013
552060,2016,7,40,3,43,3071
552130,2016,4,40,66,106,7268
552160,2016,8,59,6,65,8019
552230,2016,6,9,3,12,506
552300,2016,7,8,2,10,673
552410,2016,5,31,17,48,8095
552580,2016,5,10,5,15,2624
552610,2016,7,11,2,13,381
552720,2016,6,7,3,10,1446
552780,2016,6,26,9,35,122688
553000,2016,4,7,14,21,2678
553450,2016,5,19,13,32,3613
553590,2016,8,57,3,60,9521
553610,2016,6,12,5,17,556
553640,2016,8,14985,1299,16284,437615
553780,2016,7,12,1,13,5347
553790,2016,8,510,84,594,84282
553800,2016,5,23,13,36,2441
553820,2016,6,17,7,24,34743
554310,2016,6,183,72,255,20329
554640,2016,6,279,89,368,63972
554680,2016,5,9,4,13,608
554800,2016,8,53,12,65,7953
555060,2016,8,66,9,75,8544
555210,2016,8,2456,285,2741,164544
555290,2016,7,35,6,41,2037
555320,2016,8,57,6,63,4725
555610,2016,8,63,12,75,6977
555640,2016,6,124,34,158,18127
555710,2016,6,98,29,127,18858
555720,2016,7,29,6,35,1281
555730,2016,6,11,3,14,300
555750,2016,5,188,102,290,15081
555850,2016,5,13,6,19,31359
556160,2016,5,57,76,133,149079
556190,2016,7,16,2,18,678
556280,2016,6,121,45,166,82514
556710,2016,7,12,3,15,267
556870,2016,5,107,57,164,70634
556890,2016,7,29,5,34,775
557040,2016,8,242,34,276,10553
557680,2016,5,87,64,151,267647
557700,2016,6,7,3,10,1196
557770,2016,6,13,5,18,2472
557790,2016,7,13,1,14,49822
557810,2016,5,267,229,496,131966
557860,2016,7,10,1,11,213
557890,2016,8,75,9,84,6131
558410,2016,7,13,2,15,1575
558850,2016,5,14,8,22,868
558870,2016,4,23,44,67,3428
559450,2016,6,7,3,10,3958
559900,2016,5,75,34,109,993
560010,2016,5,6,4,10,156
560050,2016,8,51,6,57,5009
560220,2016,7,25,3,28,5559
560260,2016,8,1833,186,2019,202966
560710,2016,5,13,8,21,14947
560770,2016,6,7,3,10,447
561000,2016,7,18,1,19,2545
561190,2016,7,29,3,32,1309
561230,2016,6,14,4,18,1104
561340,2016,8,97,16,113,31024
562050,2016,6,41,12,53,4164
562220,2016,9,3835,187,4022,152851
562320,2016,7,29,5,34,2447
562360,2016,8,324,40,364,48265
562520,2016,5,31,35,66,124879
562570,2016,8,105,26,131,6691
562660,2016,7,29,5,34,9676
562690,2016,4,6,16,22,3830
563130,2016,6,14,4,18,539
563750,2016,5,44,27,71,4172
564010,2016,4,57,115,172,9877
565110,2016,7,13,1,14,25646
565380,2016,6,27,9,36,14694
565720,2016,8,182,34,216,15981
566550,2016,5,14,16,30,1281
566870,2016,7,12,2,14,1078
567040,2016,4,12,22,34,6617
567210,2016,7,38,5,43,37493
567280,2016,8,430,50,480,78780
567290,2016,8,712,67,779,116068
567580,2016,8,186,46,232,65299
567800,2016,8,80,9,89,8734
568030,2016,7,15,1,16,911
568090,2016,8,1012,122,1134,70929
568340,2016,5,34,23,57,1344
568370,2016,7,25,2,27,605
568500,2016,7,12,2,14,1370
568570,2016,6,1343,479,1822,139115
568610,2016,7,23,2,25,2169
568860,2016,6,14,5,19,26230
569380,2016,7,10,1,11,1393
569610,2016,6,105,36,141,62738
570350,2016,5,18,9,27,3826
570490,2016,7,38,2,40,1433
570890,2016,5,13,12,25,5156
570910,2016,3,2,13,15,2440
571520,2016,5,9,4,13,2874
572000,2016,6,44,15,59,12018
573210,2016,5,18,13,31,22443
574030,2016,5,57,39,96,64459
574580,2016,6,35,13,48,47859
575010,2016,6,65,21,86,6449
