app_id,review_score,review_score_desc,total_positive,total_negative,total_reviews
220,9,Overwhelmingly Positive,54855,1761,56616
240,9,Overwhelmingly Positive,65877,2798,68675
300,8,Very Positive,9014,937,9951
380,8,Very Positive,6168,352,6520
400,9,Overwhelmingly Positive,43124,794,43918
420,9,Overwhelmingly Positive,11237,495,11732
440,8,Very Positive,446494,28380,474874
500,9,Overwhelmingly Positive,14637,731,15368
550,9,Overwhelmingly Positive,210383,6339,216722
620,9,Overwhelmingly Positive,113776,1338,115114
630,9,Overwhelmingly Positive,16119,777,16896
730,8,Very Positive,2160849,277888,2438737
852,0,No user reviews,0,0,0
1200,8,Very Positive,1335,176,1511
1250,9,Overwhelmingly Positive,49902,2286,52188
1520,8,Very Positive,1875,304,2179
1530,8,Very Positive,337,65,402
1840,8,Very Positive,11458,738,12196
2450,6,Mostly Positive,598,179,777
2820,8,Very Positive,1523,239,1762
2870,5,Mixed,2632,3838,6470
3540,8,Very Positive,315,20,335
3590,9,Overwhelmingly Positive,11809,297,12106
3620,8,Very Positive,367,20,387
3830,9,Overwhelmingly Positive,7378,376,7754
4000,9,Overwhelmingly Positive,297556,12631,310187
4920,8,Very Positive,7798,1337,9135
6120,8,Very Positive,1551,186,1737
6600,5,Mixed,36,32,68
7520,5,Mixed,2754,1849,4603
8190,8,Very Positive,29030,2534,31564
8740,0,No user reviews,0,0,0
8850,8,Very Positive,7815,831,8646
8870,9,Overwhelmingly Positive,69661,3237,72898
8930,9,Overwhelmingly Positive,115676,4236,119912
8955,0,No user reviews,0,0,0
8970,6,Mostly Positive,31,12,43
8980,8,Very Positive,20087,1365,21452
9500,5,Mixed,153,91,244
9880,6,Mostly Positive,1883,701,2584
9940,8,Very Positive,696,133,829
9970,3,Negative,5,24,29
10180,8,Very Positive,26250,2398,28648
10220,4,Mostly Negative,525,919,1444
10500,8,Very Positive,13232,1263,14495
10680,8,Very Positive,8114,981,9095
11240,5,Mixed,287,295,582
11280,8,Very Positive,811,113,924
11330,8,Very Positive,548,120,668
11340,6,Mostly Positive,493,149,642
12900,9,Overwhelmingly Positive,8586,351,8937
13000,8,Very Positive,48,4,52
13120,0,No user reviews,0,0,0
13140,5,Mixed,1457,679,2136
13210,8,Very Positive,2179,229,2408
15400,8,Very Positive,85,20,105
15500,6,Mostly Positive,393,135,528
15520,8,Very Positive,551,98,649
15540,4,Mostly Negative,142,322,464
15560,6,Mostly Positive,714,228,942
15620,8,Very Positive,5238,654,5892
15740,6,Mostly Positive,376,131,507
15750,8,Very Positive,682,117,799
15800,0,2 user reviews,1,1,2
16500,7,Positive,10,1,11
16600,8,Very Positive,165,33,198
17100,8,Very Positive,161,31,192
17120,8,Very Positive,47,10,57
17140,6,Mostly Positive,109,36,145
17180,6,Mostly Positive,15,6,21
17500,8,Very Positive,4607,715,5322
17570,8,Very Positive,3306,471,3777
17580,8,Very Positive,680,131,811
17710,6,Mostly Positive,1575,404,1979
17740,8,Very Positive,586,89,675
17760,0,No user reviews,0,0,0
18000,8,Very Positive,385,40,425
18020,8,Very Positive,116,20,136
18040,8,Very Positive,504,29,533
18050,8,Very Positive,120,18,138
18070,8,Very Positive,145,36,181
18310,0,No user reviews,0,0,0
18500,9,Overwhelmingly Positive,3268,104,3372
18600,5,Mixed,12,10,22
18700,5,Mixed,727,313,1040
18820,8,Very Positive,612,149,761
19020,5,Mixed,15,7,22
19030,6,Mostly Positive,64,18,82
19200,5,Mixed,214,177,391
19320,5,Mixed,6,7,13
19500,4,Mostly Negative,12,46,58
20200,4,Mostly Negative,6,10,16
20500,8,Very Positive,5896,620,6516
20570,8,Very Positive,1537,137,1674
20700,6,Mostly Positive,48,15,63
20710,8,Very Positive,55,11,66
20820,8,Very Positive,962,61,1023
20920,8,Very Positive,31185,3823,35008
21100,6,Mostly Positive,4782,1800,6582
21300,6,Mostly Positive,16,5,21
21400,5,Mixed,9,5,14
21640,6,Mostly Positive,108,33,141
21690,8,Very Positive,7310,1211,8521
22000,8,Very Positive,3180,204,3384
22200,8,Very Positive,1876,328,2204
22230,8,Very Positive,2419,210,2629
22310,5,Mixed,368,209,577
22350,5,Mixed,3049,2033,5082
22380,9,Overwhelmingly Positive,55309,2336,57645
22490,8,Very Positive,2525,482,3007
22500,8,Very Positive,125,16,141
22600,8,Very Positive,2278,384,2662
22610,6,Mostly Positive,687,272,959
22650,5,Mixed,432,204,636
22670,6,Mostly Positive,207,75,282
23130,0,7 user reviews,6,1,7
23140,7,Positive,17,1,18
23150,6,Mostly Positive,12,5,17
23530,8,Very Positive,702,69,771
24200,8,Very Positive,8966,2239,11205
24240,8,Very Positive,31919,2223,34142
24420,8,Very Positive,975,121,1096
24480,5,Mixed,172,156,328
25700,8,Very Positive,183,39,222
25730,0,No user reviews,0,0,0
26000,8,Very Positive,153,33,186
26300,4,Mostly Negative,11,29,40
26500,8,Very Positive,646,81,727
26800,8,Very Positive,6137,354,6491
27330,4,Mostly Negative,123,193,316
27600,7,Positive,21,2,23
27920,5,Mixed,87,91,178
27940,4,Mostly Negative,196,398,594
28000,5,Mixed,2271,1480,3751
29017,0,No user reviews,0,0,0
29180,8,Very Positive,820,98,918
31280,8,Very Positive,5506,833,6339
31700,8,Very Positive,304,51,355
31980,5,Mixed,12,8,20
32150,8,Very Positive,299,6,305
32160,8,Very Positive,215,38,253
32200,5,Mixed,76,44,120
32410,6,Mostly Positive,37,15,52
32460,9,Overwhelmingly Positive,1082,49,1131
33390,6,Mostly Positive,24,7,31
33650,8,Very Positive,284,38,322
33660,6,Mostly Positive,21,8,29
33670,5,Mixed,161,123,284
33680,8,Very Positive,904,81,985
33930,8,Very Positive,16375,1305,17680
33980,5,Mixed,74,44,118
34030,8,Very Positive,7309,621,7930
34270,8,Very Positive,1267,305,1572
34500,7,Positive,31,7,38
34830,5,Mixed,1759,1374,3133
34870,6,Mostly Positive,5362,2096,7458
34900,6,Mostly Positive,9475,2723,12198
34920,4,Mostly Negative,47,149,196
35130,8,Very Positive,2309,194,2503
35140,9,Overwhelmingly Positive,17684,659,18343
35320,8,Very Positive,292,58,350
35450,8,Very Positive,24118,1958,26076
35460,6,Mostly Positive,578,192,770
35470,0,No user reviews,0,0,0
35480,6,Mostly Positive,569,156,725
35600,5,Mixed,43,35,78
35700,9,Overwhelmingly Positive,8516,351,8867
35720,9,Overwhelmingly Positive,14968,588,15556
36000,5,Mixed,176,103,279
37500,6,Mostly Positive,32,9,41
37800,5,Mixed,25,12,37
38230,5,Mixed,54,77,131
38600,8,Very Positive,2071,192,2263
38700,8,Very Positive,1562,210,1772
38720,8,Very Positive,996,111,1107
39110,6,Mostly Positive,145,39,184
39140,8,Very Positive,10623,755,11378
39150,8,Very Positive,4876,559,5435
39160,5,Mixed,992,634,1626
39800,8,Very Positive,1944,247,2191
40100,8,Very Positive,4738,781,5519
40390,6,Mostly Positive,2681,785,3466
40400,8,Very Positive,956,168,1124
40420,5,Mixed,126,63,189
40700,9,Overwhelmingly Positive,4544,211,4755
40800,9,Overwhelmingly Positive,21448,1041,22489
40930,8,Very Positive,319,38,357
40960,8,Very Positive,456,82,538
40980,6,Mostly Positive,320,92,412
41000,8,Very Positive,3374,220,3594
41070,8,Very Positive,13693,1671,15364
41300,8,Very Positive,1436,106,1542
41740,6,Mostly Positive,252,64,316
41900,6,Mostly Positive,586,168,754
42000,5,Mixed,8,5,13
42120,6,Mostly Positive,1293,470,1763
42140,5,Mixed,167,79,246
42170,5,Mixed,412,309,721
42500,5,Mixed,229,141,370
42700,8,Very Positive,12481,1532,14013
42910,8,Very Positive,19454,1409,20863
42990,5,Mixed,323,425,748
43000,5,Mixed,432,290,722
43190,8,Very Positive,464,69,533
43600,7,Positive,36,4,40
44100,8,Very Positive,73,9,82
44350,8,Very Positive,9095,2089,11184
45000,8,Very Positive,286,29,315
45100,8,Very Positive,1273,248,1521
45300,5,Mixed,299,131,430
45400,8,Very Positive,764,66,830
45410,5,Mixed,142,107,249
45420,7,Positive,10,1,11
45450,8,Very Positive,442,42,484
45730,5,Mixed,123,127,250
45740,6,Mostly Positive,2294,783,3077
45760,8,Very Positive,7602,1015,8617
45770,6,Mostly Positive,1142,315,1457
46000,6,Mostly Positive,71,29,100
46450,5,Mixed,202,127,329
46470,0,No user reviews,0,0,0
46520,5,Mixed,158,117,275
46570,5,Mixed,96,79,175
46600,6,Mostly Positive,39,12,51
46770,6,Mostly Positive,185,55,240
47000,8,Very Positive,524,85,609
47540,8,Very Positive,250,49,299
47800,5,Mixed,344,156,500
48000,8,Very Positive,27176,1657,28833
48700,9,Overwhelmingly Positive,64072,1698,65770
48720,8,Very Positive,5157,796,5953
48950,8,Very Positive,392,61,453
49300,5,Mixed,57,66,123
49320,5,Mixed,29,25,54
49330,5,Mixed,75,43,118
49470,8,Very Positive,720,93,813
49520,9,Overwhelmingly Positive,119815,4536,124351
49540,5,Mixed,3777,3149,6926
49600,9,Overwhelmingly Positive,6028,292,6320
49810,8,Very Positive,105,23,128
49900,5,Mixed,178,78,256
50000,8,Very Positive,180,10,190
50130,8,Very Positive,26419,1541,27960
50400,7,Positive,43,6,49
50510,5,Mixed,57,85,142
50620,8,Very Positive,8038,906,8944
51060,8,Very Positive,73,11,84
55020,5,Mixed,39,28,67
55040,8,Very Positive,1385,164,1549
55100,5,Mixed,4496,3003,7499
55110,6,Mostly Positive,2451,886,3337
55140,8,Very Positive,1427,316,1743
55150,8,Very Positive,7279,574,7853
55190,0,No user reviews,0,0,0
55210,0,No user reviews,0,0,0
55230,9,Overwhelmingly Positive,38409,1416,39825
57000,8,Very Positive,83,9,92
57200,8,Very Positive,395,37,432
57300,8,Very Positive,17767,958,18725
57680,6,Mostly Positive,421,177,598
57690,8,Very Positive,8081,724,8805
57700,6,Mostly Positive,97,39,136
57800,5,Mixed,73,86,159
57900,5,Mixed,4097,2017,6114
58200,8,Very Positive,247,30,277
58230,8,Very Positive,79,15,94
58400,4,Mostly Negative,42,80,122
58550,4,Mostly Negative,192,399,591
58610,6,Mostly Positive,1766,510,2276
60350,8,Very Positive,67,9,76
60600,5,Mixed,27,21,48
60700,4,Mostly Negative,9,25,34
61100,6,Mostly Positive,163,51,214
61600,8,Very Positive,415,58,473
61700,8,Very Positive,1191,108,1299
61730,8,Very Positive,245,13,258
62000,8,Very Positive,407,33,440
62100,8,Very Positive,581,38,619
63000,8,Very Positive,648,159,807
63200,6,Mostly Positive,709,192,901
63230,0,No user reviews,0,0,0
63380,8,Very Positive,18751,2493,21244
63700,8,Very Positive,600,140,740
63710,8,Very Positive,2921,457,3378
63940,5,Mixed,347,211,558
64000,8,Very Positive,2609,351,2960
65300,8,Very Positive,1519,197,1716
65400,8,Very Positive,85,17,102
65710,8,Very Positive,253,48,301
65800,8,Very Positive,10202,847,11049
65980,5,Mixed,8945,7767,16712
67000,6,Mostly Positive,334,106,440
67370,8,Very Positive,9732,1009,10741
70000,8,Very Positive,11018,2113,13131
70120,4,Mostly Negative,157,282,439
70300,9,Overwhelmingly Positive,6175,233,6408
70500,6,Mostly Positive,31,12,43
70600,8,Very Positive,1760,235,1995
70620,8,Very Positive,360,79,439
71230,8,Very Positive,860,215,1075
71240,8,Very Positive,260,50,310
71250,8,Very Positive,2210,440,2650
71260,8,Very Positive,495,71,566
71300,0,No user reviews,0,0,0
71310,0,No user reviews,0,0,0
71340,8,Very Positive,5887,434,6321
72000,8,Very Positive,649,94,743
72200,8,Very Positive,2203,489,2692
72400,6,Mostly Positive,219,66,285
72500,5,Mixed,35,38,73
72520,0,No user reviews,0,0,0
72530,0,No user reviews,0,0,0
72850,8,Very Positive,216040,13281,229321
72900,5,Mixed,132,73,205
73010,6,Mostly Positive,576,161,737
73060,4,Mostly Negative,32,64,96
78000,9,Overwhelmingly Positive,2373,99,2472
80000,4,Mostly Negative,44,109,153
80200,6,Mostly Positive,258,65,323
80310,8,Very Positive,1141,114,1255
80330,8,Very Positive,789,96,885
80340,8,Very Positive,322,21,343
80350,8,Very Positive,258,14,272
80360,8,Very Positive,282,10,292
90200,8,Very Positive,312,54,366
90500,5,Mixed,61,89,150
90800,0,6 user reviews,5,1,6
91100,8,Very Positive,725,87,812
91200,8,Very Positive,3132,420,3552
91310,8,Very Positive,18344,2849,21193
91600,8,Very Positive,2469,271,2740
91700,8,Very Positive,4113,795,4908
91800,8,Very Positive,68,8,76
91810,6,Mostly Positive,19,7,26
92000,5,Mixed,1241,776,2017
92100,5,Mixed,1034,611,1645
92200,8,Very Positive,117,7,124
92210,8,Very Positive,130,25,155
92220,8,Very Positive,113,21,134
92300,6,Mostly Positive,561,236,797
92600,6,Mostly Positive,123,39,162
92800,8,Very Positive,3525,300,3825
93200,8,Very Positive,807,143,950
94200,9,Overwhelmingly Positive,1935,100,2035
94400,8,Very Positive,4966,681,5647
95000,6,Mostly Positive,114,34,148
95300,6,Mostly Positive,682,195,877
95400,8,Very Positive,2678,155,2833
95900,5,Mixed,153,99,252
96100,8,Very Positive,7045,1108,8153
96800,5,Mixed,165,95,260
96900,5,Mixed,21,16,37
97000,8,Very Positive,1484,150,1634
97330,8,Very Positive,906,114,1020
98200,8,Very Positive,1952,399,2351
98300,8,Very Positive,968,101,1069
98400,8,Very Positive,2970,548,3518
98600,8,Very Positive,196,49,245
98800,8,Very Positive,3799,218,4017
98810,0,No user reviews,0,0,0
98900,5,Mixed,126,75,201
99100,4,Mostly Negative,96,269,365
99110,0,No user reviews,0,0,0
99120,5,Mixed,30,18,48
99200,8,Very Positive,97,10,107
99300,8,Very Positive,1628,261,1889
99400,5,Mixed,146,158,304
99700,8,Very Positive,713,93,806
99900,8,Very Positive,13847,2717,16564
99910,8,Very Positive,922,212,1134
99930,0,No user reviews,0,0,0
102200,6,Mostly Positive,251,76,327
102210,0,No user reviews,0,0,0
102400,5,Mixed,20,9,29
102500,8,Very Positive,7760,1057,8817
102600,9,Overwhelmingly Positive,5168,154,5322
102700,5,Mixed,4783,4286,9069
102810,8,Very Positive,81,18,99
104000,6,Mostly Positive,142,45,187
104020,6,Mostly Positive,87,35,122
104900,6,Mostly Positive,20385,6841,27226
105000,6,Mostly Positive,898,291,1189
105300,6,Mostly Positive,282,73,355
105420,6,Mostly Positive,154,42,196
105600,9,Overwhelmingly Positive,207331,5325,212656
105700,5,Mixed,70,47,117
105800,8,Very Positive,536,127,663
107100,9,Overwhelmingly Positive,25848,899,26747
107200,8,Very Positive,2296,178,2474
107410,8,Very Positive,89908,9762,99670
107800,8,Very Positive,1416,124,1540
108200,8,Very Positive,1262,227,1489
108210,5,Mixed,169,100,269
108500,8,Very Positive,515,66,581
108700,6,Mostly Positive,357,147,504
108710,8,Very Positive,19943,1754,21697
109700,5,Mixed,53,30,83
110500,5,Mixed,51,24,75
110600,5,Mixed,27,26,53
110610,6,Mostly Positive,47,17,64
110630,5,Mixed,23,15,38
110800,8,Very Positive,12349,1856,14205
111100,8,Very Positive,340,75,415
111300,6,Mostly Positive,21,8,29
111400,5,Mixed,181,199,380
111600,8,Very Positive,476,77,553
111800,6,Mostly Positive,536,148,684
111900,4,Mostly Negative,271,991,1262
112100,8,Very Positive,321,70,391
113020,8,Very Positive,6583,653,7236
113200,9,Overwhelmingly Positive,40199,1673,41872
113400,5,Mixed,17657,10053,27710
113420,5,Mixed,3637,2788,6425
115100,8,Very Positive,2459,177,2636
115110,8,Very Positive,1187,135,1322
115120,8,Very Positive,510,108,618
115800,8,Very Positive,3002,415,3417
116100,5,Mixed,185,114,299
116120,6,Mostly Positive,106,28,134
200010,8,Very Positive,1107,196,1303
200020,5,Mixed,116,169,285
200130,6,Mostly Positive,145,45,190
200150,5,Mixed,90,105,195
200170,8,Very Positive,3428,597,4025
200190,5,Mixed,65,39,104
200210,8,Very Positive,20195,3857,24052
200260,9,Overwhelmingly Positive,22372,994,23366
200370,5,Mixed,266,154,420
200410,5,Mixed,45,45,90
200550,4,Mostly Negative,60,102,162
200710,8,Very Positive,27172,1507,28679
200900,9,Overwhelmingly Positive,4698,217,4915
200910,8,Very Positive,1095,165,1260
200940,8,Very Positive,1918,197,2115
201420,8,Very Positive,620,119,739
201510,1,Overwhelmingly Negative,236,1662,1898
201570,6,Mostly Positive,1366,430,1796
201810,8,Very Positive,23454,2554,26008
201830,5,Mixed,981,536,1517
201930,0,No user reviews,0,0,0
202070,8,Very Positive,178,37,215
202130,5,Mixed,171,199,370
202170,8,Very Positive,14153,815,14968
202270,5,Mixed,196,191,387
202310,5,Mixed,476,400,876
202370,5,Mixed,31,20,51
202410,8,Very Positive,103,20,123
202530,5,Mixed,530,609,1139
202730,8,Very Positive,334,54,388
202750,6,Mostly Positive,3171,1257,4428
202970,8,Very Positive,22831,3964,26795
203140,8,Very Positive,19955,2076,22031
203160,9,Overwhelmingly Positive,77826,3230,81056
203210,8,Very Positive,759,72,831
203290,6,Mostly Positive,5651,1655,7306
203350,8,Very Positive,653,138,791
203560,8,Very Positive,197,44,241
203650,6,Mostly Positive,558,165,723
203750,8,Very Positive,3971,637,4608
203770,8,Very Positive,24221,3111,27332
203830,8,Very Positive,1123,172,1295
203990,8,Very Positive,196,22,218
204060,6,Mostly Positive,1705,444,2149
204100,8,Very Positive,19080,3783,22863
204220,6,Mostly Positive,155,63,218
204240,8,Very Positive,2636,331,2967
204360,9,Overwhelmingly Positive,42208,1596,43804
204440,8,Very Positive,110,24,134
204530,8,Very Positive,1788,108,1896
204580,7,Positive,21,4,25
204630,8,Very Positive,1822,214,2036
204760,4,Mostly Negative,50,137,187
204840,5,Mixed,47,48,95
204860,5,Mixed,164,84,248
204880,8,Very Positive,7007,480,7487
204960,5,Mixed,200,182,382
205060,5,Mixed,63,47,110
205070,6,Mostly Positive,49,18,67
205080,5,Mixed,62,39,101
205090,5,Mixed,64,59,123
205100,9,Overwhelmingly Positive,36528,1046,37574
205230,8,Very Positive,2490,385,2875
205530,5,Mixed,46,35,81
205610,5,Mixed,422,186,608
205650,8,Very Positive,1399,249,1648
205690,6,Mostly Positive,220,60,280
205730,8,Very Positive,520,70,590
205810,5,Mixed,103,69,172
205830,8,Very Positive,169,14,183
205910,8,Very Positive,3255,273,3528
205950,8,Very Positive,2892,517,3409
205990,5,Mixed,521,261,782
206190,9,Overwhelmingly Positive,9542,233,9775
206210,8,Very Positive,8363,1511,9874
206230,5,Mixed,24,15,39
206370,8,Very Positive,506,52,558
206420,8,Very Positive,47037,3961,50998
206440,9,Overwhelmingly Positive,37990,1214,39204
206500,8,Very Positive,6783,1214,7997
206690,8,Very Positive,402,80,482
207000,5,Mixed,78,50,128
207020,6,Mostly Positive,293,75,368
207040,8,Very Positive,724,156,880
207080,8,Very Positive,1455,115,1570
207140,8,Very Positive,18253,1196,19449
207170,8,Very Positive,4305,239,4544
207190,5,Mixed,64,64,128
207230,6,Mostly Positive,5281,1897,7178
207250,6,Mostly Positive,326,120,446
207420,6,Mostly Positive,512,214,726
207430,5,Mixed,326,318,644
207610,9,Overwhelmingly Positive,40968,1341,42309
207670,5,Mixed,27,34,61
207690,9,Overwhelmingly Positive,3241,110,3351
207710,5,Mixed,24,15,39
207730,4,Mostly Negative,123,246,369
207750,8,Very Positive,1104,193,1297
207930,5,Mixed,592,255,847
208090,8,Very Positive,32752,5111,37863
208140,8,Very Positive,5361,1269,6630
208200,8,Very Positive,3448,680,4128
208400,8,Very Positive,617,48,665
208460,4,Mostly Negative,11,35,46
208500,8,Very Positive,1252,147,1399
208520,5,Mixed,956,581,1537
208580,8,Very Positive,7015,800,7815
208600,8,Very Positive,452,87,539
208620,5,Mixed,52,27,79
208630,6,Mostly Positive,51,14,65
208640,7,Positive,44,5,49
208650,6,Mostly Positive,27501,11489,38990
208670,8,Very Positive,1213,283,1496
208710,5,Mixed,23,10,33
208730,6,Mostly Positive,1339,544,1883
208750,8,Very Positive,1986,198,2184
209000,8,Very Positive,17958,2944,20902
209060,8,Very Positive,489,90,579
209080,8,Very Positive,11778,1031,12809
209160,5,Mixed,13833,10061,23894
209230,8,Very Positive,184,37,221
209270,5,Mixed,475,206,681
209330,5,Mixed,258,167,425
209360,6,Mostly Positive,39,12,51
209370,8,Very Positive,1795,116,1911
209390,4,Mostly Negative,15,50,65
209520,5,Mixed,379,204,583
209610,5,Mixed,58,46,104
209630,8,Very Positive,239,42,281
209650,5,Mixed,12415,7868,20283
209670,5,Mixed,2479,1149,3628
209690,5,Mixed,119,76,195
209730,5,Mixed,265,290,555
209790,8,Very Positive,456,56,512
209850,5,Mixed,31,18,49
209870,6,Mostly Positive,11300,3699,14999
209950,8,Very Positive,546,50,596
210170,6,Mostly Positive,137,54,191
210490,3,Negative,1,47,48
210550,8,Very Positive,366,46,412
210770,8,Very Positive,10689,1112,11801
210870,8,Very Positive,159,15,174
210950,8,Very Positive,487,35,522
210970,8,Very Positive,5493,1046,6539
211160,5,Mixed,755,907,1662
211180,8,Very Positive,355,26,381
211260,8,Very Positive,1828,286,2114
211280,5,Mixed,165,117,282
211340,8,Very Positive,749,86,835
211360,8,Very Positive,430,89,519
211380,0,No user reviews,0,0,0
211400,8,Very Positive,8581,2134,10715
211420,8,Very Positive,59608,5624,65232
211440,8,Very Positive,907,142,1049
211580,5,Mixed,239,221,460
211800,6,Mostly Positive,88,29,117
211820,8,Very Positive,64838,6605,71443
212010,6,Mostly Positive,965,336,1301
212030,6,Mostly Positive,761,195,956
212050,8,Very Positive,335,28,363
212070,6,Mostly Positive,7738,2335,10073
212090,0,No user reviews,0,0,0
212110,6,Mostly Positive,134,47,181
212480,9,Overwhelmingly Positive,9416,493,9909
212700,5,Mixed,92,86,178
212780,5,Mixed,183,101,284
213050,0,No user reviews,0,0,0
213610,8,Very Positive,3814,658,4472
213650,8,Very Positive,1229,202,1431
213670,9,Overwhelmingly Positive,32620,801,33421
213850,8,Very Positive,3492,746,4238
214050,0,No user reviews,0,0,0
214100,5,Mixed,27,25,52
214130,5,Mixed,82,45,127
214190,5,Mixed,2406,1563,3969
214270,6,Mostly Positive,8,3,11
214340,8,Very Positive,6368,709,7077
214360,6,Mostly Positive,1138,409,1547
214400,0,4 user reviews,4,0,4
214420,6,Mostly Positive,5571,1928,7499
214510,8,Very Positive,3107,320,3427
214550,8,Very Positive,443,106,549
214560,9,Overwhelmingly Positive,13793,369,14162
214570,6,Mostly Positive,175,51,226
214590,8,Very Positive,838,131,969
214630,5,Mixed,123,90,213
214730,9,Overwhelmingly Positive,2903,141,3044
214770,8,Very Positive,4607,299,4906
214790,8,Very Positive,736,128,864
214830,8,Very Positive,1083,157,1240
214870,6,Mostly Positive,1997,602,2599
214910,5,Mixed,159,189,348
214950,6,Mostly Positive,27397,7235,34632
214970,8,Very Positive,893,173,1066
215080,6,Mostly Positive,3686,1118,4804
215390,5,Mixed,6,6,12
215450,7,Positive,41,2,43
215470,6,Mostly Positive,4027,1167,5194
215510,6,Mostly Positive,1912,503,2415
215530,8,Very Positive,4786,966,5752
215590,0,No user reviews,0,0,0
215630,5,Mixed,442,214,656
215670,5,Mixed,1013,480,1493
215690,6,Mostly Positive,719,231,950
215710,8,Very Positive,259,53,312
215770,5,Mixed,50,42,92
215870,5,Mixed,143,212,355
216090,8,Very Positive,326,18,344
216110,8,Very Positive,644,152,796
216130,4,Mostly Negative,28,97,125
216250,8,Very Positive,7129,1197,8326
216260,8,Very Positive,416,34,450
216290,8,Very Positive,165,13,178
216890,8,Very Positive,1074,255,1329
216910,6,Mostly Positive,791,304,1095
217100,5,Mixed,391,446,837
217140,5,Mixed,1351,617,1968
217270,6,Mostly Positive,120,47,167
217290,8,Very Positive,123,21,144
217690,5,Mixed,836,445,1281
217790,6,Mostly Positive,348,138,486
218060,8,Very Positive,2447,203,2650
218410,9,Overwhelmingly Positive,2571,85,2656
218510,6,Mostly Positive,381,163,544
218620,8,Very Positive,265676,48200,313876
218640,8,Very Positive,4934,1180,6114
218660,6,Mostly Positive,107,27,134
218680,8,Very Positive,5742,460,6202
218740,8,Very Positive,1894,333,2227
218820,6,Mostly Positive,1415,577,1992
219150,9,Overwhelmingly Positive,39104,959,40063
219190,8,Very Positive,512,54,566
219200,8,Very Positive,253,49,302
219340,6,Mostly Positive,553,182,735
219640,8,Very Positive,46448,9497,55945
219700,5,Mixed,435,242,677
219830,8,Very Positive,2743,547,3290
219910,8,Very Positive,1456,135,1591
219950,8,Very Positive,465,65,530
219990,8,Very Positive,21546,1725,23271
220260,8,Very Positive,3769,342,4111
220440,8,Very Positive,12340,704,13044
220460,8,Very Positive,601,132,733
220740,8,Very Positive,1228,106,1334
220780,8,Very Positive,7140,390,7530
220820,8,Very Positive,1883,340,2223
220900,5,Mixed,203,121,324
221040,8,Very Positive,12281,3024,15305
221180,8,Very Positive,316,34,350
221380,8,Very Positive,45226,2622,47848
221540,8,Very Positive,1477,333,1810
221640,9,Overwhelmingly Positive,18102,542,18644
221810,8,Very Positive,1528,231,1759
221830,8,Very Positive,244,46,290
222140,6,Mostly Positive,303,113,416
222180,6,Mostly Positive,18,7,25
222320,0,No user reviews,0,0,0
222420,8,Very Positive,753,147,900
222440,8,Very Positive,763,59,822
222480,8,Very Positive,4238,771,5009
222640,6,Mostly Positive,445,131,576
222660,8,Very Positive,277,44,321
222730,8,Very Positive,3340,808,4148
222880,8,Very Positive,74283,7029,81312
222940,8,Very Positive,3772,468,4240
223000,8,Very Positive,139,23,162
223100,5,Mixed,5434,4415,9849
223140,0,No user reviews,0,0,0
223220,6,Mostly Positive,1192,301,1493
223330,6,Mostly Positive,824,236,1060
223410,6,Mostly Positive,439,182,621
223430,4,Mostly Negative,104,200,304
223450,6,Mostly Positive,162,46,208
223470,9,Overwhelmingly Positive,29051,1427,30478
223510,6,Mostly Positive,695,195,890
223730,8,Very Positive,365,57,422
223810,8,Very Positive,964,119,1083
223850,8,Very Positive,1837,239,2076
224040,6,Mostly Positive,186,52,238
224260,8,Very Positive,42230,4850,47080
224460,8,Very Positive,3661,374,4035
224480,8,Very Positive,5606,412,6018
224540,5,Mixed,10901,5657,16558
224760,8,Very Positive,9685,816,10501
224820,9,Overwhelmingly Positive,1184,43,1227
224860,4,Mostly Negative,222,463,685
224900,5,Mixed,293,212,505
225080,9,Overwhelmingly Positive,29593,1509,31102
225160,8,Very Positive,1601,126,1727
225260,8,Very Positive,11241,748,11989
225280,8,Very Positive,915,151,1066
225360,5,Mixed,410,445,855
225420,5,Mixed,1040,793,1833
225540,6,Mostly Positive,26990,10656,37646
225600,6,Mostly Positive,2636,1043,3679
226100,6,Mostly Positive,455,164,619
226560,5,Mixed,465,328,793
226580,6,Mostly Positive,982,289,1271
226620,8,Very Positive,993,92,1085
226720,5,Mixed,1441,909,2350
226760,7,Positive,22,4,26
226780,5,Mixed,35,41,76
226820,8,Very Positive,53,4,57
226840,8,Very Positive,4040,934,4974
226860,6,Mostly Positive,5533,1669,7202
226920,0,No user reviews,0,0,0
227000,9,Overwhelmingly Positive,1643,38,1681
227020,5,Mixed,177,133,310
227060,5,Mixed,216,137,353
227080,8,Very Positive,2296,147,2443
227100,8,Very Positive,2962,391,3353
227180,5,Mixed,1556,759,2315
227200,8,Very Positive,877,104,981
227220,8,Very Positive,1413,188,1601
227300,9,Overwhelmingly Positive,133355,3620,136975
227380,6,Mostly Positive,288,75,363
227400,5,Mixed,313,302,615
227480,6,Mostly Positive,1576,669,2245
227560,5,Mixed,313,158,471
227580,8,Very Positive,1481,172,1653
227600,8,Very Positive,1136,109,1245
227780,8,Very Positive,1160,122,1282
227800,6,Mostly Positive,114,39,153
227860,5,Mixed,2341,2106,4447
228280,8,Very Positive,3652,593,4245
228300,8,Very Positive,8042,1523,9565
228320,5,Mixed,88,91,179
228360,8,Very Positive,867,54,921
228400,5,Mixed,2482,1772,4254
228440,6,Mostly Positive,131,53,184
228960,8,Very Positive,448,54,502
229480,8,Very Positive,694,160,854
229520,5,Mixed,306,173,479
229580,5,Mixed,505,351,856
229810,5,Mixed,269,123,392
229890,8,Very Positive,61,12,73
230050,8,Very Positive,5099,665,5764
230070,8,Very Positive,1488,311,1799
230150,6,Mostly Positive,219,86,305
230190,8,Very Positive,3527,631,4158
230210,0,No user reviews,0,0,0
230230,8,Very Positive,10129,902,11031
230270,9,Overwhelmingly Positive,1389,62,1451
230310,4,Mostly Negative,104,192,296
230410,8,Very Positive,161067,15293,176360
230650,5,Mixed,112,130,242
230700,8,Very Positive,1349,285,1634
230840,5,Mixed,723,739,1462
230860,8,Very Positive,542,50,592
231020,6,Mostly Positive,62,25,87
231160,9,Overwhelmingly Positive,5330,210,5540
231310,5,Mixed,259,165,424
231330,6,Mostly Positive,1309,497,1806
231430,6,Mostly Positive,27036,8955,35991
231720,4,Mostly Negative,118,232,350
231740,8,Very Positive,2148,395,2543
231910,8,Very Positive,312,78,390
232050,5,Mixed,1187,582,1769
232090,8,Very Positive,47871,6839,54710
232430,6,Mostly Positive,11281,3367,14648
232450,5,Mixed,748,381,1129
232750,6,Mostly Positive,1299,470,1769
232770,8,Very Positive,1965,436,2401
232790,8,Very Positive,5048,1004,6052
232890,5,Mixed,3458,2359,5817
232950,5,Mixed,309,323,632
232970,8,Very Positive,355,57,412
233110,4,Mostly Negative,58,90,148
233130,8,Very Positive,16645,1170,17815
233150,8,Very Positive,2917,283,3200
233190,8,Very Positive,678,123,801
233210,4,Mostly Negative,54,157,211
233230,6,Mostly Positive,1055,357,1412
233250,5,Mixed,8361,5848,14209
233290,8,Very Positive,7053,1366,8419
233310,8,Very Positive,101,17,118
233370,6,Mostly Positive,531,177,708
233450,8,Very Positive,27015,1874,28889
233470,8,Very Positive,4184,822,5006
233510,5,Mixed,101,53,154
233530,4,Mostly Negative,50,127,177
233550,8,Very Positive,1083,209,1292
233610,8,Very Positive,3103,185,3288
233700,8,Very Positive,1003,149,1152
233720,8,Very Positive,10068,2097,12165
233740,8,Very Positive,2031,258,2289
233840,6,Mostly Positive,1519,498,2017
233980,8,Very Positive,5384,389,5773
234080,8,Very Positive,3425,805,4230
234140,8,Very Positive,29985,3026,33011
234160,8,Very Positive,425,70,495
234270,8,Very Positive,634,47,681
234290,5,Mixed,239,129,368
234390,8,Very Positive,2015,329,2344
234490,5,Mixed,515,325,840
234630,6,Mostly Positive,7952,2427,10379
234670,8,Very Positive,7542,769,8311
234710,8,Very Positive,4157,735,4892
234820,6,Mostly Positive,169,70,239
234900,8,Very Positive,799,148,947
234920,6,Mostly Positive,316,83,399
234940,6,Mostly Positive,899,279,1178
235070,5,Mixed,128,102,230
235210,8,Very Positive,1965,361,2326
235250,8,Very Positive,1214,155,1369
235320,8,Very Positive,802,56,858
235360,6,Mostly Positive,634,190,824
235380,5,Mixed,2155,1572,3727
235460,8,Very Positive,12041,973,13014
235540,8,Very Positive,13067,3206,16273
235720,6,Mostly Positive,311,96,407
235800,8,Very Positive,3338,600,3938
235820,8,Very Positive,476,94,570
235980,8,Very Positive,350,10,360
236010,5,Mixed,16,13,29
236090,9,Overwhelmingly Positive,14207,554,14761
236110,6,Mostly Positive,9170,3228,12398
236130,5,Mixed,237,165,402
236150,6,Mostly Positive,2495,1017,3512
236290,6,Mostly Positive,19,5,24
236370,5,Mixed,4198,2715,6913
236390,8,Very Positive,67266,16297,83563
236430,8,Very Positive,27777,3421,31198
236450,9,Overwhelmingly Positive,5481,262,5743
236470,5,Mixed,109,70,179
236490,5,Mixed,16,12,28
236690,6,Mostly Positive,2395,903,3298
236730,8,Very Positive,445,99,544
236790,4,Mostly Negative,136,464,600
236850,8,Very Positive,31870,6296,38166
236870,6,Mostly Positive,17138,4724,21862
236930,8,Very Positive,450,9,459
237110,8,Very Positive,10834,1195,12029
237350,6,Mostly Positive,178,64,242
237370,6,Mostly Positive,252,106,358
237430,8,Very Positive,835,188,1023
237470,5,Mixed,148,73,221
237550,5,Mixed,157,130,287
237630,8,Very Positive,2897,462,3359
237740,8,Very Positive,2231,271,2502
237760,8,Very Positive,330,25,355
237850,8,Very Positive,2481,472,2953
237870,5,Mixed,3587,1598,5185
237890,6,Mostly Positive,1134,408,1542
237930,9,Overwhelmingly Positive,19980,1002,20982
237970,6,Mostly Positive,48,18,66
237990,8,Very Positive,8984,993,9977
238010,8,Very Positive,10996,981,11977
238090,6,Mostly Positive,10800,2725,13525
238240,4,Mostly Negative,906,1471,2377
238260,6,Mostly Positive,2046,728,2774
238280,6,Mostly Positive,1028,359,1387
238320,9,Overwhelmingly Positive,38528,1565,40093
238370,6,Mostly Positive,3623,1103,4726
238430,6,Mostly Positive,8427,3205,11632
238460,9,Overwhelmingly Positive,40829,1010,41839
238530,8,Very Positive,340,31,371
238630,6,Mostly Positive,174,58,232
238870,2,Very Negative,59,341,400
238890,5,Mixed,119,154,273
238910,6,Mostly Positive,623,203,826
238960,8,Very Positive,53700,4554,58254
239030,9,Overwhelmingly Positive,21692,888,22580
239070,8,Very Positive,4750,512,5262
239090,8,Very Positive,318,20,338
239120,8,Very Positive,897,216,1113
239140,8,Very Positive,57374,4146,61520
239160,6,Mostly Positive,8852,3761,12613
239200,5,Mixed,3561,1832,5393
239250,8,Very Positive,2068,397,2465
239350,8,Very Positive,7501,704,8205
239430,8,Very Positive,1050,191,1241
239490,0,No user reviews,0,0,0
239660,6,Mostly Positive,1543,393,1936
239700,8,Very Positive,425,65,490
239720,8,Very Positive,111,25,136
239800,8,Very Positive,1517,109,1626
239820,9,Overwhelmingly Positive,23837,1125,24962
239840,6,Mostly Positive,1319,477,1796
240220,0,No user reviews,0,0,0
240340,8,Very Positive,72,7,79
240360,7,Positive,40,9,49
240440,8,Very Positive,392,42,434
240600,6,Mostly Positive,359,136,495
240620,5,Mixed,122,76,198
240660,5,Mixed,100,43,143
240720,6,Mostly Positive,7782,1956,9738
240760,8,Very Positive,5928,1224,7152
240970,8,Very Positive,387,29,416
241240,8,Very Positive,856,76,932
241260,8,Very Positive,1709,138,1847
241300,8,Very Positive,51,7,58
241320,8,Very Positive,885,60,945
241410,8,Very Positive,1066,120,1186
241540,8,Very Positive,14475,2620,17095
241600,8,Very Positive,12925,803,13728
241720,5,Mixed,554,572,1126
241760,6,Mostly Positive,107,34,141
241910,8,Very Positive,1161,144,1305
241930,8,Very Positive,46639,3936,50575
242050,8,Very Positive,20587,2693,23280
242110,5,Mixed,192,139,331
242130,5,Mixed,288,255,543
242320,0,No user reviews,0,0,0
242530,5,Mixed,187,103,290
242640,8,Very Positive,3949,820,4769
242680,9,Overwhelmingly Positive,8218,314,8532
242700,8,Very Positive,7907,1259,9166
242720,5,Mixed,6363,3148,9511
242760,8,Very Positive,85507,6544,92051
242780,8,Very Positive,468,86,554
242820,8,Very Positive,3040,203,3243
242840,8,Very Positive,967,217,1184
242860,8,Very Positive,19702,3714,23416
242920,8,Very Positive,22678,2383,25061
243120,8,Very Positive,2317,501,2818
243160,8,Very Positive,394,80,474
243200,8,Very Positive,1165,117,1282
243220,8,Very Positive,433,65,498
243280,6,Mostly Positive,145,39,184
243450,8,Very Positive,1094,251,1345
243780,6,Mostly Positive,583,173,756
243800,8,Very Positive,2232,342,2574
243930,5,Mixed,1683,860,2543
243950,6,Mostly Positive,1174,368,1542
243970,8,Very Positive,3210,227,3437
244030,5,Mixed,769,565,1334
244050,5,Mixed,644,547,1191
244070,5,Mixed,371,164,535
244090,5,Mixed,195,109,304
244160,8,Very Positive,4919,747,5666
244210,8,Very Positive,12522,1689,14211
244430,8,Very Positive,458,92,550
244450,8,Very Positive,9125,1557,10682
244590,5,Mixed,738,376,1114
244690,5,Mixed,148,67,215
244730,8,Very Positive,1328,241,1569
244750,8,Very Positive,75,10,85
244810,8,Very Positive,454,98,552
244850,8,Very Positive,52959,7421,60380
244870,8,Very Positive,2824,273,3097
244890,6,Mostly Positive,129,37,166
244930,5,Mixed,6205,3010,9215
244950,6,Mostly Positive,118,30,148
245050,5,Mixed,81,96,177
245170,8,Very Positive,12074,735,12809
245280,8,Very Positive,3304,582,3886
245300,5,Mixed,78,54,132
245350,0,No user reviews,0,0,0
245370,4,Mostly Negative,297,488,785
245470,6,Mostly Positive,4074,1377,5451
245620,6,Mostly Positive,6759,1923,8682
246110,6,Mostly Positive,1017,408,1425
246300,5,Mixed,266,145,411
246420,9,Overwhelmingly Positive,4550,155,4705
246580,8,Very Positive,2175,318,2493
246620,8,Very Positive,16793,1096,17889
246680,5,Mixed,252,147,399
246720,4,Mostly Negative,27,48,75
246760,6,Mostly Positive,940,267,1207
246800,4,Mostly Negative,30,46,76
246840,8,Very Positive,755,68,823
246900,8,Very Positive,5635,431,6066
246920,8,Very Positive,98,8,106
246940,2,Very Negative,70,283,353
246960,8,Very Positive,245,47,292
247000,6,Mostly Positive,2623,842,3465
247020,8,Very Positive,3916,208,4124
247080,9,Overwhelmingly Positive,12283,403,12686
247140,8,Very Positive,526,50,576
247240,8,Very Positive,1588,356,1944
247310,5,Mixed,34,49,83
247370,6,Mostly Positive,292,99,391
247580,8,Very Positive,179,38,217
247660,5,Mixed,1823,812,2635
247870,5,Mixed,147,208,355
247910,8,Very Positive,2832,493,3325
247950,4,Mostly Negative,874,2710,3584
248190,8,Very Positive,259,38,297
248290,5,Mixed,211,93,304
248310,9,Overwhelmingly Positive,3226,138,3364
248330,8,Very Positive,485,43,528
248390,8,Very Positive,6193,822,7015
248410,4,Mostly Negative,74,187,261
248450,5,Mixed,133,75,208
248470,5,Mixed,334,171,505
248530,6,Mostly Positive,596,204,800
248550,8,Very Positive,792,88,880
248570,8,Very Positive,9510,1280,10790
248590,0,No user reviews,0,0,0
248610,8,Very Positive,4841,263,5104
248630,5,Mixed,455,559,1014
248650,6,Mostly Positive,719,227,946
248710,4,Mostly Negative,179,433,612
248730,8,Very Positive,285,63,348
248800,6,Mostly Positive,585,173,758
248820,8,Very Positive,20449,1261,21710
248970,8,Very Positive,484,79,563
249050,8,Very Positive,6596,806,7402
249130,8,Very Positive,7658,548,8206
249190,5,Mixed,129,158,287
249230,6,Mostly Positive,2441,997,3438
249330,8,Very Positive,1061,121,1182
249360,5,Mixed,268,121,389
249590,8,Very Positive,1294,187,1481
249610,5,Mixed,38,34,72
249630,8,Very Positive,1651,218,1869
249650,5,Mixed,1528,943,2471
249680,8,Very Positive,1608,131,1739
249870,8,Very Positive,1107,220,1327
249950,8,Very Positive,398,73,471
249990,6,Mostly Positive,1726,569,2295
250050,9,Overwhelmingly Positive,913,29,942
250070,7,Positive,12,2,14
250110,9,Overwhelmingly Positive,1183,60,1243
250180,8,Very Positive,4728,500,5228
250260,8,Very Positive,3677,350,4027
250320,9,Overwhelmingly Positive,19561,472,20033
250340,6,Mostly Positive,3083,1219,4302
250380,8,Very Positive,825,124,949
250400,8,Very Positive,11872,2400,14272
250420,5,Mixed,2534,1737,4271
250460,6,Mostly Positive,763,249,1012
250520,8,Very Positive,1244,188,1432
250560,6,Mostly Positive,923,233,1156
250580,5,Mixed,894,405,1299
250600,8,Very Positive,18125,1534,19659
250620,8,Very Positive,3457,531,3988
250640,8,Very Positive,253,56,309
250660,5,Mixed,198,96,294
250680,0,No user reviews,0,0,0
250700,8,Very Positive,627,66,693
250760,9,Overwhelmingly Positive,8276,257,8533
250900,9,Overwhelmingly Positive,62009,1337,63346
251110,8,Very Positive,527,68,595
251130,8,Very Positive,2361,165,2526
251150,8,Very Positive,3068,269,3337
251170,6,Mostly Positive,2351,894,3245
251210,8,Very Positive,165,18,183
251230,6,Mostly Positive,260,78,338
251270,8,Very Positive,364,26,390
251290,9,Overwhelmingly Positive,966,21,987
251390,5,Mixed,118,55,173
251410,5,Mixed,73,103,176
251430,8,Very Positive,510,35,545
251450,4,Mostly Negative,66,104,170
251470,8,Very Positive,1712,106,1818
251490,8,Very Positive,251,7,258
251510,8,Very Positive,43,7,50
251530,6,Mostly Positive,388,100,488
251570,8,Very Positive,51025,10923,61948
251630,8,Very Positive,821,137,958
251650,0,No user reviews,0,0,0
251690,5,Mixed,323,177,500
251710,5,Mixed,161,137,298
251730,8,Very Positive,1904,187,2091
251810,6,Mostly Positive,196,65,261
251830,9,Overwhelmingly Positive,517,26,543
251850,6,Mostly Positive,449,129,578
251870,8,Very Positive,2116,296,2412
251890,5,Mixed,306,224,530
251910,6,Mostly Positive,200,61,261
251990,8,Very Positive,5307,281,5588
252010,8,Very Positive,524,103,627
252030,8,Very Positive,1828,300,2128
252090,8,Very Positive,53,10,63
252110,9,Overwhelmingly Positive,1506,79,1585
252130,8,Very Positive,601,46,647
252170,8,Very Positive,227,53,280
252230,5,Mixed,217,100,317
252270,5,Mixed,150,85,235
252290,5,Mixed,162,80,242
252310,8,Very Positive,514,88,602
252330,8,Very Positive,3705,470,4175
252370,8,Very Positive,428,94,522
252410,8,Very Positive,3741,273,4014
252430,5,Mixed,60,89,149
252450,5,Mixed,953,691,1644
252470,8,Very Positive,1503,362,1865
252490,8,Very Positive,180850,40762,221612
252550,8,Very Positive,467,57,524
252570,5,Mixed,242,127,369
252630,8,Very Positive,1407,189,1596
252710,8,Very Positive,158,30,188
252750,8,Very Positive,180,22,202
252830,5,Mixed,196,85,281
252850,6,Mostly Positive,1405,518,1923
252890,8,Very Positive,91,18,109
252950,8,Very Positive,181782,17822,199604
252970,6,Mostly Positive,96,29,125
253030,8,Very Positive,4800,305,5105
253050,6,Mostly Positive,273,107,380
253110,8,Very Positive,3109,219,3328
253150,6,Mostly Positive,389,106,495
253190,5,Mixed,582,306,888
253230,9,Overwhelmingly Positive,7338,100,7438
253290,8,Very Positive,530,64,594
253310,6,Mostly Positive,76,20,96
253330,6,Mostly Positive,1342,464,1806
253350,8,Very Positive,163,27,190
253370,5,Mixed,223,115,338
253390,5,Mixed,108,52,160
253430,6,Mostly Positive,3734,1519,5253
253510,5,Mixed,442,549,991
253610,6,Mostly Positive,328,125,453
253630,5,Mixed,158,141,299
253650,6,Mostly Positive,1288,483,1771
253690,6,Mostly Positive,304,85,389
253710,5,Mixed,10194,13312,23506
253750,9,Overwhelmingly Positive,1245,61,1306
253790,8,Very Positive,160,34,194
253840,8,Very Positive,1501,136,1637
254200,6,Mostly Positive,1555,525,2080
254270,0,No user reviews,0,0,0
254300,6,Mostly Positive,124,48,172
254370,0,No user reviews,0,0,0
254440,8,Very Positive,2193,230,2423
254460,8,Very Positive,545,36,581
254480,6,Mostly Positive,209,54,263
254700,8,Very Positive,8843,1590,10433
255070,5,Mixed,1275,760,2035
255220,6,Mostly Positive,4500,1416,5916
255260,5,Mixed,152,76,228
255280,6,Mostly Positive,608,225,833
255300,8,Very Positive,903,117,1020
255320,8,Very Positive,623,138,761
255340,8,Very Positive,291,6,297
255370,5,Mixed,459,236,695
255390,8,Very Positive,901,48,949
255420,5,Mixed,1719,2161,3880
255520,8,Very Positive,2091,500,2591
255710,8,Very Positive,53369,4186,57555
255870,8,Very Positive,409,39,448
256010,5,Mixed,307,363,670
256030,5,Mixed,216,120,336
256070,6,Mostly Positive,120,45,165
256190,5,Mixed,1807,1069,2876
256330,5,Mixed,526,294,820
256370,6,Mostly Positive,599,157,756
256390,5,Mixed,190,194,384
256460,8,Very Positive,316,34,350
257050,5,Mixed,391,368,759
257120,6,Mostly Positive,401,101,502
257170,8,Very Positive,830,142,972
257260,8,Very Positive,50,4,54
257350,8,Very Positive,2185,358,2543
257510,9,Overwhelmingly Positive,14880,637,15517
257630,5,Mixed,127,145,272
257690,8,Very Positive,569,87,656
257750,8,Very Positive,2117,389,2506
257770,5,Mixed,45,29,74
257790,8,Very Positive,324,43,367
257830,5,Mixed,417,241,658
257850,8,Very Positive,9406,565,9971
257970,8,Very Positive,350,85,435
257990,8,Very Positive,524,87,611
258050,5,Mixed,493,249,742
258090,5,Mixed,200,144,344
258180,4,Mostly Negative,895,1924,2819
258220,5,Mixed,369,250,619
258520,8,Very Positive,6430,768,7198
258590,6,Mostly Positive,281,97,378
258890,6,Mostly Positive,1069,269,1338
258910,6,Mostly Positive,219,63,282
258950,5,Mixed,230,155,385
258970,6,Mostly Positive,4568,1311,5879
259080,8,Very Positive,10771,946,11717
259410,8,Very Positive,225,28,253
259430,6,Mostly Positive,167,57,224
259470,5,Mixed,50,23,73
259490,8,Very Positive,233,29,262
259510,8,Very Positive,399,70,469
259530,8,Very Positive,2292,157,2449
259550,8,Very Positive,2633,212,2845
259600,8,Very Positive,668,137,805
259640,4,Mostly Negative,57,127,184
259660,5,Mixed,193,103,296
259680,9,Overwhelmingly Positive,2450,108,2558
259700,4,Mostly Negative,79,137,216
259720,5,Mixed,126,64,190
259740,8,Very Positive,1006,75,1081
259810,8,Very Positive,92,5,97
259830,5,Mixed,59,45,104
259870,8,Very Positive,257,62,319
260130,6,Mostly Positive,228,70,298
260160,8,Very Positive,438,98,536
260250,5,Mixed,339,220,559
260330,6,Mostly Positive,110,36,146
260380,5,Mixed,23,12,35
260410,6,Mostly Positive,1031,367,1398
260430,5,Mixed,1957,843,2800
260530,8,Very Positive,75,6,81
260790,8,Very Positive,410,94,504
261030,9,Overwhelmingly Positive,19248,846,20094
261110,6,Mostly Positive,4216,1311,5527
261180,8,Very Positive,4392,277,4669
261470,6,Mostly Positive,808,223,1031
261490,6,Mostly Positive,495,163,658
261530,6,Mostly Positive,1986,580,2566
261570,9,Overwhelmingly Positive,24272,869,25141
261600,3,Negative,9,39,48
261640,8,Very Positive,13673,3145,16818
261680,6,Mostly Positive,248,69,317
261700,8,Very Positive,1021,143,1164
261720,5,Mixed,67,50,117
261740,5,Mixed,32,17,49
261760,5,Mixed,1314,922,2236
261900,7,Positive,23,0,23
261920,5,Mixed,43,58,101
261940,6,Mostly Positive,55,20,75
261960,5,Mixed,73,43,116
262000,8,Very Positive,496,50,546
262060,8,Very Positive,32758,5145,37903
262080,2,Very Negative,9,44,53
262120,6,Mostly Positive,454,152,606
262190,6,Mostly Positive,118,31,149
262210,8,Very Positive,154,31,185
262240,8,Very Positive,112,15,127
262260,8,Very Positive,858,117,975
262280,6,Mostly Positive,2702,700,3402
262300,5,Mixed,30,18,48
262390,8,Very Positive,662,105,767
262410,8,Very Positive,8946,1908,10854
262450,8,Very Positive,295,47,342
262470,8,Very Positive,404,45,449
262510,6,Mostly Positive,28,11,39
262550,8,Very Positive,571,73,644
262590,8,Very Positive,134,21,155
262610,5,Mixed,16,12,28
262630,7,Positive,12,2,14
262690,8,Very Positive,651,134,785
262750,5,Mixed,203,89,292
262770,8,Very Positive,322,23,345
262790,8,Very Positive,520,115,635
262810,5,Mixed,66,53,119
262900,6,Mostly Positive,181,66,247
262920,5,Mixed,14,12,26
262940,8,Very Positive,1359,185,1544
262960,6,Mostly Positive,761,191,952
262980,4,Mostly Negative,22,73,95
263020,8,Very Positive,523,55,578
263040,5,Mixed,60,26,86
263060,8,Very Positive,4662,1069,5731
263080,5,Mixed,142,70,212
263200,6,Mostly Positive,434,112,546
263280,8,Very Positive,15306,2536,17842
263320,8,Very Positive,361,85,446
263380,8,Very Positive,184,22,206
263400,8,Very Positive,394,56,450
263420,5,Mixed,166,191,357
263460,6,Mostly Positive,141,55,196
263480,5,Mixed,68,74,142
263500,6,Mostly Positive,2207,643,2850
263520,5,Mixed,81,35,116
263560,8,Very Positive,408,90,498
263620,8,Very Positive,2247,478,2725
263640,5,Mixed,33,49,82
263680,5,Mixed,392,346,738
263700,6,Mostly Positive,272,78,350
263720,6,Mostly Positive,236,94,330
263740,8,Very Positive,755,139,894
263760,8,Very Positive,3269,293,3562
263820,8,Very Positive,504,63,567
263860,6,Mostly Positive,207,80,287
263880,8,Very Positive,340,46,386
263920,6,Mostly Positive,193,75,268
263980,8,Very Positive,5641,397,6038
264000,5,Mixed,120,70,190
264020,5,Mixed,11,5,16
264060,8,Very Positive,147,26,173
264140,5,Mixed,4069,2139,6208
264160,8,Very Positive,396,57,453
264200,9,Overwhelmingly Positive,12815,201,13016
264220,8,Very Positive,182,28,210
264240,6,Mostly Positive,972,362,1334
264260,6,Mostly Positive,42,16,58
264280,5,Mixed,318,193,511
264300,6,Mostly Positive,621,254,875
264340,8,Very Positive,211,40,251
264380,8,Very Positive,2545,156,2701
264400,7,Positive,25,0,25
264440,3,Negative,3,14,17
264460,5,Mixed,19,26,45
264520,6,Mostly Positive,145,53,198
264540,5,Mixed,180,91,271
264560,8,Very Positive,108,19,127
264710,8,Very Positive,64938,4013,68951
264730,6,Mostly Positive,1030,342,1372
265000,8,Very Positive,434,63,497
265020,3,Negative,3,33,36
265170,8,Very Positive,160,30,190
265210,8,Very Positive,3086,317,3403
265240,4,Mostly Negative,6,14,20
265300,5,Mixed,6286,4082,10368
265380,5,Mixed,148,71,219
265470,8,Very Positive,95,14,109
265590,6,Mostly Positive,1302,454,1756
265610,9,Overwhelmingly Positive,1839,72,1911
265630,8,Very Positive,19862,1879,21741
265670,4,Mostly Negative,136,282,418
265750,6,Mostly Positive,926,354,1280
265770,4,Mostly Negative,123,379,502
265790,5,Mixed,52,28,80
265810,5,Mixed,287,182,469
265830,6,Mostly Positive,388,138,526
265890,9,Overwhelmingly Positive,3172,116,3288
265930,8,Very Positive,40659,4943,45602
265950,6,Mostly Positive,263,87,350
265970,5,Mixed,213,230,443
265990,5,Mixed,197,90,287
266010,9,Overwhelmingly Positive,6236,231,6467
266050,5,Mixed,87,106,193
266090,4,Mostly Negative,71,113,184
266110,8,Very Positive,741,153,894
266130,8,Very Positive,1473,298,1771
266150,5,Mixed,372,240,612
266210,8,Very Positive,3176,181,3357
266230,8,Very Positive,342,63,405
266250,8,Very Positive,96,12,108
266310,6,Mostly Positive,705,243,948
266330,5,Mixed,127,78,205
266370,5,Mixed,44,53,97
266390,8,Very Positive,405,91,496
266430,5,Mixed,1354,612,1966
266470,5,Mixed,32,18,50
266490,8,Very Positive,746,107,853
266510,8,Very Positive,7536,681,8217
266840,8,Very Positive,7984,1324,9308
267060,5,Mixed,250,156,406
267340,6,Mostly Positive,165,70,235
267490,4,Mostly Negative,508,783,1291
267530,8,Very Positive,1554,311,1865
267730,5,Mixed,15,20,35
267750,5,Mixed,728,384,1112
268050,8,Very Positive,8983,1983,10966
268200,5,Mixed,143,118,261
268220,8,Very Positive,598,100,698
268240,8,Very Positive,617,94,711
268260,5,Mixed,60,62,122
268320,8,Very Positive,232,22,254
268340,7,Positive,14,3,17
268360,5,Mixed,149,68,217
268400,8,Very Positive,914,67,981
268500,8,Very Positive,23517,5428,28945
268520,5,Mixed,29,31,60
268540,6,Mostly Positive,653,226,879
268650,8,Very Positive,3298,397,3695
268770,8,Very Positive,89,5,94
268810,6,Mostly Positive,189,58,247
268850,6,Mostly Positive,1389,454,1843
268870,5,Mixed,2134,941,3075
268910,9,Overwhelmingly Positive,29947,1151,31098
268930,6,Mostly Positive,50,20,70
268970,4,Mostly Negative,8,13,21
268990,8,Very Positive,305,13,318
269010,6,Mostly Positive,85,34,119
269050,8,Very Positive,1381,127,1508
269110,6,Mostly Positive,294,96,390
269170,8,Very Positive,596,51,647
269210,6,Mostly Positive,12832,3310,16142
269270,8,Very Positive,860,86,946
269310,5,Mixed,406,194,600
269370,5,Mixed,236,116,352
269430,3,Negative,4,32,36
269490,8,Very Positive,1174,141,1315
269530,5,Mixed,32,47,79
269630,5,Mixed,19,19,38
269650,8,Very Positive,1270,192,1462
269670,8,Very Positive,928,170,1098
269710,6,Mostly Positive,506,132,638
269730,5,Mixed,623,350,973
269770,8,Very Positive,3070,208,3278
269790,6,Mostly Positive,2072,639,2711
269810,6,Mostly Positive,248,95,343
269890,5,Mixed,233,163,396
269990,5,Mixed,59,27,86
270010,8,Very Positive,250,33,283
270050,6,Mostly Positive,425,127,552
270070,5,Mixed,30,14,44
270110,5,Mixed,226,135,361
270130,8,Very Positive,1108,163,1271
270150,8,Very Positive,4507,592,5099
270190,5,Mixed,101,61,162
270210,8,Very Positive,3748,255,4003
270230,8,Very Positive,60,9,69
270270,5,Mixed,320,145,465
270330,4,Mostly Negative,23,60,83
270410,5,Mixed,22,26,48
270430,4,Mostly Negative,4,16,20
270450,8,Very Positive,2821,213,3034
270490,8,Very Positive,172,43,215
270510,6,Mostly Positive,34,11,45
270550,8,Very Positive,8697,1293,9990
270570,6,Mostly Positive,1078,319,1397
270590,5,Mixed,39,37,76
270630,8,Very Positive,780,157,937
270810,5,Mixed,100,53,153
270950,6,Mostly Positive,181,59,240
271240,6,Mostly Positive,2512,801,3313
271360,8,Very Positive,324,80,404
271370,5,Mixed,106,113,219
271550,8,Very Positive,195,37,232
271570,6,Mostly Positive,1111,381,1492
271590,6,Mostly Positive,254544,108090,362634
271640,4,Mostly Negative,134,285,419
271670,8,Very Positive,539,84,623
271730,5,Mixed,181,129,310
271820,8,Very Positive,713,77,790
271900,8,Very Positive,1165,71,1236
271920,8,Very Positive,255,38,293
271970,8,Very Positive,134,13,147
271990,7,Positive,34,3,37
272010,5,Mixed,55,35,90
272270,5,Mixed,1835,862,2697
272330,8,Very Positive,208,29,237
272470,5,Mixed,1154,572,1726
272510,8,Very Positive,3602,893,4495
272600,8,Very Positive,1037,59,1096
272620,8,Very Positive,186,26,212
272890,5,Mixed,547,381,928
272990,5,Mixed,137,61,198
273030,4,Mostly Negative,31,119,150
273070,6,Mostly Positive,288,95,383
273110,5,Mixed,18693,10018,28711
273240,6,Mostly Positive,129,52,181
273350,5,Mixed,26801,13422,40223
273500,8,Very Positive,750,135,885
273730,4,Mostly Negative,35,124,159
273740,2,Very Negative,6,53,59
273800,5,Mixed,37,53,90
273830,2,Very Negative,11,50,61
273890,3,Negative,4,25,29
273960,5,Mixed,51,70,121
274010,5,Mixed,44,42,86
274130,5,Mixed,242,201,443
274170,8,Very Positive,17203,1601,18804
274190,9,Overwhelmingly Positive,26569,847,27416
274230,5,Mixed,1043,471,1514
274250,6,Mostly Positive,559,145,704
274270,8,Very Positive,1358,181,1539
274290,6,Mostly Positive,1478,595,2073
274310,6,Mostly Positive,1563,505,2068
274350,8,Very Positive,1035,61,1096
274480,8,Very Positive,211,20,231
274500,8,Very Positive,1309,89,1398
274520,8,Very Positive,2844,154,2998
274560,6,Mostly Positive,1290,474,1764
274700,8,Very Positive,61,3,64
274880,5,Mixed,87,38,125
274900,8,Very Positive,3549,663,4212
274920,8,Very Positive,3277,601,3878
274940,8,Very Positive,18793,2819,21612
274980,6,Mostly Positive,663,219,882
275000,0,4 user reviews,3,1,4
275060,4,Mostly Negative,49,171,220
275100,8,Very Positive,2251,473,2724
275180,8,Very Positive,428,62,490
275200,8,Very Positive,1016,95,1111
275290,8,Very Positive,292,65,357
275350,8,Very Positive,67,16,83
275390,8,Very Positive,1416,96,1512
275470,8,Very Positive,873,152,1025
275490,5,Mixed,799,993,1792
275510,5,Mixed,79,73,152
275530,6,Mostly Positive,529,186,715
275610,5,Mixed,430,376,806
275670,8,Very Positive,1418,217,1635
275850,5,Mixed,43397,41797,85194
276730,5,Mixed,37,19,56
276810,5,Mixed,3366,1444,4810
276870,5,Mixed,135,65,200
276890,6,Mostly Positive,117,43,160
277390,8,Very Positive,98,16,114
277430,8,Very Positive,2521,617,3138
277470,6,Mostly Positive,157,62,219
277490,8,Very Positive,330,64,394
277510,5,Mixed,53,40,93
277520,5,Mixed,127,96,223
277630,6,Mostly Positive,82,30,112
277700,8,Very Positive,113,12,125
277870,6,Mostly Positive,296,95,391
277890,8,Very Positive,779,116,895
278080,8,Very Positive,3805,850,4655
278100,8,Very Positive,527,73,600
278360,8,Very Positive,9624,771,10395
278420,8,Very Positive,61,9,70
278440,6,Mostly Positive,184,66,250
278460,8,Very Positive,1250,170,1420
278530,5,Mixed,106,76,182
278570,8,Very Positive,215,50,265
278620,5,Mixed,252,117,369
278640,6,Mostly Positive,165,54,219
278810,5,Mixed,76,58,134
278890,8,Very Positive,1005,147,1152
278910,8,Very Positive,580,140,720
278930,6,Mostly Positive,217,63,280
279070,8,Very Positive,76,11,87
279140,6,Mostly Positive,227,71,298
279160,5,Mixed,151,82,233
279260,6,Mostly Positive,247,91,338
279440,6,Mostly Positive,360,108,468
279480,5,Mixed,46,39,85
279500,5,Mixed,41,21,62
279520,5,Mixed,22,21,43
279580,5,Mixed,95,44,139
279800,9,Overwhelmingly Positive,692,23,715
279900,5,Mixed,120,53,173
279920,5,Mixed,73,38,111
279940,8,Very Positive,517,41,558
279990,5,Mixed,110,52,162
280010,8,Very Positive,701,167,868
280040,5,Mixed,270,118,388
280140,6,Mostly Positive,199,57,256
280160,8,Very Positive,3058,370,3428
280180,8,Very Positive,902,185,1087
280200,5,Mixed,35,31,66
280220,9,Overwhelmingly Positive,2084,70,2154
280320,5,Mixed,307,194,501
280360,5,Mixed,198,135,333
280460,5,Mixed,60,41,101
280500,5,Mixed,27,16,43
280520,8,Very Positive,677,165,842
280540,6,Mostly Positive,93,35,128
280560,8,Very Positive,343,19,362
280600,8,Very Positive,201,50,251
280720,8,Very Positive,177,34,211
280830,6,Mostly Positive,123,52,175
280850,0,No user reviews,0,0,0
280890,4,Mostly Negative,35,55,90
280910,8,Very Positive,317,35,352
280930,8,Very Positive,229,36,265
281060,6,Mostly Positive,89,32,121
281200,5,Mixed,213,104,317
281220,5,Mixed,420,242,662
281610,6,Mostly Positive,2451,642,3093
281640,8,Very Positive,1405,134,1539
281750,8,Very Positive,369,66,435
281820,6,Mostly Positive,42,16,58
281920,8,Very Positive,1615,170,1785
281940,5,Mixed,661,450,1111
281990,8,Very Positive,26902,6152,33054
282050,5,Mixed,263,259,522
282070,9,Overwhelmingly Positive,39981,1948,41929
282100,6,Mostly Positive,364,94,458
282140,9,Overwhelmingly Positive,13229,550,13779
282210,5,Mixed,856,1024,1880
282400,6,Mostly Positive,1058,290,1348
282440,8,Very Positive,9266,1670,10936
282530,8,Very Positive,703,148,851
282560,4,Mostly Negative,1072,3341,4413
282590,8,Very Positive,465,110,575
282620,5,Mixed,52,33,85
282640,7,Positive,34,1,35
282680,6,Mostly Positive,68,21,89
282740,5,Mixed,11,13,24
282760,8,Very Positive,1712,193,1905
282780,6,Mostly Positive,74,31,105
282800,8,Very Positive,8382,602,8984
282860,4,Mostly Negative,52,114,166
282880,5,Mixed,179,91,270
282900,9,Overwhelmingly Positive,7771,368,8139
282960,0,6 user reviews,6,0,6
283000,5,Mixed,50,75,125
283020,4,Mostly Negative,20,39,59
283040,5,Mixed,37,34,71
283080,8,Very Positive,206,28,234
283160,8,Very Positive,848,90,938
283180,6,Mostly Positive,94,31,125
283230,6,Mostly Positive,755,258,1013
283640,8,Very Positive,6030,474,6504
283660,5,Mixed,183,105,288
283680,8,Very Positive,1007,113,1120
283820,8,Very Positive,93,7,100
283840,8,Very Positive,76,11,87
283880,8,Very Positive,773,102,875
284050,8,Very Positive,275,14,289
284100,5,Mixed,80,47,127
284140,5,Mixed,59,31,90
284160,8,Very Positive,10842,958,11800
284180,8,Very Positive,91,12,103
284200,6,Mostly Positive,36,15,51
284390,8,Very Positive,1114,59,1173
284410,6,Mostly Positive,40,16,56
284460,8,Very Positive,1335,218,1553
284580,5,Mixed,15,17,32
284710,8,Very Positive,823,87,910
284730,8,Very Positive,364,39,403
284750,8,Very Positive,580,109,689
284770,9,Overwhelmingly Positive,773,22,795
284790,9,Overwhelmingly Positive,515,21,536
284810,8,Very Positive,446,13,459
284830,8,Very Positive,672,61,733
284850,9,Overwhelmingly Positive,801,30,831
284870,8,Very Positive,819,85,904
284890,8,Very Positive,335,60,395
284930,5,Mixed,162,152,314
284950,8,Very Positive,1792,382,2174
284970,5,Mixed,52,47,99
284990,5,Mixed,224,121,345
285010,6,Mostly Positive,456,151,607
285070,6,Mostly Positive,490,135,625
285130,5,Mixed,112,105,217
285160,6,Mostly Positive,2158,622,2780
285190,5,Mixed,5984,7452,13436
285350,5,Mixed,12,12,24
285380,5,Mixed,170,110,280
285440,8,Very Positive,945,51,996
285740,8,Very Positive,520,29,549
285800,8,Very Positive,710,151,861
285820,8,Very Positive,452,52,504
285840,8,Very Positive,611,93,704
285900,5,Mixed,11034,4775,15809
285920,8,Very Positive,3316,648,3964
285960,5,Mixed,94,60,154
285980,6,Mostly Positive,76,21,97
286000,6,Mostly Positive,1601,421,2022
286040,6,Mostly Positive,1938,752,2690
286100,8,Very Positive,4538,339,4877
286120,5,Mixed,391,335,726
286160,9,Overwhelmingly Positive,10024,518,10542
286200,5,Mixed,149,75,224
286220,5,Mixed,57,35,92
286240,8,Very Positive,246,19,265
286260,8,Very Positive,2105,137,2242
286280,8,Very Positive,138,30,168
286300,7,Positive,33,2,35
286320,8,Very Positive,336,24,360
286360,6,Mostly Positive,462,153,615
286380,8,Very Positive,267,36,303
286570,5,Mixed,2877,2156,5033
286660,8,Very Positive,145,23,168
286690,8,Very Positive,19773,1910,21683
287100,4,Mostly Negative,230,524,754
287120,6,Mostly Positive,410,137,547
287200,5,Mixed,158,150,308
287260,8,Very Positive,774,144,918
287290,6,Mostly Positive,7586,2177,9763
287340,5,Mixed,769,1106,1875
287390,8,Very Positive,15929,1207,17136
287450,8,Very Positive,4438,392,4830
287580,5,Mixed,322,170,492
287600,5,Mixed,146,69,215
287630,8,Very Positive,396,49,445
287700,8,Very Positive,32906,4072,36978
287780,5,Mixed,13,6,19
287840,8,Very Positive,170,32,202
287860,5,Mixed,112,100,212
287920,5,Mixed,1236,1225,2461
287980,9,Overwhelmingly Positive,6172,222,6394
288020,6,Mostly Positive,155,43,198
288040,6,Mostly Positive,336,93,429
288060,8,Very Positive,616,126,742
288100,5,Mixed,10,7,17
288120,8,Very Positive,472,41,513
288140,5,Mixed,393,234,627
288160,9,Overwhelmingly Positive,8172,219,8391
288220,8,Very Positive,166,16,182
288260,6,Mostly Positive,114,48,162
288370,8,Very Positive,219,51,270
288470,6,Mostly Positive,3480,976,4456
288650,5,Mixed,25,11,36
288860,6,Mostly Positive,68,20,88
288880,5,Mixed,255,143,398
288930,8,Very Positive,340,74,414
289070,6,Mostly Positive,29863,12306,42169
289090,5,Mixed,1133,662,1795
289130,8,Very Positive,8845,1672,10517
289520,5,Mixed,546,243,789
289690,5,Mixed,603,471,1074
289760,6,Mostly Positive,401,102,503
289930,5,Mixed,546,263,809
289950,6,Mostly Positive,2205,748,2953
290000,6,Mostly Positive,176,45,221
290020,8,Very Positive,97,21,118
290080,5,Mixed,5737,3072,8809
290260,8,Very Positive,250,21,271
290300,8,Very Positive,4541,763,5304
290320,8,Very Positive,69,15,84
290340,8,Very Positive,5668,1191,6859
290380,8,Very Positive,135,5,140
290440,5,Mixed,18,23,41
290490,5,Mixed,120,166,286
290510,0,No user reviews,0,0,0
290530,8,Very Positive,261,64,325
290730,8,Very Positive,2705,446,3151
290770,8,Very Positive,2638,335,2973
290790,5,Mixed,2170,997,3167
290810,4,Mostly Negative,36,57,93
290870,6,Mostly Positive,58,17,75
290890,8,Very Positive,575,118,693
290970,5,Mixed,186,80,266
290990,5,Mixed,77,35,112
291010,5,Mixed,2185,1023,3208
291030,5,Mixed,147,99,246
291050,5,Mixed,42,30,72
291070,8,Very Positive,87,20,107
291130,5,Mixed,310,337,647
291170,6,Mostly Positive,125,49,174
291190,6,Mostly Positive,151,40,191
291370,4,Mostly Negative,47,121,168
291390,5,Mixed,63,30,93
291410,8,Very Positive,3109,688,3797
291430,6,Mostly Positive,32,11,43
291480,6,Mostly Positive,26047,11136,37183
291550,8,Very Positive,52691,9115,61806
291610,5,Mixed,17,8,25
291650,8,Very Positive,10429,1532,11961
291690,6,Mostly Positive,45,14,59
291710,6,Mostly Positive,164,49,213
291840,0,No user reviews,0,0,0
291860,8,Very Positive,4147,237,4384
291910,5,Mixed,218,183,401
291930,4,Mostly Negative,65,130,195
292030,9,Overwhelmingly Positive,149117,3223,152340
292090,7,Positive,16,4,20
292120,6,Mostly Positive,6374,2440,8814
292140,5,Mixed,1646,988,2634
292200,6,Mostly Positive,174,57,231
292330,5,Mixed,158,123,281
292370,5,Mixed,120,105,225
292400,5,Mixed,104,46,150
292480,5,Mixed,194,97,291
292500,8,Very Positive,451,32,483
292570,5,Mixed,300,136,436
292600,8,Very Positive,557,31,588
292730,5,Mixed,6740,9520,16260
292910,8,Very Positive,1775,208,1983
293200,5,Mixed,38,26,64
293220,5,Mixed,464,349,813
293240,8,Very Positive,383,37,420
293260,8,Very Positive,2839,434,3273
293340,5,Mixed,60,51,111
293360,7,Positive,16,3,19
293420,5,Mixed,27,13,40
293440,6,Mostly Positive,108,31,139
293460,5,Mixed,86,39,125
293480,4,Mostly Negative,77,122,199
293520,6,Mostly Positive,321,127,448
293540,5,Mixed,1022,525,1547
293600,5,Mixed,33,40,73
293660,8,Very Positive,312,31,343
293680,8,Very Positive,537,62,599
293740,8,Very Positive,236,44,280
293780,9,Overwhelmingly Positive,3223,117,3340
293860,5,Mixed,307,192,499
293900,8,Very Positive,190,18,208
293920,5,Mixed,29,34,63
293940,5,Mixed,192,103,295
293960,5,Mixed,33,17,50
294000,8,Very Positive,226,39,265
294020,5,Mixed,267,133,400
294040,6,Mostly Positive,855,301,1156
294060,6,Mostly Positive,80,32,112
294140,8,Very Positive,789,161,950
294160,8,Very Positive,586,94,680
294190,4,Mostly Negative,8,13,21
294230,8,Very Positive,443,93,536
294370,6,Mostly Positive,280,84,364
294440,8,Very Positive,434,60,494
294460,8,Very Positive,114,23,137
294750,8,Very Positive,174,43,217
294810,8,Very Positive,889,70,959
294830,5,Mixed,82,116,198
294860,8,Very Positive,7915,698,8613
295110,5,Mixed,45336,30556,75892
295490,5,Mixed,78,36,114
295550,5,Mixed,773,357,1130
295630,8,Very Positive,74,17,91
295670,6,Mostly Positive,193,49,242
295690,8,Very Positive,1076,127,1203
295730,8,Very Positive,176,35,211
295750,8,Very Positive,252,59,311
295790,8,Very Positive,4722,1094,5816
295850,6,Mostly Positive,239,98,337
295870,6,Mostly Positive,51,17,68
295930,5,Mixed,236,279,515
296030,7,Positive,27,5,32
296050,5,Mixed,502,221,723
296070,5,Mixed,790,362,1152
296150,4,Mostly Negative,21,51,72
296220,6,Mostly Positive,196,53,249
296300,6,Mostly Positive,4038,1209,5247
296470,9,Overwhelmingly Positive,5636,266,5902
296490,9,Overwhelmingly Positive,1923,81,2004
296510,6,Mostly Positive,48,20,68
296550,8,Very Positive,77,14,91
296570,8,Very Positive,734,145,879
296590,4,Mostly Negative,15,26,41
296630,6,Mostly Positive,281,102,383
296710,8,Very Positive,1160,120,1280
296730,6,Mostly Positive,115,36,151
296770,5,Mixed,601,365,966
296790,6,Mostly Positive,18,5,23
296810,0,5 user reviews,4,1,5
296830,5,Mixed,654,446,1100
296850,5,Mixed,30,21,51
296870,8,Very Positive,1367,131,1498
296910,6,Mostly Positive,1207,420,1627
296930,6,Mostly Positive,142,37,179
296970,8,Very Positive,1835,123,1958
297000,5,Mixed,3732,1766,5498
297020,6,Mostly Positive,2205,765,2970
297100,4,Mostly Negative,53,100,153
297120,8,Very Positive,839,158,997
297130,6,Mostly Positive,2953,829,3782
297290,8,Very Positive,149,33,182
297330,5,Mixed,65,52,117
297370,8,Very Positive,104,12,116
297410,7,Positive,35,7,42
297450,5,Mixed,79,56,135
297490,8,Very Positive,235,29,264
297590,8,Very Positive,57,1,58
297660,7,Positive,38,4,42
297740,5,Mixed,30,24,54
297920,6,Mostly Positive,178,58,236
298050,6,Mostly Positive,2679,1117,3796
298160,6,Mostly Positive,989,265,1254
298260,5,Mixed,3487,1957,5444
298340,5,Mixed,116,82,198
298360,8,Very Positive,106,6,112
298380,0,6 user reviews,5,1,6
298400,8,Very Positive,362,28,390
298420,6,Mostly Positive,11,3,14
298480,6,Mostly Positive,291,91,382
298520,8,Very Positive,1372,261,1633
298560,8,Very Positive,209,38,247
298600,8,Very Positive,1856,163,2019
298630,8,Very Positive,9822,1161,10983
298790,7,Positive,36,3,39
298820,7,Positive,32,4,36
298830,7,Positive,24,2,26
298840,7,Positive,18,2,20
298850,5,Mixed,17,10,27
298900,5,Mixed,2889,2542,5431
298930,6,Mostly Positive,249,70,319
298950,6,Mostly Positive,90,29,119
299090,5,Mixed,12,14,26
299250,4,Mostly Negative,194,298,492
299340,5,Mixed,92,102,194
299360,6,Mostly Positive,8995,2615,11610
299380,7,Positive,10,1,11
299400,8,Very Positive,87,9,96
299420,5,Mixed,169,95,264
299440,5,Mixed,51,22,73
299460,5,Mixed,3542,1718,5260
299480,6,Mostly Positive,559,233,792
299540,8,Very Positive,290,44,334
299580,5,Mixed,31,18,49
299660,8,Very Positive,374,33,407
299680,6,Mostly Positive,957,244,1201
299720,8,Very Positive,851,158,1009
299740,5,Mixed,14956,6673,21629
299800,8,Very Positive,50,3,53
299950,8,Very Positive,408,94,502
300060,5,Mixed,691,546,1237
300220,5,Mixed,257,151,408
300280,6,Mostly Positive,66,27,93
300300,8,Very Positive,484,52,536
300320,5,Mixed,74,68,142
300340,8,Very Positive,176,23,199
300360,5,Mixed,50,29,79
300380,8,Very Positive,3617,685,4302
300400,8,Very Positive,76,12,88
300540,5,Mixed,58,55,113
300550,8,Very Positive,3160,333,3493
300570,8,Very Positive,1330,78,1408
300580,6,Mostly Positive,308,113,421
300610,5,Mixed,115,114,229
300620,7,Positive,12,1,13
300630,5,Mixed,57,28,85
300760,5,Mixed,57,41,98
300840,8,Very Positive,61,4,65
301050,5,Mixed,71,33,104
301150,8,Very Positive,281,52,333
301190,8,Very Positive,656,119,775
301200,8,Very Positive,532,100,632
301220,2,Very Negative,20,132,152
301250,0,9 user reviews,2,7,9
301300,8,Very Positive,199,6,205
301360,5,Mixed,33,43,76
301380,8,Very Positive,102,8,110
301420,6,Mostly Positive,30,12,42
301460,8,Very Positive,431,103,534
301520,6,Mostly Positive,70946,26834,97780
301540,5,Mixed,54,65,119
301640,8,Very Positive,6987,1048,8035
301650,8,Very Positive,444,39,483
301750,5,Mixed,488,456,944
301840,8,Very Positive,170,32,202
301860,6,Mostly Positive,1665,586,2251
301910,6,Mostly Positive,4460,1550,6010
301920,8,Very Positive,76,4,80
301930,7,Positive,18,2,20
301970,8,Very Positive,998,92,1090
301990,6,Mostly Positive,50,21,71
302060,5,Mixed,196,108,304
302270,5,Mixed,765,748,1513
302290,4,Mostly Negative,7,11,18
302310,5,Mixed,66,92,158
302440,5,Mixed,30,33,63
302510,8,Very Positive,12509,2430,14939
302590,8,Very Positive,1717,298,2015
302610,8,Very Positive,1176,96,1272
302670,6,Mostly Positive,3730,1594,5324
302690,8,Very Positive,349,57,406
302710,8,Very Positive,846,122,968
302790,8,Very Positive,652,52,704
302850,5,Mixed,54,38,92
302870,5,Mixed,13,14,27
302950,5,Mixed,56,48,104
302970,8,Very Positive,60,11,71
303260,5,Mixed,47,47,94
303310,8,Very Positive,374,7,381
303340,5,Mixed,42,27,69
303430,8,Very Positive,388,30,418
303470,5,Mixed,77,37,114
303510,5,Mixed,75,84,159
303530,5,Mixed,23,11,34
303550,8,Very Positive,165,17,182
303610,8,Very Positive,351,50,401
303680,8,Very Positive,109,17,126
303690,6,Mostly Positive,120,32,152
303720,5,Mixed,31,15,46
303790,6,Mostly Positive,330,124,454
303800,6,Mostly Positive,543,144,687
303830,4,Mostly Negative,12,47,59
303840,6,Mostly Positive,117,46,163
303860,6,Mostly Positive,38,13,51
303870,4,Mostly Negative,18,35,53
303880,4,Mostly Negative,9,19,28
303910,5,Mixed,15,11,26
303940,6,Mostly Positive,100,28,128
304050,6,Mostly Positive,39269,11164,50433
304170,2,Very Negative,30,137,167
304240,8,Very Positive,5151,500,5651
304290,8,Very Positive,121,28,149
304410,9,Overwhelmingly Positive,1748,50,1798
304430,9,Overwhelmingly Positive,16902,786,17688
304460,5,Mixed,224,100,324
304530,5,Mixed,1394,941,2335
304580,5,Mixed,104,151,255
304650,8,Very Positive,4703,975,5678
304670,8,Very Positive,266,66,332
304690,0,No user reviews,0,0,0
304730,5,Mixed,1849,1034,2883
304910,6,Mostly Positive,140,36,176
304930,8,Very Positive,252271,24725,276996
304950,8,Very Positive,278,61,339
305010,3,Negative,7,30,37
305050,8,Very Positive,2563,561,3124
305070,5,Mixed,163,107,270
305260,6,Mostly Positive,2386,719,3105
305380,8,Very Positive,967,92,1059
305480,5,Mixed,21,15,36
305490,5,Mixed,40,23,63
305500,5,Mixed,68,51,119
305620,8,Very Positive,34834,3057,37891
305640,5,Mixed,342,149,491
305760,8,Very Positive,115,0,115
305780,8,Very Positive,103,25,128
305800,5,Mixed,49,31,80
305820,6,Mostly Positive,36,13,49
305920,8,Very Positive,237,33,270
305940,6,Mostly Positive,348,136,484
305960,5,Mixed,249,342,591
305980,5,Mixed,137,127,264
306000,5,Mixed,38,44,82
306020,8,Very Positive,3019,246,3265
306260,5,Mixed,21,31,52
306440,5,Mixed,54,53,107
306550,8,Very Positive,195,32,227
306660,8,Very Positive,1815,385,2200
306670,4,Mostly Negative,100,331,431
306680,6,Mostly Positive,220,74,294
306700,8,Very Positive,178,22,200
306760,8,Very Positive,1595,370,1965
306950,5,Mixed,42,26,68
307010,8,Very Positive,186,36,222
307030,7,Positive,19,0,19
307050,6,Mostly Positive,1525,595,2120
307090,6,Mostly Positive,191,66,257
307130,5,Mixed,117,87,204
307150,5,Mixed,19,12,31
307170,5,Mixed,285,177,462
307190,5,Mixed,68,30,98
307210,5,Mixed,44,29,73
307230,8,Very Positive,1554,310,1864
307270,5,Mixed,22,20,42
307430,6,Mostly Positive,61,21,82
307570,6,Mostly Positive,110,45,155
307580,9,Overwhelmingly Positive,705,35,740
307590,8,Very Positive,201,32,233
307600,5,Mixed,47,31,78
307620,5,Mixed,48,35,83
307670,6,Mostly Positive,1715,477,2192
307690,8,Very Positive,11261,1366,12627
307780,6,Mostly Positive,16573,6213,22786
307880,5,Mixed,2942,2384,5326
307940,6,Mostly Positive,227,75,302
307980,5,Mixed,33,18,51
308040,8,Very Positive,1240,279,1519
308060,6,Mostly Positive,432,133,565
308080,6,Mostly Positive,82,29,111
308173,6,Mostly Positive,237,73,310
308180,7,Positive,14,3,17
308270,8,Very Positive,254,61,315
308360,8,Very Positive,44,9,53
308380,5,Mixed,21,23,44
308400,0,2 user reviews,2,0,2
308420,8,Very Positive,2472,357,2829
308440,8,Very Positive,78,7,85
308460,6,Mostly Positive,120,49,169
308520,5,Mixed,36,30,66
308560,6,Mostly Positive,23,9,32
308600,8,Very Positive,89,2,91
310060,8,Very Positive,722,118,840
310080,8,Very Positive,4770,301,5071
310110,5,Mixed,101,93,194
310360,9,Overwhelmingly Positive,1177,47,1224
310380,6,Mostly Positive,8938,2779,11717
310460,4,Mostly Negative,6,20,26
310470,5,Mixed,629,844,1473
310490,8,Very Positive,139,23,162
310510,8,Very Positive,857,195,1052
310560,8,Very Positive,14682,1910,16592
310700,8,Very Positive,373,49,422
310740,6,Mostly Positive,150,39,189
310790,8,Very Positive,853,87,940
310810,6,Mostly Positive,47,17,64
310850,5,Mixed,122,178,300
310880,5,Mixed,24,36,60
310890,5,Mixed,384,338,722
310990,0,8 user reviews,5,3,8
311010,8,Very Positive,501,58,559
311170,5,Mixed,16,22,38
311210,5,Mixed,32412,20416,52828
311240,8,Very Positive,1247,106,1353
311250,6,Mostly Positive,228,86,314
311260,5,Mixed,1043,1005,2048
311290,6,Mostly Positive,1472,592,2064
311340,8,Very Positive,7083,1422,8505
311480,8,Very Positive,538,118,656
311490,5,Mixed,14,14,28
311680,6,Mostly Positive,56,21,77
311690,8,Very Positive,14732,969,15701
311720,8,Very Positive,336,70,406
311730,5,Mixed,3964,2457,6421
311800,8,Very Positive,298,11,309
311840,5,Mixed,26,19,45
311860,5,Mixed,86,44,130
311870,8,Very Positive,876,67,943
311910,5,Mixed,67,50,117
311930,8,Very Positive,80,3,83
311940,0,2 user reviews,2,0,2
311980,2,Very Negative,13,56,69
312050,5,Mixed,19,23,42
312150,6,Mostly Positive,617,264,881
312200,0,No user reviews,0,0,0
312220,4,Mostly Negative,15,28,43
312230,8,Very Positive,205,50,255
312240,7,Positive,15,3,18
312280,6,Mostly Positive,1164,413,1577
312300,8,Very Positive,112,10,122
312410,7,Positive,29,6,35
312430,5,Mixed,120,96,216
312440,5,Mixed,19,13,32
312450,6,Mostly Positive,661,273,934
312510,8,Very Positive,61,10,71
312520,8,Very Positive,966,168,1134
312530,9,Overwhelmingly Positive,12794,555,13349
312540,8,Very Positive,371,30,401
312560,8,Very Positive,156,16,172
312600,5,Mixed,72,34,106
312610,8,Very Positive,1296,116,1412
312630,6,Mostly Positive,164,56,220
312650,8,Very Positive,130,31,161
312660,8,Very Positive,6266,888,7154
312670,0,No user reviews,0,0,0
312720,8,Very Positive,98,9,107
312750,8,Very Positive,765,146,911
312780,6,Mostly Positive,850,215,1065
312790,5,Mixed,114,65,179
312840,8,Very Positive,1937,423,2360
312900,5,Mixed,79,38,117
312920,6,Mostly Positive,75,23,98
312960,5,Mixed,70,80,150
312980,8,Very Positive,216,29,245
313010,4,Mostly Negative,518,1196,1714
313020,8,Very Positive,1884,258,2142
313080,5,Mixed,294,174,468
313120,6,Mostly Positive,13839,4326,18165
313130,5,Mixed,81,61,142
313160,8,Very Positive,9432,963,10395
313340,8,Very Positive,9263,1261,10524
313390,8,Very Positive,78,17,95
313400,8,Very Positive,238,11,249
313470,8,Very Positive,75,12,87
313590,6,Mostly Positive,174,59,233
313630,8,Very Positive,1651,394,2045
313650,5,Mixed,222,141,363
313690,8,Very Positive,1857,298,2155
313780,8,Very Positive,524,107,631
313810,6,Mostly Positive,115,46,161
313830,5,Mixed,191,89,280
313980,6,Mostly Positive,102,38,140
314000,5,Mixed,682,385,1067
314010,8,Very Positive,480,117,597
314020,8,Very Positive,3602,682,4284
314050,0,6 user reviews,4,2,6
314070,8,Very Positive,593,65,658
314120,6,Mostly Positive,19,8,27
314150,5,Mixed,275,196,471
314180,8,Very Positive,247,6,253
314200,6,Mostly Positive,73,27,100
314210,3,Negative,6,37,43
314220,5,Mixed,64,41,105
314240,5,Mixed,256,180,436
314250,6,Mostly Positive,412,122,534
314280,5,Mixed,795,524,1319
314290,5,Mixed,30,32,62
314330,7,Positive,41,5,46
314340,5,Mixed,46,43,89
314360,8,Very Positive,78,7,85
314370,6,Mostly Positive,77,23,100
314410,8,Very Positive,1946,155,2101
314450,8,Very Positive,1262,256,1518
314460,5,Mixed,31,28,59
314470,8,Very Positive,109,22,131
314520,5,Mixed,838,507,1345
314560,5,Mixed,65,37,102
314570,5,Mixed,18,19,37
314590,8,Very Positive,53,13,66
314630,7,Positive,14,2,16
314660,8,Very Positive,1803,229,2032
314710,5,Mixed,1244,1246,2490
314760,5,Mixed,9,12,21
314790,8,Very Positive,813,133,946
314810,6,Mostly Positive,535,160,695
314830,5,Mixed,427,209,636
314850,3,Negative,2,22,24
314970,6,Mostly Positive,977,254,1231
314980,6,Mostly Positive,357,115,472
315060,5,Mixed,172,89,261
315070,4,Mostly Negative,23,89,112
315080,7,Positive,35,7,42
315110,6,Mostly Positive,73,23,96
315130,5,Mixed,26,28,54
315320,4,Mostly Negative,45,101,146
315340,6,Mostly Positive,107,30,137
315430,8,Very Positive,3605,852,4457
315450,5,Mixed,29,17,46
315460,8,Very Positive,2222,186,2408
315480,4,Mostly Negative,4,16,20
315680,4,Mostly Negative,18,35,53
315830,8,Very Positive,92,17,109
315850,5,Mixed,123,61,184
315860,5,Mixed,207,90,297
315920,5,Mixed,110,53,163
315930,8,Very Positive,46,9,55
315940,5,Mixed,36,20,56
316010,6,Mostly Positive,15980,6382,22362
316020,7,Positive,31,4,35
316080,8,Very Positive,95,11,106
316140,5,Mixed,46,34,80
316180,5,Mixed,49,31,80
316370,5,Mixed,47,38,85
316480,6,Mostly Positive,94,25,119
316600,8,Very Positive,301,25,326
316610,8,Very Positive,155,7,162
316660,6,Mostly Positive,53,15,68
316720,9,Overwhelmingly Positive,1343,34,1377
316740,5,Mixed,26,24,50
316750,4,Mostly Negative,86,228,314
316790,8,Very Positive,3633,408,4041
316810,5,Mixed,42,37,79
316890,5,Mixed,184,98,282
316930,5,Mixed,353,188,541
316970,5,Mixed,43,39,82
317040,8,Very Positive,274,24,298
317060,5,Mixed,48,51,99
317100,6,Mostly Positive,235,69,304
317280,6,Mostly Positive,94,29,123
317290,5,Mixed,20,13,33
317300,6,Mostly Positive,123,40,163
317320,8,Very Positive,111,6,117
317360,8,Very Positive,7735,662,8397
317370,7,Positive,40,9,49
317440,5,Mixed,82,61,143
317510,8,Very Positive,748,98,846
317530,5,Mixed,73,49,122
317610,5,Mixed,44,19,63
317620,6,Mostly Positive,460,195,655
317710,8,Very Positive,506,61,567
317730,4,Mostly Negative,32,55,87
317820,6,Mostly Positive,1108,366,1474
317840,6,Mostly Positive,29,9,38
317940,6,Mostly Positive,116,48,164
317950,5,Mixed,23,21,44
318020,5,Mixed,1216,751,1967
318090,5,Mixed,129,60,189
318100,5,Mixed,929,829,1758
318130,9,Overwhelmingly Positive,1386,47,1433
318230,8,Very Positive,676,159,835
318260,5,Mixed,64,32,96
318310,8,Very Positive,276,18,294
318330,8,Very Positive,97,10,107
318430,8,Very Positive,2762,518,3280
318440,5,Mixed,17,19,36
318480,7,Positive,38,3,41
318530,8,Very Positive,749,134,883
318600,6,Mostly Positive,2654,818,3472
318650,5,Mixed,61,32,93
318680,0,6 user reviews,4,2,6
318860,5,Mixed,64,34,98
318970,8,Very Positive,365,51,416
319050,6,Mostly Positive,686,190,876
319140,6,Mostly Positive,362,130,492
319250,8,Very Positive,360,38,398
319270,8,Very Positive,90,13,103
319320,8,Very Positive,243,35,278
319450,8,Very Positive,163,38,201
319480,8,Very Positive,700,66,766
319550,8,Very Positive,758,103,861
319570,4,Mostly Negative,171,261,432
319630,9,Overwhelmingly Positive,101790,3702,105492
319740,6,Mostly Positive,240,81,321
319760,8,Very Positive,116,16,132
319780,4,Mostly Negative,40,81,121
319830,6,Mostly Positive,669,174,843
319850,8,Very Positive,267,53,320
319910,5,Mixed,3158,1593,4751
319970,6,Mostly Positive,362,129,491
320040,6,Mostly Positive,1098,328,1426
320090,7,Positive,33,4,37
320120,5,Mixed,23,21,44
320140,8,Very Positive,1483,191,1674
320150,8,Very Positive,213,42,255
320240,6,Mostly Positive,1970,684,2654
320300,8,Very Positive,6925,653,7578
320340,5,Mixed,470,472,942
320430,6,Mostly Positive,237,65,302
320520,6,Mostly Positive,75,30,105
320540,6,Mostly Positive,349,143,492
320610,6,Mostly Positive,94,27,121
320630,6,Mostly Positive,90,29,119
320650,5,Mixed,37,30,67
320670,6,Mostly Positive,63,19,82
320820,5,Mixed,654,331,985
320840,6,Mostly Positive,238,65,303
321150,6,Mostly Positive,445,170,615
321160,0,No user reviews,0,0,0
321210,0,No user reviews,0,0,0
321260,5,Mixed,415,344,759
321270,6,Mostly Positive,445,124,569
321330,6,Mostly Positive,34,11,45
321350,5,Mixed,16,8,24
321360,6,Mostly Positive,2390,902,3292
321370,5,Mixed,52,29,81
321400,6,Mostly Positive,1191,335,1526
321490,4,Mostly Negative,16,37,53
321560,8,Very Positive,116,17,133
321660,4,Mostly Negative,16,39,55
321800,8,Very Positive,552,87,639
321830,6,Mostly Positive,136,49,185
321920,6,Mostly Positive,181,51,232
321950,5,Mixed,200,219,419
321960,5,Mixed,1242,1501,2743
322080,6,Mostly Positive,58,19,77
322110,8,Very Positive,2075,137,2212
322170,9,Overwhelmingly Positive,40871,2014,42885
322190,9,Overwhelmingly Positive,2215,89,2304
322210,8,Very Positive,1347,84,1431
322290,8,Very Positive,442,37,479
322440,5,Mixed,31,27,58
322450,8,Very Positive,54,2,56
322500,8,Very Positive,11942,1757,13699
322520,5,Mixed,490,280,770
322550,6,Mostly Positive,14,5,19
322630,5,Mixed,26,30,56
322680,8,Very Positive,530,65,595
322750,8,Very Positive,173,36,209
322770,8,Very Positive,2027,119,2146
322850,5,Mixed,184,128,312
322900,6,Mostly Positive,241,99,340
322910,6,Mostly Positive,1065,439,1504
322920,5,Mixed,2059,1572,3631
322950,5,Mixed,33,42,75
322970,5,Mixed,120,80,200
323020,0,3 user reviews,2,1,3
323040,6,Mostly Positive,48,15,63
323060,5,Mixed,1319,582,1901
323190,8,Very Positive,10959,1636,12595
323320,8,Very Positive,3470,327,3797
323380,8,Very Positive,970,74,1044
323450,8,Very Positive,77,13,90
323460,8,Very Positive,248,43,291
323470,8,Very Positive,11590,1535,13125
323490,8,Very Positive,401,34,435
323580,6,Mostly Positive,4478,1221,5699
323630,8,Very Positive,163,12,175
323680,3,Negative,7,34,41
323700,6,Mostly Positive,28,11,39
323720,6,Mostly Positive,634,219,853
323850,8,Very Positive,6322,872,7194
323900,6,Mostly Positive,321,105,426
324060,5,Mixed,82,54,136
324070,8,Very Positive,125,26,151
324090,5,Mixed,70,42,112
324120,6,Mostly Positive,171,68,239
324140,8,Very Positive,182,9,191
324160,9,Overwhelmingly Positive,1568,23,1591
324260,6,Mostly Positive,421,170,591
324270,0,9 user reviews,3,6,9
324310,5,Mixed,1218,776,1994
324390,8,Very Positive,40,10,50
324400,5,Mixed,8,10,18
324420,5,Mixed,34,30,64
324470,6,Mostly Positive,126,35,161
324510,6,Mostly Positive,537,178,715
324520,8,Very Positive,137,31,168
324570,8,Very Positive,427,89,516
324610,2,Very Negative,16,113,129
324650,6,Mostly Positive,234,68,302
324710,8,Very Positive,143,12,155
324730,6,Mostly Positive,19,7,26
324740,6,Mostly Positive,302,85,387
324750,5,Mixed,40,33,73
324810,6,Mostly Positive,3427,1028,4455
325060,8,Very Positive,94,12,106
325090,6,Mostly Positive,375,99,474
325120,8,Very Positive,414,58,472
325150,8,Very Positive,94,11,105
325160,7,Positive,35,2,37
325300,0,8 user reviews,8,0,8
325520,8,Very Positive,278,43,321
325610,6,Mostly Positive,10499,3484,13983
325630,5,Mixed,84,100,184
325730,6,Mostly Positive,143,46,189
325790,4,Mostly Negative,79,121,200
325860,6,Mostly Positive,30,10,40
325870,6,Mostly Positive,40,15,55
325880,5,Mixed,34,38,72
325930,8,Very Positive,152,18,170
326110,5,Mixed,9,13,22
326120,8,Very Positive,208,49,257
326150,8,Very Positive,467,39,506
326160,5,Mixed,821,766,1587
326180,5,Mixed,882,458,1340
326190,6,Mostly Positive,697,212,909
326340,5,Mixed,375,171,546
326360,5,Mixed,369,180,549
326380,7,Positive,33,7,40
326410,8,Very Positive,2048,497,2545
326420,4,Mostly Negative,9,31,40
326460,8,Very Positive,8959,955,9914
326470,6,Mostly Positive,27,11,38
326480,8,Very Positive,2203,174,2377
326520,6,Mostly Positive,69,18,87
326650,3,Negative,6,39,45
326670,5,Mixed,459,228,687
326720,8,Very Positive,132,21,153
326730,5,Mixed,34,39,73
326840,8,Very Positive,272,57,329
326950,6,Mostly Positive,229,86,315
327000,0,5 user reviews,1,4,5
327010,4,Mostly Negative,107,178,285
327030,8,Very Positive,1661,404,2065
327070,5,Mixed,1636,765,2401
327090,5,Mixed,1327,710,2037
327150,6,Mostly Positive,36,11,47
327260,8,Very Positive,250,51,301
327310,8,Very Positive,207,38,245
327410,8,Very Positive,5332,1042,6374
327440,6,Mostly Positive,129,35,164
327500,8,Very Positive,62,6,68
327510,6,Mostly Positive,666,214,880
327520,6,Mostly Positive,54,16,70
327560,8,Very Positive,434,43,477
327640,5,Mixed,719,418,1137
327670,8,Very Positive,478,110,588
327680,5,Mixed,518,632,1150
327760,7,Positive,23,3,26
327860,8,Very Positive,1044,238,1282
327880,8,Very Positive,378,46,424
327890,6,Mostly Positive,3567,999,4566
327960,3,Negative,4,17,21
327980,7,Positive,16,1,17
328000,5,Mixed,6,6,12
328060,5,Mixed,272,253,525
328270,8,Very Positive,408,86,494
328500,6,Mostly Positive,353,130,483
328550,7,Positive,20,5,25
328590,6,Mostly Positive,131,36,167
328600,5,Mixed,179,92,271
328640,5,Mixed,20,16,36
328650,5,Mixed,8,5,13
328680,5,Mixed,32,17,49
328710,5,Mixed,67,30,97
328730,8,Very Positive,293,19,312
328760,8,Very Positive,1115,84,1199
328780,7,Positive,34,5,39
328940,5,Mixed,259,150,409
329000,5,Mixed,31,32,63
329020,5,Mixed,131,57,188
329050,8,Very Positive,3639,342,3981
329110,6,Mostly Positive,2597,852,3449
329130,8,Very Positive,1902,135,2037
329240,6,Mostly Positive,55,17,72
329280,5,Mixed,66,49,115
329320,8,Very Positive,84,10,94
329340,7,Positive,10,2,12
329380,6,Mostly Positive,617,175,792
329430,6,Mostly Positive,3238,1036,4274
329440,5,Mixed,810,478,1288
329460,8,Very Positive,350,34,384
329490,8,Very Positive,2030,372,2402
329690,8,Very Positive,102,16,118
329790,5,Mixed,171,100,271
329860,8,Very Positive,716,85,801
330000,5,Mixed,66,58,124
330020,7,Positive,32,0,32
330100,6,Mostly Positive,134,38,172
330180,8,Very Positive,230,52,282
330270,5,Mixed,162,101,263
330370,6,Mostly Positive,50,14,64
330390,8,Very Positive,955,92,1047
330450,6,Mostly Positive,23,7,30
330580,6,Mostly Positive,950,261,1211
330620,6,Mostly Positive,81,26,107
330660,5,Mixed,46,25,71
330670,7,Positive,28,3,31
330680,3,Negative,3,18,21
330770,8,Very Positive,104,22,126
330820,6,Mostly Positive,772,200,972
330830,9,Overwhelmingly Positive,12881,575,13456
330840,6,Mostly Positive,7341,2250,9591
330990,5,Mixed,156,92,248
331220,6,Mostly Positive,113,34,147
331340,5,Mixed,99,91,190
331390,8,Very Positive,121,18,139
331400,4,Mostly Negative,10,37,47
331440,8,Very Positive,1417,303,1720
331460,8,Very Positive,72,9,81
331470,9,Overwhelmingly Positive,24564,1233,25797
331480,8,Very Positive,405,51,456
331510,8,Very Positive,105,20,125
331570,6,Mostly Positive,28,8,36
331600,8,Very Positive,3887,785,4672
331610,4,Mostly Negative,12,44,56
331670,8,Very Positive,687,59,746
331690,8,Very Positive,346,54,400
331720,6,Mostly Positive,113,30,143
331760,5,Mixed,47,26,73
331790,5,Mixed,88,57,145
331870,8,Very Positive,733,138,871
331910,4,Mostly Negative,9,25,34
331980,5,Mixed,92,70,162
332070,5,Mixed,1466,1504,2970
332200,8,Very Positive,2738,150,2888
332250,8,Very Positive,158,38,196
332270,7,Positive,24,5,29
332310,6,Mostly Positive,7792,2309,10101
332330,8,Very Positive,59,11,70
332370,7,Positive,9,1,10
332380,8,Very Positive,63,10,73
332390,8,Very Positive,103,14,117
332400,8,Very Positive,117,16,133
332410,8,Very Positive,92,15,107
332480,8,Very Positive,432,84,516
332490,6,Mostly Positive,191,62,253
332530,5,Mixed,61,36,97
332540,8,Very Positive,50,1,51
332610,8,Very Positive,122,14,136
332620,5,Mixed,105,47,152
332630,7,Positive,28,5,33
332710,5,Mixed,76,64,140
332730,5,Mixed,15,16,31
332790,5,Mixed,175,222,397
332830,8,Very Positive,74,5,79
332880,7,Positive,20,3,23
333120,4,Mostly Negative,34,55,89
333130,0,8 user reviews,7,1,8
333210,5,Mixed,167,85,252
333250,8,Very Positive,1247,217,1464
333290,7,Positive,15,1,16
333300,8,Very Positive,520,61,581
333330,6,Mostly Positive,57,15,72
333340,5,Mixed,63,74,137
333390,7,Positive,35,8,43
333420,6,Mostly Positive,3706,1237,4943
333490,7,Positive,24,4,28
333510,7,Positive,37,8,45
333580,7,Positive,14,2,16
333600,9,Overwhelmingly Positive,13511,601,14112
333640,9,Overwhelmingly Positive,1121,35,1156
333650,5,Mixed,25,32,57
333660,5,Mixed,61,43,104
333730,4,Mostly Negative,14,22,36
333870,8,Very Positive,77,17,94
333880,6,Mostly Positive,170,62,232
333930,8,Very Positive,37347,8984,46331
333970,6,Mostly Positive,74,26,100
333980,8,Very Positive,1875,262,2137
334030,5,Mixed,175,93,268
334070,5,Mixed,552,294,846
334100,7,Positive,21,3,24
334140,8,Very Positive,77,4,81
334190,6,Mostly Positive,174,48,222
334210,6,Mostly Positive,564,171,735
334230,8,Very Positive,10028,1358,11386
334260,0,7 user reviews,7,0,7
334270,5,Mixed,32,21,53
334280,5,Mixed,33,20,53
334300,8,Very Positive,105,18,123
334350,0,No user reviews,0,0,0
334420,6,Mostly Positive,783,227,1010
334560,8,Very Positive,197,30,227
334620,6,Mostly Positive,29,10,39
334690,6,Mostly Positive,204,65,269
334710,6,Mostly Positive,47,19,66
334830,6,Mostly Positive,31,11,42
334840,8,Very Positive,48,9,57
334850,5,Mixed,71,31,102
334940,8,Very Positive,132,7,139
334960,4,Mostly Negative,4,8,12
335000,8,Very Positive,1586,97,1683
335010,6,Mostly Positive,37,10,47
335070,6,Mostly Positive,189,52,241
335090,7,Positive,33,0,33
335100,6,Mostly Positive,155,54,209
335190,8,Very Positive,223,47,270
335200,6,Mostly Positive,40,17,57
335220,5,Mixed,18,10,28
335240,8,Very Positive,9364,1707,11071
335300,8,Very Positive,20745,2973,23718
335450,7,Positive,15,1,16
335460,8,Very Positive,51,10,61
335550,6,Mostly Positive,15,4,19
335560,7,Positive,18,1,19
335620,8,Very Positive,590,43,633
335660,5,Mixed,83,45,128
335670,9,Overwhelmingly Positive,6156,285,6441
335690,4,Mostly Negative,20,31,51
335700,5,Mixed,130,61,191
335830,5,Mixed,161,86,247
335840,6,Mostly Positive,108,34,142
335900,5,Mixed,21,28,49
335920,8,Very Positive,171,15,186
336010,5,Mixed,46,22,68
336020,5,Mixed,24,29,53
336030,7,Positive,35,7,42
336040,5,Mixed,121,52,173
336060,6,Mostly Positive,190,58,248
336080,8,Very Positive,186,46,232
336090,6,Mostly Positive,72,25,97
336100,5,Mixed,38,18,56
336110,8,Very Positive,89,19,108
336130,8,Very Positive,240,25,265
336140,0,No user reviews,0,0,0
336150,6,Mostly Positive,136,35,171
336160,0,6 user reviews,5,1,6
336200,5,Mixed,31,18,49
336210,5,Mixed,14,17,31
336240,8,Very Positive,237,29,266
336250,5,Mixed,44,54,98
336280,5,Mixed,51,25,76
336300,8,Very Positive,245,42,287
336420,6,Mostly Positive,293,76,369
336440,8,Very Positive,171,9,180
336610,8,Very Positive,362,28,390
336700,7,Positive,17,3,20
336710,7,Positive,18,4,22
336730,6,Mostly Positive,18,5,23
336840,7,Positive,21,3,24
336940,8,Very Positive,61,4,65
337000,5,Mixed,13241,6096,19337
337040,5,Mixed,85,39,124
337070,5,Mixed,234,109,343
337110,5,Mixed,31,32,63
337130,0,8 user reviews,6,2,8
337150,8,Very Positive,548,76,624
337180,5,Mixed,48,28,76
337210,5,Mixed,82,52,134
337220,5,Mixed,35,38,73
337270,8,Very Positive,180,29,209
337280,6,Mostly Positive,45,16,61
337290,8,Very Positive,66,5,71
337340,9,Overwhelmingly Positive,4689,84,4773
337350,8,Very Positive,156,7,163
337360,5,Mixed,70,62,132
337480,6,Mostly Positive,164,43,207
337490,8,Very Positive,148,25,173
337650,7,Positive,24,0,24
337670,7,Positive,32,1,33
337680,6,Mostly Positive,82,24,106
337700,5,Mixed,17,8,25
337720,8,Very Positive,126,2,128
337820,6,Mostly Positive,153,39,192
337850,8,Very Positive,112,19,131
337960,8,Very Positive,72,17,89
337970,5,Mixed,8,5,13
337980,6,Mostly Positive,75,24,99
338000,8,Very Positive,687,58,745
338040,6,Mostly Positive,39,15,54
338050,5,Mixed,234,117,351
338120,5,Mixed,132,61,193
338130,5,Mixed,101,45,146
338170,8,Very Positive,1835,328,2163
338180,5,Mixed,1408,953,2361
338190,8,Very Positive,164,19,183
338290,0,5 user reviews,5,0,5
338310,8,Very Positive,46,6,52
338320,6,Mostly Positive,271,71,342
338330,7,Positive,25,4,29
338390,5,Mixed,1094,490,1584
338420,5,Mixed,79,37,116
338530,5,Mixed,154,106,260
338630,5,Mixed,16,8,24
338810,6,Mostly Positive,187,59,246
338830,5,Mixed,21,16,37
338840,0,No user reviews,0,0,0
338890,6,Mostly Positive,37,13,50
338980,6,Mostly Positive,90,25,115
339000,5,Mixed,72,90,162
339090,0,No user reviews,0,0,0
339110,5,Mixed,15,14,29
339120,8,Very Positive,465,93,558
339130,8,Very Positive,326,23,349
339160,8,Very Positive,254,48,302
339190,8,Very Positive,462,81,543
339200,8,Very Positive,1136,278,1414
339210,5,Mixed,94,68,162
339230,5,Mixed,878,485,1363
339250,5,Mixed,10,5,15
339280,6,Mostly Positive,3346,1048,4394
339290,5,Mixed,152,78,230
339340,8,Very Positive,1677,253,1930
339350,9,Overwhelmingly Positive,1526,46,1572
339400,8,Very Positive,1847,315,2162
339440,8,Very Positive,168,15,183
339460,7,Positive,27,4,31
339500,4,Mostly Negative,3,9,12
339510,8,Very Positive,103,20,123
339570,8,Very Positive,106,18,124
339580,6,Mostly Positive,390,115,505
339590,7,Positive,41,8,49
339600,5,Mixed,1241,1150,2391
339640,5,Mixed,72,58,130
339690,7,Positive,22,3,25
339700,5,Mixed,84,51,135
339710,5,Mixed,6,4,10
339720,7,Positive,16,3,19
339790,8,Very Positive,263,40,303
339800,9,Overwhelmingly Positive,14868,549,15417
339860,3,Negative,7,32,39
339910,8,Very Positive,324,54,378
340000,8,Very Positive,488,49,537
340030,3,Negative,6,38,44
340050,6,Mostly Positive,1405,362,1767
340070,5,Mixed,363,348,711
340140,0,3 user reviews,2,1,3
340170,5,Mixed,1346,853,2199
340220,4,Mostly Negative,45,86,131
340250,7,Positive,14,1,15
340270,5,Mixed,310,151,461
340280,8,Very Positive,226,19,245
340320,6,Mostly Positive,118,49,167
340330,6,Mostly Positive,16,5,21
340340,8,Very Positive,347,83,430
340360,8,Very Positive,191,30,221
340370,7,Positive,10,1,11
340380,7,Positive,10,2,12
340390,7,Positive,31,5,36
340440,6,Mostly Positive,28,9,37
340450,6,Mostly Positive,34,11,45
340460,5,Mixed,302,375,677
340470,5,Mixed,74,47,121
340480,5,Mixed,11,6,17
340490,8,Very Positive,597,125,722
340520,8,Very Positive,517,36,553
340560,5,Mixed,4,6,10
340580,8,Very Positive,241,29,270
340600,7,Positive,20,4,24
340630,4,Mostly Negative,34,106,140
340650,5,Mixed,66,67,133
340680,7,Positive,9,2,11
340700,0,8 user reviews,7,1,8
340720,7,Positive,24,3,27
340730,8,Very Positive,699,120,819
340750,5,Mixed,15,17,32
340770,6,Mostly Positive,221,57,278
340830,8,Very Positive,321,65,386
340880,7,Positive,21,3,24
340960,7,Positive,36,6,42
341000,8,Very Positive,2814,296,3110
341020,6,Mostly Positive,160,61,221
341030,5,Mixed,111,71,182
341040,6,Mostly Positive,39,12,51
341090,8,Very Positive,188,25,213
341120,8,Very Positive,213,23,236
341150,8,Very Positive,184,22,206
341270,5,Mixed,13,10,23
341290,7,Positive,13,2,15
341310,6,Mostly Positive,1036,366,1402
341360,5,Mixed,8,7,15
341440,5,Mixed,36,46,82
341470,6,Mostly Positive,57,24,81
341500,6,Mostly Positive,1017,375,1392
341510,7,Positive,33,8,41
341530,8,Very Positive,69,17,86
341550,8,Very Positive,347,35,382
341570,6,Mostly Positive,19,5,24
341680,8,Very Positive,50,8,58
341690,5,Mixed,35,16,51
341710,6,Mostly Positive,134,54,188
341730,8,Very Positive,266,50,316
341750,5,Mixed,10,7,17
341760,7,Positive,15,1,16
341780,5,Mixed,27,19,46
341800,9,Overwhelmingly Positive,4538,78,4616
341820,8,Very Positive,55,10,65
341860,5,Mixed,110,83,193
341870,6,Mostly Positive,296,98,394
341930,5,Mixed,34,32,66
341940,6,Mostly Positive,4528,1305,5833
341950,6,Mostly Positive,150,44,194
342020,5,Mixed,79,55,134
342090,4,Mostly Negative,20,35,55
342100,7,Positive,28,5,33
342130,5,Mixed,19,10,29
342150,5,Mixed,303,222,525
342180,8,Very Positive,2584,400,2984
342190,6,Mostly Positive,91,23,114
342200,6,Mostly Positive,3761,1188,4949
342240,5,Mixed,12,10,22
342260,6,Mostly Positive,213,65,278
342280,8,Very Positive,97,14,111
342300,8,Very Positive,606,50,656
342310,5,Mixed,406,183,589
342350,8,Very Positive,122,28,150
342450,5,Mixed,38,40,78
342480,5,Mixed,653,299,952
342490,8,Very Positive,134,29,163
342500,4,Mostly Negative,13,23,36
342520,4,Mostly Negative,16,54,70
342530,8,Very Positive,60,9,69
342550,5,Mixed,112,72,184
342560,9,Overwhelmingly Positive,1178,39,1217
342570,4,Mostly Negative,176,273,449
342580,8,Very Positive,2198,141,2339
342610,8,Very Positive,174,15,189
342620,8,Very Positive,334,64,398
342650,6,Mostly Positive,28,12,40
342660,0,2 user reviews,1,1,2
342740,5,Mixed,30,26,56
342870,4,Mostly Negative,22,36,58
342920,7,Positive,35,2,37
342970,5,Mixed,147,69,216
343020,7,Positive,9,1,10
343070,5,Mixed,100,80,180
343090,8,Very Positive,205,29,234
343100,6,Mostly Positive,796,212,1008
343170,5,Mixed,20,21,41
343280,5,Mixed,106,63,169
343340,4,Mostly Negative,35,59,94
343370,8,Very Positive,88,5,93
343410,0,8 user reviews,7,1,8
343430,7,Positive,16,4,20
343440,8,Very Positive,513,87,600
343560,8,Very Positive,315,39,354
343570,7,Positive,23,2,25
343710,5,Mixed,1507,681,2188
343780,8,Very Positive,1513,132,1645
343860,8,Very Positive,1495,237,1732
343930,6,Mostly Positive,131,54,185
344040,4,Mostly Negative,1051,2204,3255
344130,6,Mostly Positive,205,86,291
344190,6,Mostly Positive,169,67,236
344230,6,Mostly Positive,147,41,188
344240,5,Mixed,338,164,502
344270,7,Positive,13,3,16
344300,5,Mixed,141,76,217
344340,8,Very Positive,101,22,123
344410,6,Mostly Positive,165,68,233
344480,8,Very Positive,173,2,175
344500,5,Mixed,95,57,152
344740,8,Very Positive,554,92,646
344770,9,Overwhelmingly Positive,1564,29,1593
344840,5,Mixed,98,127,225
344850,6,Mostly Positive,932,294,1226
344860,8,Very Positive,190,13,203
344880,5,Mixed,47,26,73
344890,5,Mixed,24,21,45
344910,5,Mixed,349,205,554
344960,7,Positive,9,2,11
345010,6,Mostly Positive,215,87,302
345060,8,Very Positive,142,33,175
345080,6,Mostly Positive,97,36,133
345090,8,Very Positive,279,66,345
345120,8,Very Positive,334,42,376
345180,8,Very Positive,3812,482,4294
345200,8,Very Positive,252,26,278
345220,5,Mixed,397,228,625
345230,5,Mixed,22,12,34
345330,8,Very Positive,93,17,110
345340,6,Mostly Positive,14,4,18
345350,8,Very Positive,1894,458,2352
345390,8,Very Positive,1593,204,1797
345430,8,Very Positive,177,16,193
345480,6,Mostly Positive,55,17,72
345540,6,Mostly Positive,81,21,102
345640,5,Mixed,40,30,70
345660,6,Mostly Positive,933,325,1258
345700,5,Mixed,75,40,115
345710,4,Mostly Negative,17,49,66
345750,5,Mixed,49,55,104
345820,8,Very Positive,1276,77,1353
345860,8,Very Positive,168,32,200
345990,6,Mostly Positive,27,9,36
346040,4,Mostly Negative,56,99,155
346090,7,Positive,40,4,44
346110,5,Mixed,120478,53229,173707
346120,8,Very Positive,2946,508,3454
346130,0,4 user reviews,4,0,4
346180,6,Mostly Positive,526,142,668
346210,6,Mostly Positive,79,23,102
346330,5,Mixed,1918,900,2818
346340,6,Mostly Positive,22,6,28
346370,4,Mostly Negative,110,371,481
346390,0,No user reviews,0,0,0
346420,6,Mostly Positive,193,64,257
346430,0,5 user reviews,2,3,5
346440,6,Mostly Positive,21,8,29
346450,5,Mixed,52,26,78
346470,8,Very Positive,279,22,301
346490,5,Mixed,4,6,10
346500,7,Positive,33,1,34
346510,7,Positive,30,3,33
346560,8,Very Positive,1214,72,1286
346610,5,Mixed,38,27,65
346630,6,Mostly Positive,253,73,326
346670,4,Mostly Negative,8,17,25
346730,8,Very Positive,756,86,842
346760,0,2 user reviews,0,2,2
346770,8,Very Positive,49,5,54
346780,8,Very Positive,47,4,51
346800,4,Mostly Negative,23,43,66
346810,8,Very Positive,414,81,495
346830,5,Mixed,147,85,232
346850,8,Very Positive,283,25,308
346900,8,Very Positive,31115,3646,34761
346940,8,Very Positive,1973,319,2292
346970,8,Very Positive,220,30,250
347000,5,Mixed,57,25,82
347040,7,Positive,40,9,49
347060,5,Mixed,36,34,70
347080,7,Positive,10,0,10
347160,8,Very Positive,522,71,593
347280,6,Mostly Positive,26,11,37
347290,6,Mostly Positive,354,146,500
347330,7,Positive,10,1,11
347400,6,Mostly Positive,84,22,106
347430,8,Very Positive,1357,247,1604
347440,6,Mostly Positive,109,43,152
347470,8,Very Positive,52,3,55
347480,5,Mixed,5,7,12
347510,8,Very Positive,222,26,248
347520,7,Positive,36,4,40
347560,5,Mixed,616,289,905
347600,8,Very Positive,199,35,234
347670,8,Very Positive,365,68,433
347690,5,Mixed,33,16,49
347710,6,Mostly Positive,96,27,123
347720,8,Very Positive,187,18,205
347730,7,Positive,34,3,37
347790,6,Mostly Positive,31,8,39
347830,8,Very Positive,1854,181,2035
348020,5,Mixed,1708,832,2540
348030,5,Mixed,176,129,305
348160,7,Positive,40,3,43
348180,5,Mixed,32,22,54
348200,8,Very Positive,209,32,241
348240,8,Very Positive,168,26,194
348270,5,Mixed,54,48,102
348280,7,Positive,18,4,22
348300,8,Very Positive,51,7,58
348340,6,Mostly Positive,88,35,123
348360,6,Mostly Positive,402,128,530
348400,5,Mixed,46,27,73
348430,8,Very Positive,55,1,56
348440,8,Very Positive,72,4,76
348460,5,Mixed,239,275,514
348470,6,Mostly Positive,672,187,859
348490,8,Very Positive,117,27,144
348510,4,Mostly Negative,156,269,425
348530,5,Mixed,14,18,32
348540,5,Mixed,157,72,229
348550,8,Very Positive,588,51,639
348650,4,Mostly Negative,19,47,66
348670,5,Mixed,772,544,1316
348700,5,Mixed,64,42,106
348710,8,Very Positive,1391,130,1521
348730,5,Mixed,49,69,118
348740,7,Positive,8,2,10
348800,7,Positive,14,1,15
348820,8,Very Positive,164,14,178
348840,7,Positive,12,1,13
348980,4,Mostly Negative,3,11,14
349020,5,Mixed,27,13,40
349040,8,Very Positive,12999,2719,15718
349100,7,Positive,44,0,44
349140,6,Mostly Positive,96,41,137
349150,7,Positive,13,0,13
349190,6,Mostly Positive,23,9,32
349220,8,Very Positive,414,40,454
349250,8,Very Positive,109,2,111
349260,5,Mixed,48,26,74
349460,5,Mixed,13,8,21
349530,6,Mostly Positive,19,8,27
349540,4,Mostly Negative,18,28,46
349550,5,Mixed,42,27,69
349680,8,Very Positive,195,8,203
349690,7,Positive,32,1,33
349710,0,No user reviews,0,0,0
349760,8,Very Positive,71,1,72
349790,8,Very Positive,101,23,124
349840,5,Mixed,19,16,35
349950,4,Mostly Negative,17,43,60
350010,5,Mixed,219,268,487
350020,5,Mixed,128,73,201
350080,8,Very Positive,5425,703,6128
350090,5,Mixed,18,14,32
350110,5,Mixed,181,216,397
350210,7,Positive,34,6,40
350280,5,Mixed,4006,2209,6215
350310,5,Mixed,157,106,263
350330,0,8 user reviews,3,5,8
350480,7,Positive,30,6,36
350490,4,Mostly Negative,10,17,27
350530,4,Mostly Negative,49,81,130
350600,5,Mixed,115,57,172
350610,7,Positive,30,3,33
350620,8,Very Positive,44,7,51
350630,6,Mostly Positive,53,17,70
350640,6,Mostly Positive,1673,570,2243
350740,8,Very Positive,864,77,941
350770,5,Mixed,77,37,114
350780,6,Mostly Positive,107,30,137
350810,6,Mostly Positive,533,171,704
350880,7,Positive,17,4,21
350970,8,Very Positive,249,56,305
351030,6,Mostly Positive,732,298,1030
351050,5,Mixed,36,17,53
351090,8,Very Positive,320,18,338
351100,8,Very Positive,457,75,532
351140,5,Mixed,190,152,342
351150,5,Mixed,333,150,483
351170,7,Positive,16,0,16
351220,0,9 user reviews,5,4,9
351230,8,Very Positive,108,13,121
351240,7,Positive,34,5,39
351250,8,Very Positive,150,24,174
351290,5,Mixed,3571,3213,6784
351300,5,Mixed,67,49,116
351320,7,Positive,14,2,16
351330,7,Positive,23,4,27
351340,6,Mostly Positive,395,133,528
351400,5,Mixed,36,36,72
351450,5,Mixed,60,38,98
351480,8,Very Positive,241,16,257
351490,8,Very Positive,811,184,995
351630,5,Mixed,88,94,182
351710,8,Very Positive,1979,153,2132
351720,7,Positive,31,7,38
351730,5,Mixed,72,46,118
351800,6,Mostly Positive,1275,320,1595
351910,5,Mixed,378,342,720
351920,9,Overwhelmingly Positive,2053,67,2120
351940,8,Very Positive,1127,175,1302
351970,8,Very Positive,4844,834,5678
351990,8,Very Positive,1035,177,1212
352010,5,Mixed,192,89,281
352070,8,Very Positive,122,9,131
352210,7,Positive,15,3,18
352220,8,Very Positive,184,43,227
352240,5,Mixed,76,46,122
352370,6,Mostly Positive,31,11,42
352400,8,Very Positive,2053,339,2392
352430,5,Mixed,103,56,159
352440,0,9 user reviews,8,1,9
352460,5,Mixed,2733,1411,4144
352520,8,Very Positive,4018,253,4271
352550,4,Mostly Negative,695,1337,2032
352580,6,Mostly Positive,44,17,61
352610,8,Very Positive,97,9,106
352620,8,Very Positive,78,14,92
352740,5,Mixed,11,5,16
352760,6,Mostly Positive,17,6,23
352780,8,Very Positive,176,23,199
352790,6,Mostly Positive,12,5,17
352850,5,Mixed,16,16,32
352890,6,Mostly Positive,192,61,253
352900,5,Mixed,22,21,43
352960,5,Mixed,68,47,115
353090,8,Very Positive,350,10,360
353130,5,Mixed,990,506,1496
353190,5,Mixed,151,84,235
353260,0,1 user reviews,1,0,1
353270,9,Overwhelmingly Positive,2198,88,2286
353330,9,Overwhelmingly Positive,705,37,742
353340,6,Mostly Positive,19,5,24
353550,5,Mixed,340,164,504
353580,8,Very Positive,118,17,135
353630,5,Mixed,72,67,139
353640,8,Very Positive,1293,153,1446
353700,8,Very Positive,821,100,921
353890,6,Mostly Positive,54,14,68
353940,6,Mostly Positive,40,15,55
354030,5,Mixed,25,11,36
354040,7,Positive,22,3,25
354050,5,Mixed,12,9,21
354160,5,Mixed,225,200,425
354180,5,Mixed,38,21,59
354200,5,Mixed,629,412,1041
354230,6,Mostly Positive,23,7,30
354240,8,Very Positive,2041,338,2379
354280,7,Positive,14,2,16
354400,8,Very Positive,205,8,213
354650,8,Very Positive,510,93,603
354740,8,Very Positive,75,5,80
354770,7,Positive,18,2,20
354810,0,6 user reviews,2,4,6
354860,6,Mostly Positive,266,82,348
354930,5,Mixed,10,7,17
354950,6,Mostly Positive,45,14,59
354970,5,Mixed,48,28,76
355010,6,Mostly Positive,50,19,69
355050,8,Very Positive,824,76,900
355060,5,Mixed,237,221,458
355080,4,Mostly Negative,6,10,16
355090,0,5 user reviews,4,1,5
355100,5,Mixed,30,25,55
355130,6,Mostly Positive,274,89,363
355180,8,Very Positive,9177,1994,11171
355240,6,Mostly Positive,144,43,187
355270,8,Very Positive,167,36,203
355280,7,Positive,37,8,45
355310,5,Mixed,27,14,41
355370,7,Positive,27,3,30
355410,8,Very Positive,110,22,132
355510,5,Mixed,11,16,27
355520,6,Mostly Positive,230,70,300
355530,8,Very Positive,242,45,287
355630,8,Very Positive,185,15,200
355690,7,Positive,14,2,16
355790,8,Very Positive,1081,264,1345
355800,5,Mixed,439,246,685
355820,0,No user reviews,0,0,0
355840,5,Mixed,8320,7995,16315
355860,6,Mostly Positive,221,72,293
355910,7,Positive,17,3,20
355920,8,Very Positive,187,23,210
355970,6,Mostly Positive,307,95,402
355980,9,Overwhelmingly Positive,755,20,775
356000,6,Mostly Positive,76,22,98
356050,5,Mixed,575,276,851
356070,8,Very Positive,890,118,1008
356090,7,Positive,25,1,26
356100,7,Positive,40,5,45
356110,7,Positive,12,1,13
356130,5,Mixed,307,296,603
356170,7,Positive,11,2,13
356190,6,Mostly Positive,13464,3940,17404
356200,6,Mostly Positive,186,55,241
356310,5,Mixed,654,668,1322
356400,8,Very Positive,1481,114,1595
356420,8,Very Positive,240,38,278
356450,8,Very Positive,50,9,59
356460,7,Positive,23,5,28
356510,8,Very Positive,557,105,662
356520,8,Very Positive,848,98,946
356530,8,Very Positive,131,15,146
356540,6,Mostly Positive,19,8,27
356550,6,Mostly Positive,16,5,21
356560,7,Positive,19,4,23
356570,8,Very Positive,4056,566,4622
356790,8,Very Positive,52,7,59
356800,5,Mixed,9,10,19
356870,0,5 user reviews,1,4,5
356890,6,Mostly Positive,102,36,138
356910,5,Mixed,59,27,86
357010,7,Positive,29,6,35
357030,6,Mostly Positive,16,6,22
357070,8,Very Positive,1525,158,1683
357120,6,Mostly Positive,123,34,157
357190,8,Very Positive,1170,172,1342
357200,4,Mostly Negative,16,37,53
357280,5,Mixed,314,143,457
357300,8,Very Positive,557,40,597
357310,6,Mostly Positive,978,259,1237
357320,5,Mixed,26,18,44
357340,8,Very Positive,488,47,535
357480,5,Mixed,1024,741,1765
357490,7,Positive,14,2,16
357600,8,Very Positive,243,12,255
357650,6,Mostly Positive,167,60,227
357670,6,Mostly Positive,115,49,164
357690,6,Mostly Positive,24,9,33
357720,8,Very Positive,303,34,337
357750,7,Positive,17,2,19
357770,4,Mostly Negative,267,950,1217
357780,8,Very Positive,689,157,846
357830,5,Mixed,24,13,37
357840,5,Mixed,27,16,43
357890,8,Very Positive,48,4,52
357900,5,Mixed,499,601,1100
358030,7,Positive,25,1,26
358070,8,Very Positive,92,6,98
358080,5,Mixed,107,78,185
358090,8,Very Positive,1198,259,1457
358130,8,Very Positive,1404,158,1562
358460,6,Mostly Positive,157,62,219
358650,8,Very Positive,148,22,170
358750,8,Very Positive,471,83,554
358760,7,Positive,14,3,17
358810,8,Very Positive,84,15,99
358830,8,Very Positive,168,23,191
358960,8,Very Positive,154,26,180
359050,9,Overwhelmingly Positive,7202,365,7567
359060,4,Mostly Negative,28,46,74
359100,8,Very Positive,235,32,267
359140,8,Very Positive,339,15,354
359190,5,Mixed,122,69,191
359230,6,Mostly Positive,506,206,712
359250,5,Mixed,42,19,61
359260,5,Mixed,13,9,22
359280,5,Mixed,45,20,65
359300,0,8 user reviews,2,6,8
359310,8,Very Positive,2510,366,2876
359340,7,Positive,10,2,12
359350,8,Very Positive,246,53,299
359390,8,Very Positive,1537,92,1629
359400,8,Very Positive,217,10,227
359420,7,Positive,19,1,20
359450,5,Mixed,12,7,19
359560,6,Mostly Positive,127,35,162
359580,5,Mixed,244,148,392
359670,5,Mixed,9,5,14
359810,5,Mixed,221,97,318
359840,8,Very Positive,178,14,192
359870,8,Very Positive,5453,506,5959
359900,5,Mixed,357,262,619
359920,8,Very Positive,169,34,203
359940,6,Mostly Positive,116,49,165
359960,5,Mixed,122,58,180
360010,8,Very Positive,55,10,65
360030,5,Mixed,16,7,23
360150,5,Mixed,564,462,1026
360170,6,Mostly Positive,5136,2120,7256
360380,5,Mixed,525,261,786
360390,5,Mixed,47,35,82
360430,5,Mixed,11148,11890,23038
360450,8,Very Positive,122,29,151
360530,7,Positive,14,0,14
360550,8,Very Positive,128,17,145
360580,5,Mixed,18,20,38
360590,2,Very Negative,14,96,110
360640,8,Very Positive,1513,153,1666
360650,8,Very Positive,646,97,743
360680,0,8 user reviews,7,1,8
360730,6,Mostly Positive,417,175,592
360740,9,Overwhelmingly Positive,3763,115,3878
360750,5,Mixed,17,16,33
360830,6,Mostly Positive,1928,532,2460
360840,8,Very Positive,90,10,100
360850,7,Positive,32,3,35
360870,8,Very Positive,964,190,1154
360880,5,Mixed,19,23,42
360940,6,Mostly Positive,1946,665,2611
360970,5,Mixed,151,67,218
360990,0,6 user reviews,5,1,6
361040,8,Very Positive,214,11,225
361110,0,4 user reviews,3,1,4
361130,5,Mixed,28,18,46
361160,7,Positive,9,2,11
361190,5,Mixed,252,149,401
361200,5,Mixed,43,37,80
361230,8,Very Positive,58,1,59
361280,8,Very Positive,2637,291,2928
361300,8,Very Positive,2149,352,2501
361350,8,Very Positive,57,7,64
361360,8,Very Positive,90,12,102
361370,3,Negative,1,10,11
361430,5,Mixed,18,14,32
361550,6,Mostly Positive,830,312,1142
361560,4,Mostly Negative,9,31,40
361630,8,Very Positive,1057,193,1250
361950,7,Positive,25,6,31
361990,8,Very Positive,716,64,780
362020,7,Positive,14,0,14
362090,8,Very Positive,180,23,203
362290,8,Very Positive,42,8,50
362310,7,Positive,31,6,37
362370,0,8 user reviews,5,3,8
362380,7,Positive,17,2,19
362410,5,Mixed,102,50,152
362610,5,Mixed,104,118,222
362660,5,Mixed,77,40,117
362680,9,Overwhelmingly Positive,3905,148,4053
362810,8,Very Positive,203,39,242
362830,4,Mostly Negative,19,32,51
362860,8,Very Positive,68,14,82
362890,8,Very Positive,10666,604,11270
362940,7,Positive,24,0,24
362960,8,Very Positive,5133,802,5935
363130,5,Mixed,686,344,1030
363180,6,Mostly Positive,18,7,25
363240,6,Mostly Positive,44,16,60
363270,5,Mixed,35,22,57
363330,8,Very Positive,359,47,406
363410,6,Mostly Positive,149,47,196
363420,8,Very Positive,279,25,304
363430,5,Mixed,21,31,52
363440,8,Very Positive,1157,275,1432
363460,8,Very Positive,312,54,366
363500,7,Positive,25,3,28
363510,5,Mixed,38,41,79
363520,6,Mostly Positive,164,69,233
363530,4,Mostly Negative,62,184,246
363580,7,Positive,15,3,18
363600,6,Mostly Positive,903,309,1212
363620,5,Mixed,419,185,604
363650,5,Mixed,23,22,45
363680,5,Mixed,2763,1239,4002
363790,6,Mostly Positive,365,99,464
363900,0,9 user reviews,5,4,9
363930,8,Very Positive,2383,487,2870
363940,5,Mixed,31,34,65
363950,8,Very Positive,124,8,132
363960,4,Mostly Negative,25,42,67
363970,8,Very Positive,38021,4128,42149
363980,8,Very Positive,203,34,237
364000,0,8 user reviews,5,3,8
364050,6,Mostly Positive,870,222,1092
364060,6,Mostly Positive,21,9,30
364100,6,Mostly Positive,15,6,21
364130,5,Mixed,12,7,19
364200,7,Positive,43,5,48
364230,8,Very Positive,192,6,198
364250,7,Positive,26,4,30
364260,0,6 user reviews,5,1,6
364300,5,Mixed,209,95,304
364350,5,Mixed,22,16,38
364360,6,Mostly Positive,27628,8776,36404
364390,8,Very Positive,428,30,458
364630,6,Mostly Positive,104,33,137
364640,5,Mixed,196,88,284
364690,4,Mostly Negative,384,630,1014
364700,0,9 user reviews,8,1,9
364720,7,Positive,10,1,11
364740,7,Positive,11,1,12
364770,7,Positive,36,8,44
364790,6,Mostly Positive,11,3,14
364830,8,Very Positive,50,3,53
364840,7,Positive,23,3,26
364850,0,8 user reviews,7,1,8
364900,4,Mostly Negative,6,21,27
364910,5,Mixed,61,66,127
364930,8,Very Positive,654,47,701
365020,5,Mixed,279,151,430
365060,7,Positive,12,3,15
365070,5,Mixed,450,331,781
365090,7,Positive,22,2,24
365120,6,Mostly Positive,52,18,70
365150,5,Mixed,16,18,34
365160,8,Very Positive,972,154,1126
365190,8,Very Positive,164,28,192
365200,4,Mostly Negative,5,10,15
365210,8,Very Positive,65,7,72
365260,8,Very Positive,56,11,67
365280,5,Mixed,26,23,49
365300,8,Very Positive,6727,416,7143
365310,5,Mixed,28,33,61
365320,5,Mixed,71,32,103
365330,5,Mixed,33,23,56
365340,5,Mixed,13,14,27
365350,8,Very Positive,81,12,93
365360,8,Very Positive,3877,481,4358
365400,0,6 user reviews,0,6,6
365440,5,Mixed,21,10,31
365450,8,Very Positive,9070,617,9687
365460,0,9 user reviews,1,8,9
365480,5,Mixed,40,23,63
365500,7,Positive,28,4,32
365510,0,7 user reviews,7,0,7
365560,5,Mixed,66,34,100
365680,5,Mixed,43,21,64
365750,4,Mostly Negative,9,19,28
365760,6,Mostly Positive,37,14,51
365770,6,Mostly Positive,410,112,522
365800,5,Mixed,47,28,75
365810,6,Mostly Positive,454,174,628
365860,8,Very Positive,41,10,51
365870,8,Very Positive,74,7,81
365880,6,Mostly Positive,68,25,93
365900,8,Very Positive,162,17,179
365960,8,Very Positive,763,158,921
366000,8,Very Positive,132,20,152
366040,8,Very Positive,132,21,153
366050,0,4 user reviews,3,1,4
366090,8,Very Positive,1358,220,1578
366180,5,Mixed,43,20,63
366210,7,Positive,38,7,45
366230,6,Mostly Positive,28,10,38
366240,6,Mostly Positive,87,25,112
366250,8,Very Positive,966,100,1066
366260,8,Very Positive,158,25,183
366270,7,Positive,42,7,49
366280,6,Mostly Positive,72,19,91
366320,8,Very Positive,1062,209,1271
366350,5,Mixed,11,14,25
366380,7,Positive,15,0,15
366440,5,Mixed,762,571,1333
366510,6,Mostly Positive,59,23,82
366590,7,Positive,25,1,26
366600,5,Mixed,4,6,10
366620,7,Positive,31,5,36
366640,6,Mostly Positive,138,52,190
366690,6,Mostly Positive,61,18,79
366760,6,Mostly Positive,465,164,629
366780,7,Positive,25,1,26
366860,5,Mixed,22,11,33
366870,8,Very Positive,284,66,350
366910,5,Mixed,729,337,1066
366920,7,Positive,22,0,22
366970,8,Very Positive,188,13,201
367000,8,Very Positive,314,42,356
367030,5,Mixed,34,15,49
367050,7,Positive,10,1,11
367080,8,Very Positive,127,22,149
367110,6,Mostly Positive,75,23,98
367120,8,Very Positive,1483,237,1720
367140,7,Positive,38,3,41
367240,5,Mixed,20,29,49
367260,7,Positive,24,6,30
367300,8,Very Positive,93,13,106
367350,8,Very Positive,45,9,54
367430,7,Positive,40,3,43
367450,8,Very Positive,2802,325,3127
367500,8,Very Positive,10682,1263,11945
367520,9,Overwhelmingly Positive,21467,959,22426
367570,8,Very Positive,709,62,771
367580,9,Overwhelmingly Positive,5799,166,5965
367700,4,Mostly Negative,13,52,65
367710,5,Mixed,42,38,80
367780,5,Mixed,55,36,91
367800,6,Mostly Positive,7,3,10
367990,4,Mostly Negative,4,15,19
368000,6,Mostly Positive,41,12,53
368050,6,Mostly Positive,76,23,99
368070,5,Mixed,2354,1915,4269
368080,6,Mostly Positive,138,58,196
368140,7,Positive,40,9,49
368180,8,Very Positive,129,23,152
368230,8,Very Positive,7672,1006,8678
368250,7,Positive,23,5,28
368290,5,Mixed,40,21,61
368310,7,Positive,9,2,11
368360,6,Mostly Positive,3870,1111,4981
368370,8,Very Positive,4432,482,4914
368390,8,Very Positive,412,16,428
368430,6,Mostly Positive,337,105,442
368450,5,Mixed,107,73,180
368570,8,Very Positive,231,13,244
368590,5,Mixed,325,160,485
368610,8,Very Positive,213,17,230
368640,8,Very Positive,196,41,237
368650,8,Very Positive,500,41,541
368680,8,Very Positive,68,2,70
368690,5,Mixed,7,7,14
368700,7,Positive,15,3,18
368710,6,Mostly Positive,46,19,65
368720,5,Mixed,99,71,170
368730,6,Mostly Positive,1323,337,1660
368740,6,Mostly Positive,144,54,198
368760,5,Mixed,14,13,27
368770,5,Mixed,19,16,35
368780,5,Mixed,21,19,40
368800,8,Very Positive,111,17,128
368830,8,Very Positive,68,12,80
368890,8,Very Positive,81,5,86
368950,8,Very Positive,1442,97,1539
368970,5,Mixed,17,8,25
368980,5,Mixed,43,37,80
369000,5,Mixed,296,128,424
369030,5,Mixed,136,91,227
369060,4,Mostly Negative,11,22,33
369070,6,Mostly Positive,830,334,1164
369180,5,Mixed,39,44,83
369230,5,Mixed,21,16,37
369290,8,Very Positive,167,38,205
369310,7,Positive,17,1,18
369360,4,Mostly Negative,11,24,35
369400,6,Mostly Positive,707,206,913
369420,8,Very Positive,397,29,426
369440,0,No user reviews,0,0,0
369530,8,Very Positive,156,14,170
369550,8,Very Positive,138,23,161
369560,8,Very Positive,91,16,107
369570,6,Mostly Positive,29,10,39
369580,8,Very Positive,2287,323,2610
369700,7,Positive,21,0,21
369840,0,No user reviews,0,0,0
369860,0,9 user reviews,6,3,9
369890,6,Mostly Positive,112,42,154
369990,8,Very Positive,2463,375,2838
370020,9,Overwhelmingly Positive,608,30,638
370050,7,Positive,35,2,37
370060,8,Very Positive,185,33,218
370070,8,Very Positive,124,28,152
370080,7,Positive,42,5,47
370090,5,Mixed,239,105,344
370120,0,4 user reviews,3,1,4
370130,5,Mixed,19,16,35
370140,0,5 user reviews,3,2,5
370150,8,Very Positive,85,3,88
370170,5,Mixed,14,9,23
370220,5,Mixed,18,27,45
370240,5,Mixed,3504,3436,6940
370280,8,Very Positive,1223,71,1294
370300,8,Very Positive,56,11,67
370360,9,Overwhelmingly Positive,2216,76,2292
370440,5,Mixed,123,68,191
370460,8,Very Positive,232,33,265
370480,8,Very Positive,92,8,100
370550,8,Very Positive,71,8,79
370590,5,Mixed,33,21,54
370600,5,Mixed,24,27,51
370640,5,Mixed,21,12,33
370670,8,Very Positive,88,2,90
370770,8,Very Positive,605,135,740
370840,5,Mixed,40,29,69
370910,8,Very Positive,968,61,1029
370920,8,Very Positive,78,13,91
370940,7,Positive,45,4,49
371000,5,Mixed,21,21,42
371010,5,Mixed,94,46,140
371100,8,Very Positive,128,22,150
371120,5,Mixed,51,33,84
371140,8,Very Positive,67,11,78
371180,8,Very Positive,423,47,470
371200,8,Very Positive,1012,189,1201
371220,5,Mixed,49,43,92
371280,5,Mixed,12,9,21
371300,8,Very Positive,109,26,135
371320,7,Positive,20,1,21
371330,6,Mostly Positive,227,80,307
371380,0,8 user reviews,8,0,8
371410,5,Mixed,8,11,19
371420,6,Mostly Positive,534,160,694
371450,6,Mostly Positive,143,42,185
371460,6,Mostly Positive,61,26,87
371500,8,Very Positive,345,38,383
371520,6,Mostly Positive,454,164,618
371530,7,Positive,18,1,19
371550,6,Mostly Positive,126,32,158
371570,6,Mostly Positive,770,252,1022
371620,0,3 user reviews,2,1,3
371650,0,No user reviews,0,0,0
371790,0,9 user reviews,5,4,9
371880,6,Mostly Positive,42,11,53
371890,6,Mostly Positive,81,28,109
371900,5,Mixed,27,13,40
371970,8,Very Positive,923,112,1035
372080,7,Positive,29,4,33
372150,4,Mostly Negative,8,25,33
372160,5,Mixed,10,13,23
372250,7,Positive,24,5,29
372330,5,Mixed,37,21,58
372350,8,Very Positive,78,10,88
372360,8,Very Positive,1629,372,2001
372380,6,Mostly Positive,44,17,61
372430,4,Mostly Negative,5,10,15
372490,5,Mixed,64,38,102
372540,5,Mixed,1021,478,1499
372690,8,Very Positive,149,31,180
372740,4,Mostly Negative,14,32,46
372750,5,Mixed,58,86,144
372780,5,Mixed,27,20,47
372800,6,Mostly Positive,1530,396,1926
372820,5,Mixed,69,76,145
372830,8,Very Positive,81,18,99
372930,8,Very Positive,117,13,130
372940,8,Very Positive,155,5,160
372950,0,7 user reviews,6,1,7
372960,7,Positive,19,1,20
372970,7,Positive,30,7,37
373290,5,Mixed,38,33,71
373360,5,Mixed,86,47,133
373390,9,Overwhelmingly Positive,1454,49,1503
373420,8,Very Positive,8398,866,9264
373480,5,Mixed,92,55,147
373600,7,Positive,39,4,43
373610,8,Very Positive,60,13,73
373620,7,Positive,32,7,39
373630,7,Positive,23,5,28
373650,6,Mostly Positive,72,26,98
373720,5,Mixed,175,100,275
373770,9,Overwhelmingly Positive,2083,74,2157
373880,4,Mostly Negative,9,17,26
373920,5,Mixed,121,97,218
373930,6,Mostly Positive,1856,703,2559
373970,8,Very Positive,242,23,265
373990,6,Mostly Positive,120,47,167
374030,5,Mixed,1091,530,1621
374040,8,Very Positive,9296,1936,11232
374050,5,Mixed,35,26,61
374060,6,Mostly Positive,136,44,180
374150,7,Positive,17,2,19
374170,5,Mixed,15,12,27
374280,5,Mixed,1065,828,1893
374320,8,Very Positive,74255,6992,81247
374410,8,Very Positive,209,11,220
374520,5,Mixed,60,63,123
374620,0,9 user reviews,5,4,9
374630,0,4 user reviews,4,0,4
374640,4,Mostly Negative,24,45,69
374670,8,Very Positive,790,142,932
374680,5,Mixed,8,4,12
374830,6,Mostly Positive,199,50,249
374900,6,Mostly Positive,549,147,696
374940,0,4 user reviews,3,1,4
374950,5,Mixed,37,46,83
374960,0,2 user reviews,1,1,2
374990,5,Mixed,5,5,10
375000,5,Mixed,7,4,11
375010,5,Mixed,140,63,203
375030,6,Mostly Positive,147,37,184
375040,5,Mixed,24,17,41
375120,8,Very Positive,159,30,189
375130,8,Very Positive,209,9,218
375170,6,Mostly Positive,26,7,33
375210,8,Very Positive,46,5,51
375230,5,Mixed,4851,5089,9940
375290,6,Mostly Positive,18,6,24
375320,5,Mixed,40,28,68
375330,5,Mixed,27,27,54
375340,0,No user reviews,0,0,0
375420,5,Mixed,18,9,27
375430,5,Mixed,6,4,10
375440,0,No user reviews,0,0,0
375450,5,Mixed,276,229,505
375460,4,Mostly Negative,500,762,1262
375480,9,Overwhelmingly Positive,984,43,1027
375520,6,Mostly Positive,106,27,133
375530,8,Very Positive,1370,131,1501
375580,6,Mostly Positive,34,13,47
375600,6,Mostly Positive,617,233,850
375680,4,Mostly Negative,86,198,284
375710,5,Mixed,219,124,343
375750,8,Very Positive,205,15,220
375770,5,Mixed,25,11,36
375790,5,Mixed,13,8,21
375810,0,No user reviews,0,0,0
375820,8,Very Positive,1842,119,1961
375840,8,Very Positive,174,27,201
375850,5,Mixed,40,39,79
375910,5,Mixed,1752,1067,2819
375950,8,Very Positive,4856,494,5350
376150,4,Mostly Negative,13,30,43
376250,6,Mostly Positive,32,10,42
376300,8,Very Positive,1761,134,1895
376310,4,Mostly Negative,187,336,523
376350,0,6 user reviews,3,3,6
376450,5,Mixed,32,15,47
376490,0,9 user reviews,6,3,9
376520,8,Very Positive,260,32,292
376560,8,Very Positive,77,14,91
376570,6,Mostly Positive,2824,1158,3982
376680,6,Mostly Positive,70,29,99
376870,6,Mostly Positive,5121,1664,6785
376880,6,Mostly Positive,43,16,59
377060,6,Mostly Positive,162,61,223
377070,7,Positive,21,3,24
377080,8,Very Positive,260,20,280
377100,0,6 user reviews,6,0,6
377140,5,Mixed,334,244,578
377160,6,Mostly Positive,92044,38135,130179
377190,7,Positive,31,7,38
377200,7,Positive,11,1,12
377250,7,Positive,16,1,17
377260,5,Mixed,145,70,215
377280,6,Mostly Positive,17,5,22
377300,0,No user reviews,0,0,0
377310,5,Mixed,143,105,248
377320,7,Positive,13,3,16
377330,8,Very Positive,566,74,640
377450,8,Very Positive,68,2,70
377460,8,Very Positive,88,7,95
377470,5,Mixed,75,44,119
377480,5,Mixed,82,39,121
377550,6,Mostly Positive,18,5,23
377690,8,Very Positive,134,8,142
377840,8,Very Positive,3430,261,3691
377860,9,Overwhelmingly Positive,699,21,720
377870,8,Very Positive,338,56,394
377880,8,Very Positive,132,21,153
377890,0,7 user reviews,5,2,7
377900,6,Mostly Positive,459,148,607
377970,5,Mixed,137,59,196
377980,5,Mixed,34,30,64
378030,7,Positive,39,5,44
378070,6,Mostly Positive,37,11,48
378080,8,Very Positive,56,12,68
378100,5,Mixed,228,268,496
378240,0,3 user reviews,3,0,3
378260,6,Mostly Positive,61,19,80
378270,5,Mixed,222,109,331
378280,5,Mixed,19,20,39
378350,7,Positive,11,2,13
378370,5,Mixed,1712,1120,2832
378410,7,Positive,16,0,16
378450,0,4 user reviews,1,3,4
378540,6,Mostly Positive,2236,703,2939
378630,6,Mostly Positive,41,13,54
378660,5,Mixed,792,419,1211
378700,5,Mixed,21,10,31
378720,8,Very Positive,2237,204,2441
378750,8,Very Positive,91,5,96
378770,8,Very Positive,70,4,74
378800,5,Mixed,192,104,296
378810,7,Positive,32,8,40
378830,5,Mixed,25,14,39
378850,8,Very Positive,56,10,66
378860,6,Mostly Positive,2828,1102,3930
378930,5,Mixed,69,32,101
379290,5,Mixed,58,60,118
379320,6,Mostly Positive,66,18,84
379340,5,Mixed,5,5,10
379350,5,Mixed,7,4,11
379370,5,Mixed,12,13,25
379380,0,7 user reviews,3,4,7
379390,7,Positive,11,2,13
379420,8,Very Positive,94,13,107
379430,6,Mostly Positive,19839,5990,25829
379520,7,Positive,27,4,31
379530,8,Very Positive,84,21,105
379610,7,Positive,36,4,40
379640,8,Very Positive,197,18,215
379720,8,Very Positive,55864,4112,59976
379760,7,Positive,42,6,48
379990,4,Mostly Negative,12,31,43
380020,5,Mixed,509,220,729
380100,7,Positive,12,1,13
380120,0,8 user reviews,6,2,8
380150,8,Very Positive,830,179,1009
380210,5,Mixed,12,9,21
380220,5,Mixed,482,222,704
380360,6,Mostly Positive,578,202,780
380540,5,Mixed,23,17,40
380550,5,Mixed,46,27,73
380560,5,Mixed,14,8,22
380660,8,Very Positive,56,7,63
380670,8,Very Positive,303,15,318
380690,5,Mixed,12,11,23
380700,5,Mixed,23,16,39
380750,6,Mostly Positive,286,112,398
380790,4,Mostly Negative,4,7,11
380810,8,Very Positive,75,1,76
380860,7,Positive,20,5,25
380920,7,Positive,37,6,43
380990,5,Mixed,17,16,33
381020,8,Very Positive,547,41,588
381050,6,Mostly Positive,42,17,59
381090,5,Mixed,26,21,47
381100,8,Very Positive,194,37,231
381120,5,Mixed,1379,839,2218
381130,4,Mostly Negative,10,29,39
381140,5,Mixed,164,73,237
381170,5,Mixed,29,28,57
381210,6,Mostly Positive,95679,28932,124611
381220,5,Mixed,35,28,63
381250,0,8 user reviews,8,0,8
381260,5,Mixed,101,45,146
381320,8,Very Positive,53,13,66
381340,7,Positive,18,1,19
381560,5,Mixed,327,333,660
381610,7,Positive,29,7,36
381750,5,Mixed,110,60,170
381780,8,Very Positive,930,90,1020
381850,5,Mixed,20,11,31
381870,8,Very Positive,82,13,95
381880,8,Very Positive,64,7,71
381890,7,Positive,49,0,49
381900,8,Very Positive,72,16,88
381910,6,Mostly Positive,19,5,24
381990,6,Mostly Positive,522,219,741
382050,8,Very Positive,492,59,551
382070,6,Mostly Positive,54,18,72
382080,5,Mixed,116,112,228
382130,6,Mostly Positive,30,11,41
382140,6,Mostly Positive,768,261,1029
382160,4,Mostly Negative,19,52,71
382180,6,Mostly Positive,38,16,54
382260,8,Very Positive,237,18,255
382270,7,Positive,12,1,13
382300,5,Mixed,262,202,464
382360,5,Mixed,139,73,212
382420,5,Mixed,107,96,203
382490,8,Very Positive,4808,287,5095
382850,5,Mixed,763,902,1665
382890,6,Mostly Positive,420,156,576
382900,6,Mostly Positive,750,213,963
382920,8,Very Positive,53,11,64
383020,5,Mixed,7,6,13
383070,5,Mixed,16,20,36
383150,6,Mostly Positive,2372,948,3320
383180,5,Mixed,526,268,794
383230,6,Mostly Positive,1259,390,1649
383240,5,Mixed,11,14,25
383270,8,Very Positive,608,38,646
383330,5,Mixed,144,87,231
383460,8,Very Positive,211,23,234
383540,6,Mostly Positive,19,6,25
383630,6,Mostly Positive,31,12,43
383670,6,Mostly Positive,24,8,32
383690,8,Very Positive,117,18,135
383700,6,Mostly Positive,33,12,45
383710,4,Mostly Negative,16,26,42
383720,5,Mixed,43,20,63
383750,6,Mostly Positive,51,17,68
383790,5,Mixed,295,212,507
383870,8,Very Positive,28348,4871,33219
383930,8,Very Positive,297,54,351
383950,6,Mostly Positive,30,11,41
383970,7,Positive,34,5,39
383980,8,Very Positive,3705,434,4139
384000,6,Mostly Positive,218,72,290
384010,6,Mostly Positive,23,9,32
384080,5,Mixed,140,91,231
384100,7,Positive,30,7,37
384110,8,Very Positive,632,92,724
384120,5,Mixed,29,14,43
384180,6,Mostly Positive,1205,328,1533
384190,8,Very Positive,13482,1051,14533
384200,6,Mostly Positive,17,7,24
384210,5,Mixed,8,5,13
384230,7,Positive,11,0,11
384250,5,Mixed,83,52,135
384280,8,Very Positive,104,9,113
384300,6,Mostly Positive,5244,1782,7026
384310,6,Mostly Positive,241,70,311
384320,5,Mixed,35,33,68
384330,6,Mostly Positive,38,16,54
384360,6,Mostly Positive,512,162,674
384480,8,Very Positive,66,7,73
384490,5,Mixed,2179,1140,3319
384500,8,Very Positive,476,72,548
384590,7,Positive,20,1,21
384630,9,Overwhelmingly Positive,929,47,976
384660,0,8 user reviews,8,0,8
384680,8,Very Positive,354,28,382
384690,8,Very Positive,57,1,58
384700,6,Mostly Positive,19,5,24
384740,6,Mostly Positive,453,185,638
384750,5,Mixed,132,140,272
384890,7,Positive,18,3,21
384920,4,Mostly Negative,11,33,44
384940,6,Mostly Positive,19,5,24
384960,8,Very Positive,106,21,127
384990,6,Mostly Positive,62,16,78
385060,7,Positive,29,4,33
385070,6,Mostly Positive,170,67,237
385240,8,Very Positive,628,138,766
385250,8,Very Positive,323,5,328
385270,5,Mixed,765,350,1115
385360,5,Mixed,46,34,80
385370,8,Very Positive,1925,315,2240
385410,6,Mostly Positive,10,4,14
385440,6,Mostly Positive,34,10,44
385490,5,Mixed,59,52,111
385530,5,Mixed,103,52,155
385560,8,Very Positive,498,88,586
385580,0,9 user reviews,3,6,9
385590,6,Mostly Positive,121,35,156
385600,5,Mixed,18,25,43
385690,7,Positive,31,1,32
385710,8,Very Positive,1115,231,1346
385730,5,Mixed,1598,938,2536
385760,5,Mixed,4097,3570,7667
385770,8,Very Positive,3353,418,3771
385800,8,Very Positive,9810,633,10443
385830,5,Mixed,249,312,561
385860,5,Mixed,26,13,39
385890,5,Mixed,210,266,476
385950,4,Mostly Negative,7,13,20
385960,3,Negative,2,12,14
386070,8,Very Positive,4386,1050,5436
386080,8,Very Positive,129,30,159
386110,3,Negative,6,35,41
386140,5,Mixed,34,18,52
386160,6,Mostly Positive,51,19,70
386180,5,Mixed,7380,4013,11393
386200,7,Positive,18,3,21
386280,5,Mixed,105,93,198
386290,6,Mostly Positive,51,16,67
386330,3,Negative,2,14,16
386350,6,Mostly Positive,55,19,74
386360,8,Very Positive,28249,5976,34225
386390,0,4 user reviews,4,0,4
386400,6,Mostly Positive,57,18,75
386420,6,Mostly Positive,119,30,149
386430,0,No user reviews,0,0,0
386460,0,No user reviews,0,0,0
386480,6,Mostly Positive,830,299,1129
386490,5,Mixed,81,54,135
386510,5,Mixed,85,61,146
386520,8,Very Positive,131,17,148
386540,4,Mostly Negative,21,39,60
386560,8,Very Positive,96,10,106
386590,6,Mostly Positive,525,225,750
386620,8,Very Positive,1015,130,1145
386640,5,Mixed,112,91,203
386650,5,Mixed,68,54,122
386690,6,Mostly Positive,188,51,239
386700,6,Mostly Positive,104,42,146
386710,5,Mixed,10,11,21
386750,6,Mostly Positive,37,15,52
386770,6,Mostly Positive,72,22,94
386840,7,Positive,34,4,38
386870,5,Mixed,47,33,80
386900,8,Very Positive,101,7,108
386930,5,Mixed,40,48,88
386940,9,Overwhelmingly Positive,5401,284,5685
386990,6,Mostly Positive,137,49,186
387010,5,Mixed,91,41,132
387060,8,Very Positive,96,20,116
387070,2,Very Negative,17,81,98
387090,5,Mixed,17,13,30
387100,7,Positive,18,2,20
387240,8,Very Positive,75,10,85
387270,5,Mixed,10,5,15
387290,9,Overwhelmingly Positive,12030,454,12484
387340,8,Very Positive,2086,141,2227
387370,6,Mostly Positive,241,94,335
387400,3,Negative,3,15,18
387430,5,Mixed,20,9,29
387840,8,Very Positive,268,65,333
387850,6,Mostly Positive,46,14,60
387870,8,Very Positive,89,21,110
387930,5,Mixed,152,125,277
387970,5,Mixed,402,460,862
388010,0,7 user reviews,4,3,7
388050,5,Mixed,44,35,79
388060,5,Mixed,284,159,443
388080,8,Very Positive,897,188,1085
388120,5,Mixed,277,284,561
388210,9,Overwhelmingly Positive,2167,57,2224
388260,7,Positive,25,4,29
388320,6,Mostly Positive,533,160,693
388360,6,Mostly Positive,49,21,70
388370,6,Mostly Positive,97,39,136
388410,6,Mostly Positive,4015,1284,5299
388420,8,Very Positive,239,26,265
388430,6,Mostly Positive,50,16,66
388440,5,Mixed,15,16,31
388450,8,Very Positive,77,3,80
388490,5,Mixed,168,134,302
388500,4,Mostly Negative,5,17,22
388540,0,5 user reviews,4,1,5
388550,5,Mixed,13,9,22
388620,8,Very Positive,248,43,291
388720,7,Positive,39,9,48
388750,8,Very Positive,1755,152,1907
388800,8,Very Positive,629,102,731
388880,8,Very Positive,5274,365,5639
388900,6,Mostly Positive,78,24,102
388910,7,Positive,25,2,27
388960,5,Mixed,23,16,39
388970,8,Very Positive,91,17,108
389010,0,6 user reviews,4,2,6
389040,5,Mixed,866,602,1468
389050,6,Mostly Positive,115,30,145
389120,6,Mostly Positive,12,5,17
389140,8,Very Positive,308,11,319
389170,8,Very Positive,748,68,816
389190,6,Mostly Positive,52,19,71
389220,5,Mixed,114,49,163
389260,8,Very Positive,58,8,66
389310,5,Mixed,43,21,64
389330,0,3 user reviews,1,2,3
389400,6,Mostly Positive,83,21,104
389510,8,Very Positive,1148,101,1249
389650,8,Very Positive,119,6,125
389670,6,Mostly Positive,271,89,360
389730,8,Very Positive,10670,1748,12418
389740,4,Mostly Negative,7,25,32
389810,5,Mixed,39,42,81
389840,5,Mixed,35,27,62
389850,8,Very Positive,68,5,73
389860,6,Mostly Positive,54,20,74
389870,5,Mixed,156,69,225
390030,8,Very Positive,229,53,282
390040,6,Mostly Positive,177,67,244
390200,5,Mixed,97,53,150
390210,5,Mixed,44,21,65
390290,8,Very Positive,436,45,481
390310,5,Mixed,88,43,131
390330,6,Mostly Positive,43,12,55
390340,4,Mostly Negative,523,1440,1963
390460,5,Mixed,11,8,19
390520,8,Very Positive,865,109,974
390570,5,Mixed,53,61,114
390610,8,Very Positive,174,9,183
390620,7,Positive,26,2,28
390670,5,Mixed,2590,1116,3706
390680,7,Positive,39,1,40
390710,8,Very Positive,133,20,153
390720,8,Very Positive,225,11,236
390730,8,Very Positive,207,12,219
390870,5,Mixed,34,24,58
390890,8,Very Positive,106,7,113
390910,8,Very Positive,124,30,154
390920,7,Positive,35,5,40
390930,7,Positive,36,5,41
390970,5,Mixed,395,293,688
391040,8,Very Positive,3016,551,3567
391100,5,Mixed,9,6,15
391140,8,Very Positive,51,3,54
391170,8,Very Positive,254,32,286
391180,6,Mostly Positive,26,9,35
391190,0,3 user reviews,3,0,3
391210,7,Positive,18,4,22
391220,8,Very Positive,37915,2708,40623
391250,8,Very Positive,76,8,84
391260,6,Mostly Positive,700,253,953
391310,5,Mixed,103,47,150
391340,5,Mixed,36,50,86
391380,0,4 user reviews,3,1,4
391390,7,Positive,26,2,28
391480,0,No user reviews,0,0,0
391490,8,Very Positive,143,21,164
391540,9,Overwhelmingly Positive,80595,3296,83891
391550,5,Mixed,13,8,21
391600,6,Mostly Positive,84,33,117
391630,5,Mixed,18,14,32
391640,6,Mostly Positive,17,7,24
391650,7,Positive,13,1,14
391660,5,Mixed,65,30,95
391720,8,Very Positive,10917,1172,12089
391730,8,Very Positive,1376,204,1580
391820,5,Mixed,17,20,37
391910,0,4 user reviews,2,2,4
391960,6,Mostly Positive,14,4,18
392000,6,Mostly Positive,216,57,273
392020,8,Very Positive,141,10,151
392030,8,Very Positive,56,2,58
392070,8,Very Positive,105,19,124
392100,0,2 user reviews,2,0,2
392110,8,Very Positive,5945,1350,7295
392120,5,Mixed,11,12,23
392190,6,Mostly Positive,68,24,92
392260,6,Mostly Positive,132,34,166
392280,5,Mixed,127,62,189
392370,0,6 user reviews,5,1,6
392410,6,Mostly Positive,186,77,263
392450,8,Very Positive,445,60,505
392580,6,Mostly Positive,408,127,535
392600,7,Positive,24,1,25
392610,8,Very Positive,55,3,58
392620,7,Positive,13,3,16
392680,6,Mostly Positive,28,10,38
392720,7,Positive,11,1,12
392780,5,Mixed,16,7,23
392820,5,Mixed,125,128,253
392940,8,Very Positive,105,21,126
392950,8,Very Positive,3466,379,3845
392970,8,Very Positive,145,10,155
393080,5,Mixed,754,877,1631
393150,6,Mostly Positive,48,15,63
393170,7,Positive,23,0,23
393200,8,Very Positive,427,80,507
393220,7,Positive,30,1,31
393230,4,Mostly Negative,9,33,42
393240,5,Mixed,13,9,22
393380,8,Very Positive,18586,4180,22766
393430,8,Very Positive,702,126,828
393460,5,Mixed,35,24,59
393520,8,Very Positive,610,67,677
393530,5,Mixed,1283,636,1919
393600,6,Mostly Positive,14,6,20
393610,8,Very Positive,80,16,96
393750,5,Mixed,106,55,161
393790,6,Mostly Positive,68,20,88
393820,5,Mixed,21,30,51
393860,5,Mixed,16,8,24
393920,5,Mixed,84,75,159
393930,5,Mixed,251,139,390
393980,6,Mostly Positive,405,130,535
394030,7,Positive,17,0,17
394130,8,Very Positive,119,6,125
394140,8,Very Positive,67,14,81
394160,8,Very Positive,179,41,220
394220,8,Very Positive,94,20,114
394230,5,Mixed,5233,3224,8457
394260,6,Mostly Positive,28,10,38
394280,5,Mixed,108,76,184
394290,8,Very Positive,71,5,76
394310,6,Mostly Positive,5316,1464,6780
394360,8,Very Positive,19863,3491,23354
394390,7,Positive,16,2,18
394430,7,Positive,37,2,39
394450,5,Mixed,324,177,501
394490,4,Mostly Negative,12,30,42
394510,8,Very Positive,11171,970,12141
394540,6,Mostly Positive,306,82,388
394550,8,Very Positive,63,7,70
394600,6,Mostly Positive,126,45,171
394690,8,Very Positive,3715,601,4316
394700,8,Very Positive,243,43,286
394760,6,Mostly Positive,868,313,1181
394770,5,Mixed,14,21,35
394870,6,Mostly Positive,477,196,673
394950,7,Positive,16,0,16
394960,0,4 user reviews,3,1,4
394970,9,Overwhelmingly Positive,1845,88,1933
395100,7,Positive,11,2,13
395140,8,Very Positive,67,8,75
395160,6,Mostly Positive,299,127,426
395170,8,Very Positive,3946,258,4204
395190,0,7 user reviews,7,0,7
395200,6,Mostly Positive,899,258,1157
395300,0,3 user reviews,2,1,3
395350,5,Mixed,180,103,283
395400,5,Mixed,14,17,31
395420,6,Mostly Positive,82,30,112
395470,5,Mixed,25,12,37
395500,8,Very Positive,183,29,212
395520,8,Very Positive,2211,289,2500
395550,7,Positive,11,0,11
395570,6,Mostly Positive,387,158,545
395580,7,Positive,14,2,16
395620,8,Very Positive,106,17,123
395850,8,Very Positive,315,57,372
395860,8,Very Positive,137,27,164
395900,5,Mixed,57,33,90
395920,5,Mixed,18,10,28
395940,0,5 user reviews,2,3,5
396010,0,4 user reviews,3,1,4
396030,5,Mixed,141,66,207
396090,6,Mostly Positive,145,48,193
396160,5,Mixed,278,310,588
396230,8,Very Positive,135,26,161
396320,5,Mixed,15,10,25
396350,8,Very Positive,253,9,262
396480,8,Very Positive,450,98,548
396650,9,Overwhelmingly Positive,852,35,887
396660,8,Very Positive,74,18,92
396680,6,Mostly Positive,34,11,45
396700,7,Positive,20,1,21
396710,8,Very Positive,127,5,132
396750,8,Very Positive,3078,728,3806
396790,6,Mostly Positive,427,117,544
396800,8,Very Positive,269,37,306
396850,5,Mixed,26,39,65
396860,8,Very Positive,133,22,155
396930,6,Mostly Positive,13,5,18
397020,0,7 user reviews,2,5,7
397090,8,Very Positive,53,10,63
397150,6,Mostly Positive,371,107,478
397160,8,Very Positive,83,13,96
397200,4,Mostly Negative,9,14,23
397240,5,Mixed,7,4,11
397270,8,Very Positive,843,57,900
397310,8,Very Positive,248,57,305
397330,8,Very Positive,89,14,103
397340,8,Very Positive,3862,361,4223
397390,6,Mostly Positive,103,38,141
397400,7,Positive,15,1,16
397460,8,Very Positive,452,24,476
397500,6,Mostly Positive,363,107,470
397570,8,Very Positive,154,32,186
397580,4,Mostly Negative,31,73,104
397600,7,Positive,11,0,11
397690,8,Very Positive,273,59,332
397700,4,Mostly Negative,21,84,105
397730,5,Mixed,23,18,41
397780,8,Very Positive,87,16,103
397810,4,Mostly Negative,6,16,22
397820,5,Mixed,22,17,39
397850,7,Positive,10,1,11
397860,7,Positive,16,2,18
397900,5,Mixed,4414,2713,7127
397940,6,Mostly Positive,80,24,104
397950,8,Very Positive,3521,370,3891
397960,7,Positive,8,2,10
397970,6,Mostly Positive,16,5,21
397990,8,Very Positive,73,14,87
398020,5,Mixed,10,9,19
398030,0,No user reviews,0,0,0
398100,8,Very Positive,356,84,440
398110,5,Mixed,10,11,21
398120,5,Mixed,14,19,33
398140,6,Mostly Positive,27,11,38
398150,5,Mixed,24,18,42
398160,7,Positive,41,3,44
398170,8,Very Positive,200,45,245
398180,5,Mixed,136,62,198
398250,7,Positive,17,0,17
398260,0,3 user reviews,2,1,3
398450,8,Very Positive,182,44,226
398460,8,Very Positive,109,9,118
398480,5,Mixed,7,4,11
398530,5,Mixed,10,7,17
398670,5,Mixed,6,6,12
398680,5,Mixed,451,215,666
398710,8,Very Positive,4499,288,4787
398830,5,Mixed,7,5,12
398850,9,Overwhelmingly Positive,2761,120,2881
398890,7,Positive,16,4,20
398940,7,Positive,26,3,29
398960,6,Mostly Positive,17,6,23
398970,4,Mostly Negative,8,21,29
398980,8,Very Positive,154,17,171
399000,5,Mixed,26,15,41
399040,8,Very Positive,66,11,77
399070,8,Very Positive,280,42,322
399130,5,Mixed,63,72,135
399140,7,Positive,33,4,37
399240,0,7 user reviews,7,0,7
399270,5,Mixed,25,26,51
399530,7,Positive,10,2,12
399600,8,Very Positive,289,10,299
399640,8,Very Positive,354,21,375
399670,8,Very Positive,2028,287,2315
399790,5,Mixed,384,395,779
399820,8,Very Positive,1046,229,1275
399890,6,Mostly Positive,137,38,175
399910,7,Positive,40,3,43
399920,5,Mixed,22,14,36
400020,6,Mostly Positive,253,68,321
400030,5,Mixed,108,90,198
400130,5,Mixed,8,5,13
400160,8,Very Positive,284,28,312
400170,6,Mostly Positive,1010,377,1387
400180,8,Very Positive,487,112,599
400200,5,Mixed,52,24,76
400250,5,Mixed,1101,788,1889
400280,7,Positive,15,1,16
400350,6,Mostly Positive,13,4,17
400360,5,Mixed,74,35,109
400380,5,Mixed,9,11,20
400450,8,Very Positive,232,51,283
400510,5,Mixed,127,117,244
400580,8,Very Positive,141,9,150
400630,9,Overwhelmingly Positive,1142,44,1186
400660,8,Very Positive,325,34,359
400800,6,Mostly Positive,259,101,360
400880,4,Mostly Negative,6,18,24
400910,9,Overwhelmingly Positive,5359,110,5469
401120,8,Very Positive,52,8,60
401170,0,5 user reviews,4,1,5
401190,5,Mixed,1566,873,2439
401280,7,Positive,16,0,16
401290,7,Positive,42,3,45
401330,5,Mixed,32,17,49
401360,6,Mostly Positive,198,58,256
401510,7,Positive,14,1,15
401550,0,9 user reviews,9,0,9
401560,4,Mostly Negative,8,14,22
401680,8,Very Positive,894,93,987
401710,6,Mostly Positive,395,119,514
401810,8,Very Positive,468,43,511
401820,6,Mostly Positive,83,29,112
401840,8,Very Positive,62,14,76
401890,6,Mostly Positive,126,48,174
402020,6,Mostly Positive,1523,651,2174
402030,5,Mixed,40,18,58
402040,8,Very Positive,294,72,366
402060,6,Mostly Positive,125,49,174
402120,8,Very Positive,227,40,267
402130,5,Mixed,278,241,519
402150,6,Mostly Positive,36,12,48
402160,5,Mixed,152,126,278
402170,5,Mixed,26,31,57
402260,8,Very Positive,286,64,350
402300,5,Mixed,42,22,64
402310,8,Very Positive,314,56,370
402330,8,Very Positive,1646,142,1788
402340,8,Very Positive,67,8,75
402390,7,Positive,20,3,23
402430,8,Very Positive,556,47,603
402530,8,Very Positive,270,16,286
402560,5,Mixed,344,274,618
402570,8,Very Positive,3555,788,4343
402670,5,Mixed,11,15,26
402750,5,Mixed,164,72,236
402840,8,Very Positive,1591,304,1895
402880,6,Mostly Positive,285,77,362
402910,0,5 user reviews,1,4,5
402970,0,1 user reviews,1,0,1
403070,7,Positive,30,3,33
403120,6,Mostly Positive,155,62,217
403180,8,Very Positive,170,37,207
403190,6,Mostly Positive,3793,1101,4894
403200,4,Mostly Negative,19,44,63
403230,7,Positive,15,3,18
403270,7,Positive,21,0,21
403290,6,Mostly Positive,90,24,114
403300,0,8 user reviews,3,5,8
403400,6,Mostly Positive,126,36,162
403430,8,Very Positive,202,34,236
403460,0,7 user reviews,5,2,7
403510,6,Mostly Positive,143,37,180
403570,6,Mostly Positive,498,206,704
403590,4,Mostly Negative,57,95,152
403640,8,Very Positive,17614,4161,21775
403680,5,Mixed,6,8,14
403700,8,Very Positive,190,30,220
403780,7,Positive,31,1,32
403830,8,Very Positive,228,13,241
403880,5,Mixed,44,37,81
403940,8,Very Positive,313,64,377
403970,6,Mostly Positive,683,197,880
404030,7,Positive,19,1,20
404050,5,Mixed,95,42,137
404100,7,Positive,29,6,35
404180,8,Very Positive,77,18,95
404200,8,Very Positive,296,65,361
404510,8,Very Positive,52,10,62
404530,8,Very Positive,204,28,232
404540,8,Very Positive,973,126,1099
404580,5,Mixed,80,36,116
404590,5,Mixed,1279,991,2270
404620,6,Mostly Positive,456,140,596
404640,5,Mixed,115,103,218
404660,5,Mixed,19,9,28
404680,8,Very Positive,1864,221,2085
404700,8,Very Positive,104,19,123
404770,5,Mixed,191,112,303
404820,8,Very Positive,129,13,142
404860,7,Positive,17,4,21
404960,7,Positive,17,2,19
405000,8,Very Positive,96,12,108
405010,8,Very Positive,461,65,526
405190,4,Mostly Negative,4,10,14
405240,5,Mixed,13,8,21
405290,8,Very Positive,215,13,228
405310,8,Very Positive,1447,293,1740
405340,5,Mixed,23,14,37
405440,5,Mixed,6,7,13
405500,5,Mixed,228,276,504
405530,7,Positive,29,2,31
405540,7,Positive,37,9,46
405550,7,Positive,36,5,41
405610,5,Mixed,160,128,288
405640,9,Overwhelmingly Positive,8094,348,8442
405650,8,Very Positive,154,38,192
405680,0,No user reviews,0,0,0
405710,6,Mostly Positive,805,248,1053
405720,6,Mostly Positive,62,20,82
405760,6,Mostly Positive,41,17,58
405780,6,Mostly Positive,101,38,139
405810,0,6 user reviews,2,4,6
405820,9,Overwhelmingly Positive,1387,60,1447
405830,9,Overwhelmingly Positive,817,39,856
405900,8,Very Positive,1900,248,2148
405950,8,Very Positive,361,23,384
405960,5,Mixed,21,19,40
405970,8,Very Positive,124,26,150
406120,5,Mixed,9,6,15
406150,9,Overwhelmingly Positive,9772,472,10244
406170,5,Mixed,191,128,319
406220,8,Very Positive,46,9,55
406290,8,Very Positive,677,101,778
406310,5,Mixed,101,57,158
406350,0,No user reviews,0,0,0
406550,8,Very Positive,236,5,241
406650,6,Mostly Positive,39,11,50
406690,0,4 user reviews,4,0,4
406720,5,Mixed,145,88,233
406730,5,Mixed,35,28,63
406850,8,Very Positive,210,39,249
406870,8,Very Positive,368,17,385
406920,7,Positive,24,1,25
406940,6,Mostly Positive,132,50,182
406970,8,Very Positive,745,165,910
407000,4,Mostly Negative,12,27,39
407020,8,Very Positive,133,32,165
407100,7,Positive,20,0,20
407110,7,Positive,21,3,24
407230,6,Mostly Positive,381,155,536
407290,6,Mostly Positive,83,28,111
407300,6,Mostly Positive,393,101,494
407310,9,Overwhelmingly Positive,509,13,522
407330,8,Very Positive,814,67,881
407340,8,Very Positive,73,4,77
407380,7,Positive,35,1,36
407420,5,Mixed,227,264,491
407530,5,Mixed,4175,2828,7003
407560,6,Mostly Positive,564,236,800
407570,0,No user reviews,0,0,0
407600,5,Mixed,29,28,57
407620,5,Mixed,73,81,154
407630,7,Positive,11,0,11
407680,5,Mixed,58,34,92
407780,8,Very Positive,173,22,195
407810,8,Very Positive,566,114,680
407830,4,Mostly Negative,5,9,14
407840,5,Mixed,1868,1468,3336
407880,8,Very Positive,87,5,92
407940,8,Very Positive,69,2,71
408000,8,Very Positive,221,52,273
408110,8,Very Positive,91,19,110
408170,7,Positive,21,1,22
408240,0,9 user reviews,9,0,9
408250,5,Mixed,116,52,168
408280,8,Very Positive,597,94,691
408400,8,Very Positive,49,11,60
408410,8,Very Positive,555,35,590
408520,8,Very Positive,421,35,456
408640,5,Mixed,114,75,189
408650,8,Very Positive,304,22,326
408750,7,Positive,23,5,28
408760,5,Mixed,172,120,292
408770,6,Mostly Positive,86,35,121
408860,0,5 user reviews,3,2,5
408880,0,3 user reviews,2,1,3
408900,8,Very Positive,119,19,138
408920,5,Mixed,105,62,167
408960,8,Very Positive,99,23,122
409000,5,Mixed,134,71,205
409040,5,Mixed,28,14,42
409070,6,Mostly Positive,21,8,29
409100,8,Very Positive,750,125,875
409160,8,Very Positive,6829,448,7277
409290,5,Mixed,29,15,44
409320,5,Mixed,117,54,171
409340,5,Mixed,67,33,100
409350,0,No user reviews,0,0,0
409360,5,Mixed,21,11,32
409370,5,Mixed,15,11,26
409380,8,Very Positive,190,32,222
409390,6,Mostly Positive,35,14,49
409410,5,Mixed,26,15,41
409440,8,Very Positive,64,11,75
409450,8,Very Positive,305,49,354
409460,5,Mixed,19,9,28
409490,5,Mixed,38,24,62
409510,4,Mostly Negative,507,1137,1644
409520,5,Mixed,31,15,46
409560,6,Mostly Positive,65,17,82
409580,0,7 user reviews,3,4,7
409600,6,Mostly Positive,70,28,98
409610,0,9 user reviews,9,0,9
409660,8,Very Positive,445,47,492
409710,5,Mixed,6304,4186,10490
409730,8,Very Positive,83,19,102
409850,8,Very Positive,177,41,218
409870,8,Very Positive,179,9,188
409890,6,Mostly Positive,217,87,304
410000,7,Positive,11,2,13
410110,8,Very Positive,2402,437,2839
410150,7,Positive,32,3,35
410320,9,Overwhelmingly Positive,3170,132,3302
410370,0,9 user reviews,8,1,9
410430,6,Mostly Positive,347,120,467
410440,6,Mostly Positive,31,8,39
410470,6,Mostly Positive,11,3,14
410570,8,Very Positive,137,33,170
410820,8,Very Positive,351,19,370
410830,8,Very Positive,59,6,65
410840,6,Mostly Positive,163,43,206
410850,5,Mixed,634,289,923
410890,8,Very Positive,255,9,264
410900,6,Mostly Positive,1378,354,1732
410910,7,Positive,20,4,24
411120,8,Very Positive,163,27,190
411130,5,Mixed,30,22,52
411300,6,Mostly Positive,5875,1713,7588
411370,8,Very Positive,933,80,1013
411390,7,Positive,11,1,12
411480,5,Mixed,79,66,145
411560,8,Very Positive,984,155,1139
411570,8,Very Positive,102,10,112
411590,8,Very Positive,60,11,71
411600,5,Mixed,33,20,53
411610,7,Positive,33,5,38
411620,5,Mixed,20,13,33
411630,5,Mixed,7,6,13
411680,8,Very Positive,49,9,58
411690,5,Mixed,12,6,18
411720,0,7 user reviews,6,1,7
411750,6,Mostly Positive,31,9,40
411760,8,Very Positive,233,41,274
411830,9,Overwhelmingly Positive,2633,132,2765
411960,9,Overwhelmingly Positive,1491,16,1507
411970,8,Very Positive,283,7,290
411980,7,Positive,47,0,47
412010,5,Mixed,21,11,32
412020,0,No user reviews,0,0,0
412150,8,Very Positive,144,24,168
412170,6,Mostly Positive,176,51,227
412230,6,Mostly Positive,40,12,52
412250,5,Mixed,15,10,25
412270,8,Very Positive,69,10,79
412400,1,Overwhelmingly Negative,248,1006,1254
412410,5,Mixed,31,18,49
412450,5,Mixed,907,634,1541
412460,5,Mixed,133,124,257
412490,5,Mixed,20,9,29
412520,6,Mostly Positive,228,61,289
412530,0,5 user reviews,5,0,5
412540,6,Mostly Positive,16,6,22
412620,8,Very Positive,92,8,100
412660,8,Very Positive,69,14,83
412670,8,Very Positive,187,4,191
412730,4,Mostly Negative,48,87,135
412760,0,9 user reviews,9,0,9
412770,8,Very Positive,246,48,294
412790,6,Mostly Positive,84,27,111
412830,9,Overwhelmingly Positive,4274,104,4378
412860,6,Mostly Positive,18,7,25
412970,5,Mixed,9,5,14
413010,0,No user reviews,0,0,0
413040,0,5 user reviews,3,2,5
413150,9,Overwhelmingly Positive,88300,2125,90425
413350,0,1 user reviews,0,1,1
413410,9,Overwhelmingly Positive,4204,120,4324
413420,9,Overwhelmingly Positive,3435,88,3523
413480,7,Positive,25,6,31
413490,5,Mixed,6,5,11
413500,8,Very Positive,57,8,65
413510,5,Mixed,22,14,36
413540,7,Positive,12,0,12
413580,7,Positive,14,0,14
413680,5,Mixed,136,63,199
413700,7,Positive,16,1,17
413710,5,Mixed,480,328,808
413740,5,Mixed,20,15,35
413760,5,Mixed,13,19,32
413830,5,Mixed,10,5,15
413870,8,Very Positive,84,6,90
414060,5,Mixed,10,11,21
414070,5,Mixed,210,138,348
414080,6,Mostly Positive,307,122,429
414090,5,Mixed,9,6,15
414190,8,Very Positive,203,43,246
414260,6,Mostly Positive,24,9,33
414290,8,Very Positive,799,135,934
414340,8,Very Positive,14216,1226,15442
414370,8,Very Positive,53,4,57
414510,8,Very Positive,222,34,256
414530,5,Mixed,950,675,1625
414550,6,Mostly Positive,97,35,132
414660,8,Very Positive,232,36,268
414700,8,Very Positive,7802,1202,9004
414730,5,Mixed,391,187,578
414740,5,Mixed,693,637,1330
414760,7,Positive,13,0,13
414870,8,Very Positive,222,47,269
414950,6,Mostly Positive,96,38,134
415010,5,Mixed,41,47,88
415030,6,Mostly Positive,339,96,435
415090,7,Positive,20,2,22
415150,8,Very Positive,115,22,137
415170,8,Very Positive,198,5,203
415200,8,Very Positive,3613,383,3996
415240,6,Mostly Positive,85,22,107
415270,8,Very Positive,1395,313,1708
415300,6,Mostly Positive,156,46,202
415350,8,Very Positive,367,37,404
415400,8,Very Positive,146,28,174
415420,8,Very Positive,1188,83,1271
415480,8,Very Positive,481,99,580
415530,7,Positive,10,1,11
415590,6,Mostly Positive,403,114,517
415610,8,Very Positive,338,22,360
415660,5,Mixed,601,375,976
415670,8,Very Positive,58,4,62
415740,8,Very Positive,168,38,206
415830,8,Very Positive,50,6,56
415840,5,Mixed,71,35,106
415850,8,Very Positive,211,39,250
415860,5,Mixed,485,520,1005
415880,6,Mostly Positive,681,218,899
415890,5,Mixed,10,10,20
415900,0,3 user reviews,3,0,3
415910,7,Positive,39,4,43
415920,8,Very Positive,96,3,99
415960,6,Mostly Positive,144,45,189
415980,0,7 user reviews,5,2,7
415990,7,Positive,19,3,22
416000,8,Very Positive,50,0,50
416040,4,Mostly Negative,69,108,177
416070,5,Mixed,15,18,33
416090,0,6 user reviews,4,2,6
416110,8,Very Positive,77,11,88
416130,6,Mostly Positive,1567,433,2000
416140,4,Mostly Negative,6,11,17
416180,7,Positive,31,4,35
416210,6,Mostly Positive,629,208,837
416220,0,8 user reviews,1,7,8
416250,7,Positive,15,3,18
416260,4,Mostly Negative,17,43,60
416290,5,Mixed,21,25,46
416350,5,Mixed,24,29,53
416360,8,Very Positive,69,2,71
416370,5,Mixed,37,25,62
416380,6,Mostly Positive,71,22,93
416450,5,Mixed,220,131,351
416530,8,Very Positive,49,4,53
416550,8,Very Positive,117,9,126
416600,8,Very Positive,530,54,584
416610,5,Mixed,34,17,51
416630,5,Mixed,45,52,97
416640,6,Mostly Positive,85,23,108
416670,5,Mixed,164,132,296
416680,8,Very Positive,847,46,893
416700,0,7 user reviews,6,1,7
416720,5,Mixed,20,15,35
416770,8,Very Positive,478,38,516
416790,8,Very Positive,188,21,209
416830,7,Positive,42,4,46
416840,0,5 user reviews,4,1,5
416850,7,Positive,12,2,14
416870,7,Positive,41,1,42
417020,0,No user reviews,0,0,0
417060,5,Mixed,10,6,16
417290,8,Very Positive,1384,112,1496
417310,6,Mostly Positive,14,6,20
417350,3,Negative,1,9,10
417400,7,Positive,12,2,14
417430,5,Mixed,425,211,636
417480,6,Mostly Positive,14,4,18
417860,8,Very Positive,22767,2904,25671
417880,5,Mixed,584,264,848
417900,7,Positive,22,1,23
417910,5,Mixed,860,652,1512
417980,8,Very Positive,44,9,53
417990,8,Very Positive,293,72,365
418040,8,Very Positive,421,36,457
418060,5,Mixed,52,25,77
418110,6,Mostly Positive,115,44,159
418120,8,Very Positive,305,64,369
418150,8,Very Positive,102,20,122
418160,7,Positive,38,8,46
418180,6,Mostly Positive,1063,418,1481
418210,7,Positive,42,5,47
418240,9,Overwhelmingly Positive,7170,260,7430
418270,6,Mostly Positive,63,22,85
418300,8,Very Positive,305,43,348
418310,5,Mixed,13,9,22
418340,8,Very Positive,7769,1508,9277
418370,8,Very Positive,15768,1384,17152
418430,4,Mostly Negative,5,11,16
418460,6,Mostly Positive,11458,3155,14613
418610,5,Mixed,54,52,106
418650,9,Overwhelmingly Positive,1679,66,1745
418670,8,Very Positive,158,30,188
418910,5,Mixed,86,65,151
418950,8,Very Positive,332,79,411
419020,6,Mostly Positive,15,4,19
419080,6,Mostly Positive,56,20,76
419090,8,Very Positive,41,9,50
419480,6,Mostly Positive,1497,416,1913
419500,8,Very Positive,51,3,54
419590,6,Mostly Positive,29,10,39
419700,0,No user reviews,0,0,0
419710,7,Positive,10,0,10
419810,7,Positive,24,2,26
419990,0,No user reviews,0,0,0
420060,8,Very Positive,275,36,311
420070,5,Mixed,56,27,83
420110,9,Overwhelmingly Positive,7531,193,7724
420140,0,No user reviews,0,0,0
420160,5,Mixed,8,4,12
420180,8,Very Positive,57,10,67
420270,5,Mixed,67,45,112
420290,8,Very Positive,7673,953,8626
420360,7,Positive,36,6,42
420370,0,6 user reviews,4,2,6
420380,6,Mostly Positive,14,4,18
420500,6,Mostly Positive,13,4,17
420530,9,Overwhelmingly Positive,7376,117,7493
420550,8,Very Positive,80,19,99
420570,7,Positive,23,3,26
420660,8,Very Positive,47,6,53
420740,8,Very Positive,1181,110,1291
420770,6,Mostly Positive,121,37,158
420790,6,Mostly Positive,621,180,801
420850,6,Mostly Positive,78,27,105
420900,6,Mostly Positive,10,3,13
420930,8,Very Positive,297,59,356
420980,8,Very Positive,128,11,139
421020,5,Mixed,2541,1365,3906
421030,6,Mostly Positive,454,123,577
421040,8,Very Positive,3200,425,3625
421050,8,Very Positive,1600,213,1813
421060,5,Mixed,119,65,184
421120,9,Overwhelmingly Positive,1616,85,1701
421140,6,Mostly Positive,10,4,14
421180,0,6 user reviews,4,2,6
421260,8,Very Positive,95,3,98
421600,5,Mixed,36,31,67
421610,7,Positive,36,6,42
421620,0,7 user reviews,4,3,7
421630,8,Very Positive,112,4,116
421660,8,Very Positive,290,7,297
421670,8,Very Positive,734,101,835
421730,0,No user reviews,0,0,0
421740,8,Very Positive,172,36,208
421810,6,Mostly Positive,235,73,308
421870,7,Positive,12,3,15
421890,5,Mixed,24,18,42
421900,5,Mixed,24,15,39
422110,8,Very Positive,119,5,124
422250,5,Mixed,275,200,475
422270,4,Mostly Negative,8,17,25
422590,4,Mostly Negative,9,28,37
422610,5,Mixed,21,12,33
422650,6,Mostly Positive,56,16,72
422810,6,Mostly Positive,1083,354,1437
422860,8,Very Positive,149,15,164
422870,5,Mixed,813,385,1198
422900,8,Very Positive,409,36,445
422910,8,Very Positive,88,6,94
422920,7,Positive,46,3,49
422970,9,Overwhelmingly Positive,3797,190,3987
422980,7,Positive,23,4,27
423120,8,Very Positive,193,22,215
423220,7,Positive,19,1,20
423230,8,Very Positive,2954,295,3249
423270,6,Mostly Positive,29,9,38
423320,8,Very Positive,64,15,79
423440,7,Positive,32,2,34
423490,8,Very Positive,233,47,280
423550,6,Mostly Positive,60,21,81
423580,8,Very Positive,1380,321,1701
423590,8,Very Positive,239,33,272
423610,6,Mostly Positive,112,31,143
423620,6,Mostly Positive,320,92,412
423650,5,Mixed,40,24,64
423700,5,Mixed,27,37,64
423710,5,Mixed,100,133,233
423720,7,Positive,11,1,12
423730,0,6 user reviews,5,1,6
423740,6,Mostly Positive,25,10,35
423800,6,Mostly Positive,31,13,44
423810,6,Mostly Positive,334,134,468
423870,7,Positive,25,6,31
423880,8,Very Positive,5747,648,6395
423950,5,Mixed,374,173,547
424010,7,Positive,18,2,20
424060,4,Mostly Negative,8,13,21
424170,6,Mostly Positive,37,10,47
424210,6,Mostly Positive,11,3,14
424250,6,Mostly Positive,241,65,306
424260,5,Mixed,37,26,63
424280,9,Overwhelmingly Positive,11633,206,11839
424370,6,Mostly Positive,1828,697,2525
424640,7,Positive,34,6,40
424750,7,Positive,9,1,10
424760,6,Mostly Positive,26,10,36
424830,4,Mostly Negative,90,287,377
424840,8,Very Positive,4797,587,5384
424850,5,Mixed,10,9,19
425040,7,Positive,16,0,16
425070,7,Positive,35,5,40
425160,8,Very Positive,61,7,68
425210,6,Mostly Positive,499,146,645
425220,6,Mostly Positive,1253,392,1645
425240,6,Mostly Positive,75,24,99
425300,6,Mostly Positive,57,18,75
425310,4,Mostly Negative,10,17,27
425410,8,Very Positive,239,30,269
425450,6,Mostly Positive,14,6,20
425580,9,Overwhelmingly Positive,5729,126,5855
425600,8,Very Positive,69,9,78
425650,8,Very Positive,98,7,105
425670,8,Very Positive,333,53,386
425720,8,Very Positive,219,41,260
425760,0,5 user reviews,4,1,5
425820,8,Very Positive,49,8,57
425860,0,9 user reviews,4,5,9
425900,7,Positive,18,3,21
426000,8,Very Positive,2650,553,3203
426010,4,Mostly Negative,16,28,44
426050,0,9 user reviews,8,1,9
426170,5,Mixed,26,13,39
426190,8,Very Positive,79,13,92
426240,7,Positive,18,1,19
426290,6,Mostly Positive,43,13,56
426310,6,Mostly Positive,139,50,189
426330,8,Very Positive,121,13,134
426590,5,Mixed,34,29,63
426790,8,Very Positive,755,86,841
427030,6,Mostly Positive,726,232,958
427050,6,Mostly Positive,8,3,11
427100,5,Mixed,1218,1015,2233
427240,8,Very Positive,339,36,375
427250,8,Very Positive,1220,280,1500
427270,5,Mixed,3473,1682,5155
427290,6,Mostly Positive,2618,907,3525
427470,6,Mostly Positive,164,67,231
427490,8,Very Positive,221,35,256
427510,6,Mostly Positive,170,50,220
427520,9,Overwhelmingly Positive,35074,465,35539
427550,5,Mixed,76,42,118
427570,5,Mixed,81,56,137
427610,0,8 user reviews,4,4,8
427660,5,Mixed,112,78,190
427680,8,Very Positive,70,4,74
427700,8,Very Positive,156,4,160
427730,6,Mostly Positive,7938,2892,10830
427770,7,Positive,40,3,43
427780,6,Mostly Positive,231,61,292
427810,6,Mostly Positive,220,68,288
427820,8,Very Positive,612,118,730
427860,6,Mostly Positive,58,22,80
427910,6,Mostly Positive,244,72,316
427930,5,Mixed,33,26,59
427970,0,5 user reviews,3,2,5
427980,6,Mostly Positive,322,87,409
428020,0,5 user reviews,3,2,5
428040,7,Positive,19,1,20
428100,8,Very Positive,74,2,76
428110,5,Mixed,14,9,23
428130,0,4 user reviews,4,0,4
428180,8,Very Positive,269,67,336
428200,5,Mixed,153,66,219
428220,8,Very Positive,236,39,275
428230,0,6 user reviews,5,1,6
428350,8,Very Positive,52,10,62
428410,7,Positive,23,2,25
428440,5,Mixed,137,82,219
428460,7,Positive,35,5,40
428490,7,Positive,18,0,18
428510,6,Mostly Positive,34,10,44
428530,5,Mixed,18,11,29
428550,9,Overwhelmingly Positive,4399,202,4601
428590,5,Mixed,7,9,16
428690,6,Mostly Positive,5461,1978,7439
428740,4,Mostly Negative,7,11,18
428750,8,Very Positive,637,46,683
428760,5,Mixed,22,19,41
428830,8,Very Positive,109,12,121
428860,8,Very Positive,92,14,106
428880,8,Very Positive,214,33,247
428900,8,Very Positive,634,95,729
428920,6,Mostly Positive,11,3,14
428930,0,6 user reviews,6,0,6
428980,4,Mostly Negative,4,13,17
429020,4,Mostly Negative,21,42,63
429050,6,Mostly Positive,818,302,1120
429060,5,Mixed,38,36,74
429120,6,Mostly Positive,18,7,25
429200,5,Mixed,22,14,36
429220,6,Mostly Positive,37,13,50
429250,7,Positive,17,4,21
429270,0,6 user reviews,6,0,6
429330,8,Very Positive,256,38,294
429350,7,Positive,24,1,25
429360,7,Positive,44,0,44
429390,5,Mixed,32,17,49
429430,4,Mostly Negative,8,18,26
429470,8,Very Positive,665,96,761
429480,0,6 user reviews,3,3,6
429570,6,Mostly Positive,3184,957,4141
429580,5,Mixed,117,100,217
429600,5,Mixed,112,75,187
429610,8,Very Positive,169,33,202
429620,6,Mostly Positive,521,181,702
429660,8,Very Positive,5377,305,5682
429680,6,Mostly Positive,833,291,1124
429690,7,Positive,29,3,32
429700,5,Mixed,244,115,359
429720,8,Very Positive,452,43,495
429780,6,Mostly Positive,330,129,459
429940,8,Very Positive,487,43,530
429950,4,Mostly Negative,17,46,63
430070,8,Very Positive,69,17,86
430170,6,Mostly Positive,58,23,81
430210,6,Mostly Positive,429,151,580
430230,7,Positive,13,3,16
430240,5,Mixed,7,5,12
430290,7,Positive,29,2,31
430300,5,Mixed,7,4,11
430410,8,Very Positive,63,11,74
430890,7,Positive,17,1,18
431120,8,Very Positive,110,17,127
431180,8,Very Positive,652,91,743
431200,7,Positive,33,4,37
431220,5,Mixed,68,72,140
431230,8,Very Positive,90,21,111
431240,8,Very Positive,12459,1187,13646
431250,8,Very Positive,236,56,292
431260,6,Mostly Positive,346,94,440
431280,0,No user reviews,0,0,0
431290,5,Mixed,25,11,36
431370,7,Positive,11,2,13
431410,7,Positive,22,4,26
431510,8,Very Positive,250,50,300
431540,8,Very Positive,932,109,1041
431560,5,Mixed,231,100,331
431590,8,Very Positive,253,32,285
431600,8,Very Positive,799,107,906
431630,7,Positive,20,4,24
431640,5,Mixed,45,47,92
431650,6,Mostly Positive,284,95,379
431680,5,Mixed,11,13,24
431700,8,Very Positive,60,3,63
431710,8,Very Positive,279,42,321
431740,5,Mixed,22,13,35
431750,6,Mostly Positive,29,10,39
431810,5,Mixed,113,50,163
431830,7,Positive,26,5,31
431840,5,Mixed,74,54,128
431850,8,Very Positive,49,9,58
431860,6,Mostly Positive,26,8,34
431870,6,Mostly Positive,48,16,64
431910,6,Mostly Positive,154,40,194
431930,8,Very Positive,101,4,105
431960,9,Overwhelmingly Positive,43990,1212,45202
432010,8,Very Positive,368,79,447
432100,8,Very Positive,307,51,358
432130,7,Positive,23,4,27
432180,7,Positive,20,4,24
432190,8,Very Positive,80,11,91
432230,7,Positive,25,5,30
432260,6,Mostly Positive,45,12,57
432270,0,5 user reviews,1,4,5
432280,6,Mostly Positive,40,11,51
432290,5,Mixed,68,54,122
432330,6,Mostly Positive,38,15,53
432380,7,Positive,15,1,16
432420,5,Mixed,8,7,15
432470,5,Mixed,96,124,220
432480,7,Positive,18,2,20
432590,5,Mixed,19,14,33
432640,5,Mixed,17,21,38
432720,6,Mostly Positive,45,17,62
432790,0,5 user reviews,5,0,5
432870,6,Mostly Positive,36,10,46
432940,8,Very Positive,57,6,63
432950,5,Mixed,53,23,76
432980,8,Very Positive,121,8,129
432990,7,Positive,36,3,39
433100,8,Very Positive,565,139,704
433110,5,Mixed,13,11,24
433190,5,Mixed,56,27,83
433210,5,Mixed,34,51,85
433300,5,Mixed,220,171,391
433320,5,Mixed,119,135,254
433340,9,Overwhelmingly Positive,17305,653,17958
433350,5,Mixed,1060,968,2028
433380,5,Mixed,42,23,65
433400,8,Very Positive,49,6,55
433450,5,Mixed,41,19,60
433480,0,8 user reviews,8,0,8
433490,7,Positive,22,3,25
433530,8,Very Positive,1142,285,1427
433570,6,Mostly Positive,7,3,10
433590,7,Positive,30,7,37
433600,8,Very Positive,151,30,181
433660,7,Positive,10,2,12
433670,4,Mostly Negative,55,106,161
433830,0,6 user reviews,4,2,6
433840,5,Mixed,35,16,51
433890,7,Positive,29,4,33
433900,5,Mixed,41,27,68
433910,8,Very Positive,858,200,1058
433950,9,Overwhelmingly Positive,4292,106,4398
433960,0,9 user reviews,8,1,9
434000,8,Very Positive,276,31,307
434010,5,Mixed,189,154,343
434020,8,Very Positive,210,37,247
434050,8,Very Positive,525,121,646
434120,5,Mixed,92,61,153
434130,7,Positive,34,3,37
434140,0,2 user reviews,1,1,2
434160,8,Very Positive,46,6,52
434170,8,Very Positive,578,33,611
434210,8,Very Positive,502,46,548
434220,7,Positive,31,4,35
434230,7,Positive,16,2,18
434240,7,Positive,13,2,15
434250,5,Mixed,868,376,1244
434260,8,Very Positive,1623,372,1995
434290,5,Mixed,67,31,98
434300,4,Mostly Negative,5,9,14
434310,6,Mostly Positive,23,8,31
434340,0,2 user reviews,2,0,2
434360,5,Mixed,44,31,75
434390,6,Mostly Positive,11,3,14
434410,8,Very Positive,186,8,194
434420,6,Mostly Positive,630,261,891
434460,6,Mostly Positive,1065,273,1338
434490,7,Positive,28,0,28
434510,8,Very Positive,178,41,219
434530,7,Positive,22,3,25
434570,9,Overwhelmingly Positive,13474,704,14178
434600,6,Mostly Positive,25,9,34
434620,6,Mostly Positive,159,48,207
434650,8,Very Positive,10543,1130,11673
434660,7,Positive,25,0,25
434680,5,Mixed,99,64,163
434700,7,Positive,13,3,16
434730,8,Very Positive,1831,449,2280
434740,8,Very Positive,68,12,80
434750,7,Positive,21,2,23
434780,5,Mixed,29,18,47
434790,6,Mostly Positive,10,4,14
434820,8,Very Positive,48,10,58
434860,7,Positive,12,3,15
434870,5,Mixed,5,5,10
434880,5,Mixed,79,37,116
434930,5,Mixed,9,10,19
434960,5,Mixed,4,6,10
434970,0,3 user reviews,2,1,3
435010,5,Mixed,16,19,35
435020,6,Mostly Positive,43,18,61
435030,8,Very Positive,3522,274,3796
435040,6,Mostly Positive,31,9,40
435100,6,Mostly Positive,116,38,154
435150,9,Overwhelmingly Positive,28259,1357,29616
435260,7,Positive,20,3,23
435300,8,Very Positive,281,23,304
435360,7,Positive,38,5,43
435400,9,Overwhelmingly Positive,2913,58,2971
435410,0,No user reviews,0,0,0
435460,8,Very Positive,49,6,55
435480,5,Mixed,73,41,114
435490,8,Very Positive,190,13,203
435530,8,Very Positive,2874,510,3384
435600,5,Mixed,18,10,28
435790,8,Very Positive,112,16,128
435800,8,Very Positive,51,4,55
435840,7,Positive,24,4,28
435970,7,Positive,48,0,48
436000,6,Mostly Positive,63,20,83
436060,5,Mixed,13,6,19
436070,7,Positive,15,2,17
436140,5,Mixed,26,12,38
436150,6,Mostly Positive,1665,616,2281
436180,5,Mixed,679,686,1365
436220,8,Very Positive,133,8,141
436230,8,Very Positive,117,26,143
436260,5,Mixed,109,89,198
436270,5,Mixed,14,9,23
436280,6,Mostly Positive,45,19,64
436290,6,Mostly Positive,170,64,234
436320,8,Very Positive,1494,240,1734
436360,7,Positive,16,0,16
436390,8,Very Positive,209,18,227
436410,4,Mostly Negative,5,14,19
436470,7,Positive,21,2,23
436480,5,Mixed,25,14,39
436490,8,Very Positive,144,34,178
436500,6,Mostly Positive,285,82,367
436520,5,Mixed,3801,2811,6612
436530,6,Mostly Positive,197,53,250
436670,8,Very Positive,361,22,383
436690,6,Mostly Positive,24,10,34
436850,0,6 user reviews,3,3,6
436940,8,Very Positive,46,5,51
437000,6,Mostly Positive,78,30,108
437010,0,No user reviews,0,0,0
437020,7,Positive,47,0,47
437060,7,Positive,19,2,21
437080,6,Mostly Positive,51,14,65
437090,7,Positive,39,5,44
437100,8,Very Positive,60,5,65
437160,8,Very Positive,1261,81,1342
437180,5,Mixed,16,7,23
437220,5,Mixed,9037,6540,15577
437250,8,Very Positive,175,25,200
437340,0,6 user reviews,6,0,6
437390,8,Very Positive,98,24,122
437420,8,Very Positive,135,17,152
437520,8,Very Positive,60,1,61
437530,8,Very Positive,122,30,152
437550,7,Positive,31,6,37
437570,8,Very Positive,612,93,705
437630,0,No user reviews,0,0,0
437690,7,Positive,24,4,28
437710,7,Positive,10,2,12
437720,5,Mixed,47,24,71
437730,7,Positive,22,2,24
437870,5,Mixed,78,68,146
437880,6,Mostly Positive,11,4,15
437920,8,Very Positive,2007,231,2238
438000,7,Positive,42,5,47
438020,4,Mostly Negative,66,171,237
438080,8,Very Positive,377,91,468
438090,0,7 user reviews,4,3,7
438130,8,Very Positive,210,15,225
438210,0,No user reviews,0,0,0
438220,6,Mostly Positive,9,3,12
438260,7,Positive,13,3,16
438300,5,Mixed,12,10,22
438310,5,Mixed,15,20,35
438320,8,Very Positive,133,1,134
438340,5,Mixed,72,44,116
438420,6,Mostly Positive,226,88,314
438430,6,Mostly Positive,192,52,244
438460,7,Positive,25,3,28
438480,8,Very Positive,436,94,530
438490,6,Mostly Positive,2207,589,2796
438640,8,Very Positive,1469,336,1805
438680,8,Very Positive,837,148,985
438720,5,Mixed,22,24,46
438730,5,Mixed,14,11,25
438740,5,Mixed,14544,6258,20802
438780,0,7 user reviews,5,2,7
438910,0,8 user reviews,1,7,8
438920,8,Very Positive,190,46,236
438940,7,Positive,10,2,12
439190,8,Very Positive,2894,448,3342
439250,8,Very Positive,192,33,225
439310,6,Mostly Positive,65,17,82
439340,6,Mostly Positive,230,85,315
439400,0,No user reviews,0,0,0
439440,6,Mostly Positive,62,20,82
439490,8,Very Positive,202,0,202
439530,0,9 user reviews,5,4,9
439550,5,Mixed,29,27,56
439720,6,Mostly Positive,59,25,84
439730,7,Positive,13,1,14
439740,7,Positive,10,2,12
439750,7,Positive,23,5,28
439770,7,Positive,38,9,47
439800,7,Positive,39,8,47
439880,7,Positive,17,4,21
439910,8,Very Positive,207,49,256
439920,6,Mostly Positive,179,45,224
439940,8,Very Positive,678,57,735
439950,5,Mixed,26,39,65
440020,5,Mixed,80,107,187
440100,7,Positive,10,1,11
440310,0,No user reviews,0,0,0
440340,5,Mixed,62,30,92
440420,8,Very Positive,229,25,254
440450,5,Mixed,28,16,44
440470,4,Mostly Negative,6,15,21
440550,8,Very Positive,141,18,159
440630,8,Very Positive,608,82,690
440650,8,Very Positive,1445,165,1610
440660,0,5 user reviews,5,0,5
440690,6,Mostly Positive,48,14,62
440720,5,Mixed,8,8,16
440730,5,Mixed,362,267,629
440740,5,Mixed,160,128,288
440750,5,Mixed,13,6,19
440790,5,Mixed,5,6,11
440800,7,Positive,25,4,29
440810,5,Mixed,31,45,76
440880,9,Overwhelmingly Positive,562,28,590
440900,6,Mostly Positive,15438,6596,22034
440950,5,Mixed,27,16,43
441010,8,Very Positive,118,21,139
441050,8,Very Positive,336,15,351
441060,7,Positive,15,2,17
441230,7,Positive,26,3,29
441250,5,Mixed,31,14,45
441280,8,Very Positive,151,10,161
441350,5,Mixed,46,20,66
441440,0,No user reviews,0,0,0
441510,7,Positive,35,3,38
441670,6,Mostly Positive,112,33,145
441790,5,Mixed,727,820,1547
441830,6,Mostly Positive,769,267,1036
442070,8,Very Positive,203,23,226
442120,6,Mostly Positive,472,124,596
442140,5,Mixed,8,4,12
442190,5,Mixed,10,11,21
442220,5,Mixed,38,35,73
442260,6,Mostly Positive,33,9,42
442290,5,Mixed,67,57,124
442500,6,Mostly Positive,395,100,495
442710,6,Mostly Positive,276,96,372
442760,0,4 user reviews,1,3,4
442770,6,Mostly Positive,13,5,18
442780,6,Mostly Positive,1029,403,1432
442810,5,Mixed,227,190,417
442890,5,Mixed,33,31,64
443250,7,Positive,23,5,28
443260,5,Mixed,35,21,56
443360,8,Very Positive,112,10,122
443420,8,Very Positive,153,23,176
443450,8,Very Positive,47,8,55
443460,8,Very Positive,44,7,51
443570,5,Mixed,29,31,60
443580,6,Mostly Positive,1387,501,1888
443630,8,Very Positive,61,7,68
443650,7,Positive,40,6,46
443810,8,Very Positive,4190,812,5002
443830,5,Mixed,11,9,20
443850,5,Mixed,11,6,17
443860,8,Very Positive,126,18,144
443880,6,Mostly Positive,95,38,133
444000,8,Very Positive,72,11,83
444020,0,7 user reviews,4,3,7
444090,8,Very Positive,132844,23677,156521
444130,8,Very Positive,55,12,67
444140,8,Very Positive,336,28,364
444160,5,Mixed,77,60,137
444170,7,Positive,38,1,39
444180,5,Mixed,73,32,105
444210,4,Mostly Negative,4,11,15
444220,5,Mixed,349,164,513
444260,5,Mixed,218,104,322
444270,7,Positive,37,5,42
444280,8,Very Positive,72,14,86
444290,4,Mostly Negative,39,110,149
444330,0,2 user reviews,2,0,2
444350,4,Mostly Negative,30,103,133
444420,4,Mostly Negative,19,48,67
444440,5,Mixed,32,24,56
444520,6,Mostly Positive,75,20,95
444550,7,Positive,22,5,27
444590,8,Very Positive,171,31,202
444620,4,Mostly Negative,26,41,67
444640,8,Very Positive,4575,876,5451
444670,8,Very Positive,60,8,68
444690,5,Mixed,56,36,92
444720,5,Mixed,189,88,277
444740,5,Mixed,6,5,11
444770,8,Very Positive,206,10,216
444800,8,Very Positive,158,21,179
444870,7,Positive,8,2,10
444880,5,Mixed,115,69,184
444930,6,Mostly Positive,225,68,293
444940,8,Very Positive,174,13,187
445000,7,Positive,17,1,18
445070,7,Positive,16,2,18
445110,8,Very Positive,174,17,191
445130,8,Very Positive,593,140,733
445190,8,Very Positive,1297,258,1555
445210,7,Positive,12,0,12
445220,8,Very Positive,2545,255,2800
445230,8,Very Positive,649,146,795
445550,0,8 user reviews,8,0,8
445600,8,Very Positive,44,11,55
445730,7,Positive,11,0,11
445770,8,Very Positive,155,31,186
445870,5,Mixed,31,15,46
445980,8,Very Positive,2003,238,2241
446020,6,Mostly Positive,2680,759,3439
446030,8,Very Positive,62,5,67
446040,8,Very Positive,102,20,122
446050,0,6 user reviews,5,1,6
446070,7,Positive,19,2,21
446100,6,Mostly Positive,74,20,94
446120,8,Very Positive,182,29,211
446150,5,Mixed,1260,789,2049
446240,5,Mixed,19,9,28
446250,5,Mixed,32,15,47
446310,8,Very Positive,70,4,74
446330,8,Very Positive,48,2,50
446390,6,Mostly Positive,332,100,432
446510,0,3 user reviews,3,0,3
446540,5,Mixed,95,62,157
446550,8,Very Positive,42,10,52
446600,6,Mostly Positive,52,14,66
446610,5,Mixed,20,14,34
446640,8,Very Positive,199,22,221
446760,7,Positive,29,3,32
446770,6,Mostly Positive,96,28,124
446790,6,Mostly Positive,445,167,612
446800,6,Mostly Positive,3506,949,4455
446810,8,Very Positive,94,13,107
446840,8,Very Positive,463,24,487
446850,7,Positive,26,0,26
446870,4,Mostly Negative,4,14,18
446910,8,Very Positive,54,5,59
446990,6,Mostly Positive,168,57,225
447010,7,Positive,19,1,20
447020,8,Very Positive,8546,698,9244
447120,8,Very Positive,162,25,187
447170,6,Mostly Positive,114,30,144
447180,5,Mixed,53,27,80
447190,8,Very Positive,95,12,107
447200,8,Very Positive,92,10,102
447210,7,Positive,41,2,43
447290,8,Very Positive,379,90,469
447310,6,Mostly Positive,56,18,74
447530,9,Overwhelmingly Positive,8906,209,9115
447570,8,Very Positive,250,41,291
447780,8,Very Positive,181,34,215
447800,8,Very Positive,69,12,81
447820,8,Very Positive,11577,2450,14027
447860,5,Mixed,34,20,54
447890,8,Very Positive,429,71,500
447950,8,Very Positive,75,4,79
447960,5,Mixed,29,14,43
447980,7,Positive,10,0,10
447990,5,Mixed,11,6,17
448000,5,Mixed,127,112,239
448010,7,Positive,27,3,30
448050,7,Positive,34,3,37
448070,5,Mixed,287,215,502
448090,5,Mixed,14,10,24
448110,5,Mixed,20,12,32
448160,7,Positive,41,3,44
448170,7,Positive,37,8,45
448240,5,Mixed,150,104,254
448250,5,Mixed,112,58,170
448260,5,Mixed,98,66,164
448280,8,Very Positive,914,127,1041
448290,8,Very Positive,246,46,292
448320,8,Very Positive,174,35,209
448370,8,Very Positive,876,49,925
448380,7,Positive,24,3,27
448440,5,Mixed,185,138,323
448470,5,Mixed,131,97,228
448480,5,Mixed,25,15,40
448500,7,Positive,25,2,27
448510,8,Very Positive,4876,418,5294
448520,7,Positive,28,1,29
448550,7,Positive,16,1,17
448560,6,Mostly Positive,96,35,131
448570,6,Mostly Positive,75,30,105
448620,5,Mixed,52,32,84
448630,4,Mostly Negative,35,53,88
448640,5,Mixed,54,31,85
448660,5,Mixed,381,228,609
448710,7,Positive,18,0,18
448720,6,Mostly Positive,23,6,29
448730,5,Mixed,8,4,12
448790,5,Mixed,21,10,31
448810,0,9 user reviews,8,1,9
448850,9,Overwhelmingly Positive,613,21,634
448910,8,Very Positive,64,12,76
449020,8,Very Positive,347,50,397
449050,5,Mixed,191,192,383
449060,8,Very Positive,93,18,111
449090,6,Mostly Positive,44,17,61
449100,0,No user reviews,0,0,0
449120,5,Mixed,10,5,15
449150,0,9 user reviews,8,1,9
449170,7,Positive,30,1,31
449180,7,Positive,25,1,26
449210,8,Very Positive,231,57,288
449220,5,Mixed,558,341,899
449240,7,Positive,14,0,14
449250,8,Very Positive,147,11,158
449300,5,Mixed,211,134,345
449310,7,Positive,20,2,22
449320,5,Mixed,11,6,17
449340,5,Mixed,23,11,34
449350,5,Mixed,8,4,12
449420,0,6 user reviews,6,0,6
449440,6,Mostly Positive,144,41,185
449450,7,Positive,39,3,42
449460,6,Mostly Positive,30,11,41
449500,0,7 user reviews,2,5,7
449510,8,Very Positive,64,11,75
449530,6,Mostly Positive,339,88,427
449540,8,Very Positive,2797,390,3187
449550,8,Very Positive,71,4,75
449560,0,7 user reviews,6,1,7
449640,6,Mostly Positive,37,14,51
449680,8,Very Positive,1769,311,2080
449690,6,Mostly Positive,42,13,55
449700,6,Mostly Positive,9,3,12
449710,6,Mostly Positive,238,88,326
449730,8,Very Positive,125,10,135
449800,8,Very Positive,2225,433,2658
449820,5,Mixed,36,28,64
449960,8,Very Positive,1713,99,1812
450060,5,Mixed,24,21,45
450110,6,Mostly Positive,73,30,103
450170,8,Very Positive,85,9,94
450190,6,Mostly Positive,137,37,174
450250,5,Mixed,17,11,28
450290,5,Mixed,16,12,28
450440,8,Very Positive,79,6,85
450500,8,Very Positive,208,19,227
450540,9,Overwhelmingly Positive,1721,50,1771
450650,7,Positive,18,2,20
450670,6,Mostly Positive,281,90,371
450700,6,Mostly Positive,114,36,150
450760,7,Positive,14,1,15
450860,5,Mixed,101,86,187
450950,8,Very Positive,85,9,94
451010,8,Very Positive,112,11,123
451020,8,Very Positive,2181,240,2421
451060,0,9 user reviews,6,3,9
451080,7,Positive,18,3,21
451100,7,Positive,29,1,30
451210,0,5 user reviews,2,3,5
451400,6,Mostly Positive,60,23,83
451570,8,Very Positive,114,14,128
451600,8,Very Positive,119,15,134
451640,7,Positive,27,5,32
451700,0,7 user reviews,3,4,7
451760,8,Very Positive,789,43,832
451780,6,Mostly Positive,206,67,273
451800,5,Mixed,6,5,11
451840,8,Very Positive,481,71,552
451880,6,Mostly Positive,319,121,440
451930,0,No user reviews,0,0,0
451990,6,Mostly Positive,63,26,89
452060,8,Very Positive,1124,134,1258
452120,8,Very Positive,41,9,50
452230,5,Mixed,179,109,288
452420,8,Very Positive,160,22,182
452450,5,Mixed,58,31,89
452510,8,Very Positive,551,31,582
452540,8,Very Positive,199,33,232
452570,8,Very Positive,446,9,455
452860,8,Very Positive,162,14,176
452920,7,Positive,29,3,32
452930,4,Mostly Negative,5,8,13
452970,5,Mixed,63,30,93
453030,6,Mostly Positive,11,3,14
453090,8,Very Positive,1051,92,1143
453100,8,Very Positive,172,33,205
453130,7,Positive,24,2,26
453220,7,Positive,10,2,12
453290,6,Mostly Positive,136,36,172
453300,8,Very Positive,65,16,81
453310,8,Very Positive,189,36,225
453320,0,8 user reviews,8,0,8
453340,8,Very Positive,605,36,641
453470,0,3 user reviews,3,0,3
453500,5,Mixed,18,8,26
453650,7,Positive,13,3,16
453660,5,Mixed,10,5,15
453690,8,Very Positive,112,23,135
453700,0,8 user reviews,7,1,8
453710,8,Very Positive,80,19,99
453720,6,Mostly Positive,86,32,118
453730,5,Mixed,16,10,26
453740,7,Positive,20,2,22
453750,6,Mostly Positive,199,58,257
453770,5,Mixed,25,11,36
453780,7,Positive,17,1,18
453790,8,Very Positive,94,19,113
453800,0,No user reviews,0,0,0
453810,5,Mixed,17,11,28
453830,7,Positive,9,1,10
453850,5,Mixed,163,85,248
453900,0,No user reviews,0,0,0
453910,7,Positive,9,1,10
454040,4,Mostly Negative,52,79,131
454060,8,Very Positive,686,144,830
454070,5,Mixed,147,107,254
454100,8,Very Positive,308,77,385
454130,7,Positive,21,4,25
454150,5,Mixed,360,288,648
454160,8,Very Positive,109,5,114
454170,7,Positive,13,0,13
454180,5,Mixed,121,63,184
454190,8,Very Positive,109,10,119
454220,6,Mostly Positive,62,16,78
454250,8,Very Positive,160,23,183
454320,8,Very Positive,101,7,108
454330,7,Positive,12,2,14
454380,8,Very Positive,94,0,94
454390,0,4 user reviews,4,0,4
454410,8,Very Positive,356,63,419
454420,6,Mostly Positive,15,4,19
454460,5,Mixed,25,11,36
454480,0,9 user reviews,8,1,9
454520,6,Mostly Positive,24,9,33
454600,5,Mixed,269,216,485
454610,5,Mixed,30,14,44
454630,7,Positive,13,1,14
454650,6,Mostly Positive,7107,1898,9005
454700,5,Mixed,8,10,18
454720,7,Positive,13,2,15
454730,0,8 user reviews,3,5,8
454750,0,6 user reviews,5,1,6
454770,7,Positive,13,1,14
454780,0,5 user reviews,4,1,5
454890,8,Very Positive,307,60,367
454900,8,Very Positive,57,5,62
454930,4,Mostly Negative,209,431,640
454970,7,Positive,28,4,32
455000,5,Mixed,38,23,61
455110,6,Mostly Positive,22,7,29
455120,5,Mixed,171,136,307
455190,6,Mostly Positive,7,3,10
455290,0,3 user reviews,3,0,3
455400,8,Very Positive,684,69,753
455490,5,Mixed,35,24,59
455640,7,Positive,12,2,14
455690,7,Positive,39,2,41
455700,5,Mixed,17,15,32
455770,7,Positive,9,2,11
455820,8,Very Positive,288,50,338
455830,6,Mostly Positive,10,3,13
455960,5,Mixed,22,10,32
455980,8,Very Positive,789,128,917
456130,7,Positive,19,2,21
456160,0,7 user reviews,4,3,7
456170,6,Mostly Positive,61,23,84
456180,7,Positive,32,5,37
456390,0,No user reviews,0,0,0
456430,8,Very Positive,166,24,190
456670,8,Very Positive,2055,269,2324
456690,7,Positive,22,3,25
456740,7,Positive,13,1,14
456780,5,Mixed,54,29,83
456810,6,Mostly Positive,107,38,145
456830,7,Positive,15,2,17
457210,9,Overwhelmingly Positive,704,35,739
457320,8,Very Positive,383,35,418
457370,7,Positive,12,2,14
457380,6,Mostly Positive,56,20,76
457450,6,Mostly Positive,22,7,29
457480,8,Very Positive,162,25,187
457490,8,Very Positive,142,21,163
457520,5,Mixed,68,33,101
457530,8,Very Positive,88,18,106
457600,6,Mostly Positive,83,33,116
457680,8,Very Positive,468,76,544
457690,4,Mostly Negative,8,28,36
457710,4,Mostly Negative,111,269,380
457730,6,Mostly Positive,271,94,365
457760,6,Mostly Positive,314,123,437
457770,7,Positive,20,3,23
457820,5,Mixed,69,38,107
457890,6,Mostly Positive,124,32,156
457960,8,Very Positive,579,50,629
457980,7,Positive,15,3,18
458000,6,Mostly Positive,336,100,436
458030,5,Mixed,18,14,32
458110,0,6 user reviews,5,1,6
458170,7,Positive,31,3,34
458330,7,Positive,30,3,33
458370,7,Positive,20,4,24
458410,5,Mixed,30,15,45
458450,4,Mostly Negative,14,28,42
458470,8,Very Positive,296,23,319
458480,8,Very Positive,132,17,149
458490,0,No user reviews,0,0,0
458500,0,2 user reviews,2,0,2
458510,7,Positive,18,4,22
458520,5,Mixed,79,115,194
458540,8,Very Positive,49,7,56
458600,5,Mixed,58,30,88
458630,6,Mostly Positive,77,25,102
458660,7,Positive,32,4,36
458680,6,Mostly Positive,57,18,75
458710,9,Overwhelmingly Positive,1864,64,1928
458730,8,Very Positive,323,48,371
458770,5,Mixed,297,213,510
458830,5,Mixed,95,66,161
458920,6,Mostly Positive,93,29,122
458960,5,Mixed,300,169,469
459040,0,9 user reviews,6,3,9
459090,8,Very Positive,207,15,222
459130,5,Mixed,29,13,42
459170,5,Mixed,21,17,38
459220,8,Very Positive,1758,193,1951
459310,5,Mixed,68,37,105
459350,7,Positive,41,8,49
459440,4,Mostly Negative,30,53,83
459610,7,Positive,17,1,18
459630,0,9 user reviews,3,6,9
459640,5,Mixed,7,4,11
459820,8,Very Positive,5370,717,6087
459830,7,Positive,17,1,18
459940,6,Mostly Positive,172,68,240
460060,0,No user reviews,0,0,0
460120,9,Overwhelmingly Positive,1987,71,2058
460150,6,Mostly Positive,47,16,63
460190,6,Mostly Positive,34,10,44
460210,7,Positive,13,0,13
460220,8,Very Positive,58,7,65
460250,7,Positive,43,3,46
460340,8,Very Positive,296,31,327
460430,8,Very Positive,381,26,407
460560,7,Positive,20,4,24
460630,8,Very Positive,66,4,70
460640,5,Mixed,69,47,116
460650,6,Mostly Positive,31,8,39
460700,8,Very Positive,431,92,523
460750,8,Very Positive,54,11,65
460780,8,Very Positive,67,4,71
460790,8,Very Positive,6225,482,6707
460810,8,Very Positive,1741,195,1936
460870,6,Mostly Positive,366,110,476
460910,8,Very Positive,84,19,103
460960,8,Very Positive,210,32,242
460970,7,Positive,23,1,24
461010,6,Mostly Positive,150,41,191
461030,5,Mixed,19,11,30
461170,8,Very Positive,116,18,134
461230,8,Very Positive,138,15,153
461340,0,8 user reviews,7,1,8
461350,0,7 user reviews,4,3,7
461360,8,Very Positive,64,8,72
461370,0,1 user reviews,0,1,1
461390,5,Mixed,13,10,23
461400,6,Mostly Positive,71,26,97
461410,8,Very Positive,54,7,61
461480,7,Positive,36,4,40
461490,5,Mixed,52,37,89
461560,8,Very Positive,4078,220,4298
461580,0,8 user reviews,5,3,8
461600,0,1 user reviews,1,0,1
461620,8,Very Positive,945,80,1025
461640,8,Very Positive,558,92,650
461650,5,Mixed,9,5,14
461680,4,Mostly Negative,45,88,133
461700,8,Very Positive,207,17,224
461710,7,Positive,40,8,48
461720,5,Mixed,194,86,280
461730,5,Mixed,181,84,265
461750,6,Mostly Positive,78,31,109
461760,6,Mostly Positive,42,12,54
461810,7,Positive,21,1,22
461830,6,Mostly Positive,12,4,16
461840,9,Overwhelmingly Positive,2048,90,2138
461850,5,Mixed,42,19,61
461860,5,Mixed,15,12,27
461870,0,No user reviews,0,0,0
461880,5,Mixed,81,68,149
461910,6,Mostly Positive,1904,534,2438
461940,5,Mixed,39,31,70
461950,8,Very Positive,1125,218,1343
461970,4,Mostly Negative,53,82,135
462000,8,Very Positive,90,12,102
462070,5,Mixed,6,5,11
462100,8,Very Positive,157,24,181
462130,6,Mostly Positive,14,5,19
462200,6,Mostly Positive,273,78,351
462240,8,Very Positive,61,8,69
462250,7,Positive,8,2,10
462440,5,Mixed,157,197,354
462480,7,Positive,38,6,44
462520,7,Positive,25,2,27
462620,8,Very Positive,62,1,63
462630,0,8 user reviews,5,3,8
462640,5,Mixed,16,10,26
462670,0,8 user reviews,8,0,8
462680,6,Mostly Positive,174,52,226
462700,5,Mixed,32,18,50
462730,5,Mixed,37,22,59
462770,8,Very Positive,3359,331,3690
462780,8,Very Positive,3492,557,4049
462830,4,Mostly Negative,13,32,45
462860,6,Mostly Positive,28,9,37
462940,6,Mostly Positive,43,17,60
462950,5,Mixed,24,24,48
462960,5,Mixed,274,139,413
462990,8,Very Positive,179,9,188
463010,0,4 user reviews,2,2,4
463030,5,Mixed,140,78,218
463060,6,Mostly Positive,404,128,532
463150,8,Very Positive,1404,208,1612
463160,6,Mostly Positive,80,22,102
463180,6,Mostly Positive,71,22,93
463210,8,Very Positive,676,113,789
463220,6,Mostly Positive,284,81,365
463240,6,Mostly Positive,23,9,32
463270,8,Very Positive,1186,86,1272
463320,5,Mixed,9,13,22
463350,6,Mostly Positive,292,99,391
463390,8,Very Positive,650,64,714
463410,0,2 user reviews,1,1,2
463440,0,2 user reviews,0,2,2
463460,6,Mostly Positive,25,7,32
463470,5,Mixed,18,10,28
463480,0,7 user reviews,5,2,7
463520,5,Mixed,61,38,99
463540,7,Positive,15,2,17
463670,5,Mixed,20,16,36
463700,8,Very Positive,96,9,105
463760,8,Very Positive,78,16,94
463830,5,Mixed,5,6,11
463860,5,Mixed,111,59,170
463870,5,Mixed,11,15,26
463880,6,Mostly Positive,11,4,15
463930,8,Very Positive,309,24,333
463980,8,Very Positive,134,16,150
464000,6,Mostly Positive,30,9,39
464020,0,2 user reviews,2,0,2
464040,0,8 user reviews,7,1,8
464050,6,Mostly Positive,30,9,39
464060,8,Very Positive,3215,336,3551
464070,0,8 user reviews,3,5,8
464100,6,Mostly Positive,121,35,156
464110,7,Positive,13,0,13
464150,8,Very Positive,185,40,225
464230,8,Very Positive,50,11,61
464240,5,Mixed,14,8,22
464340,5,Mixed,687,688,1375
464360,8,Very Positive,338,12,350
464380,4,Mostly Negative,3,9,12
464400,7,Positive,30,0,30
464440,5,Mixed,35,22,57
464450,8,Very Positive,347,10,357
464470,5,Mixed,182,128,310
464620,8,Very Positive,368,27,395
464650,7,Positive,28,4,32
464670,7,Positive,15,1,16
464700,5,Mixed,141,155,296
464740,0,5 user reviews,5,0,5
464800,5,Mixed,45,47,92
464850,5,Mixed,122,93,215
464880,6,Mostly Positive,267,72,339
464900,7,Positive,27,0,27
464960,8,Very Positive,193,19,212
465010,0,2 user reviews,1,1,2
465020,7,Positive,41,2,43
465060,0,6 user reviews,6,0,6
465070,7,Positive,14,0,14
465130,8,Very Positive,63,10,73
465170,6,Mostly Positive,129,55,184
465180,8,Very Positive,59,3,62
465200,8,Very Positive,191,15,206
465240,8,Very Positive,740,110,850
465280,8,Very Positive,158,27,185
465440,7,Positive,24,6,30
465520,8,Very Positive,3708,196,3904
465650,8,Very Positive,547,42,589
465660,5,Mixed,51,39,90
465670,6,Mostly Positive,13,5,18
465720,5,Mixed,62,29,91
465750,6,Mostly Positive,8,3,11
465760,6,Mostly Positive,180,65,245
465780,8,Very Positive,288,59,347
465840,5,Mixed,59,26,85
465870,5,Mixed,17,16,33
466110,8,Very Positive,431,32,463
466130,5,Mixed,381,211,592
466160,7,Positive,18,1,19
466170,8,Very Positive,352,58,410
466240,6,Mostly Positive,10727,3887,14614
466270,8,Very Positive,422,56,478
466290,0,6 user reviews,6,0,6
466300,9,Overwhelmingly Positive,774,39,813
466350,5,Mixed,61,33,94
466420,6,Mostly Positive,46,19,65
466430,7,Positive,43,1,44
466480,5,Mixed,12,12,24
466490,5,Mixed,37,35,72
466500,6,Mostly Positive,1692,715,2407
466520,5,Mixed,19,13,32
466560,8,Very Positive,9069,1217,10286
466720,8,Very Positive,53,4,57
466730,5,Mixed,179,100,279
466740,6,Mostly Positive,269,85,354
466770,7,Positive,14,1,15
466780,6,Mostly Positive,41,13,54
466800,6,Mostly Positive,120,31,151
466810,8,Very Positive,232,11,243
466820,7,Positive,39,6,45
466830,5,Mixed,34,26,60
466860,6,Mostly Positive,1026,401,1427
466870,8,Very Positive,210,38,248
466920,8,Very Positive,40,10,50
467010,5,Mixed,37,47,84
467060,5,Mixed,24,14,38
467120,0,8 user reviews,8,0,8
467210,8,Very Positive,245,13,258
467270,5,Mixed,23,10,33
467310,8,Very Positive,45,11,56
467320,6,Mostly Positive,51,13,64
467330,7,Positive,25,6,31
467350,4,Mostly Negative,3,8,11
467360,8,Very Positive,657,113,770
467370,5,Mixed,205,240,445
467380,9,Overwhelmingly Positive,754,34,788
467390,5,Mixed,143,71,214
467470,7,Positive,15,0,15
467490,7,Positive,18,3,21
467520,5,Mixed,289,263,552
467570,5,Mixed,118,122,240
467660,8,Very Positive,304,67,371
467760,8,Very Positive,82,6,88
467780,8,Very Positive,66,2,68
467790,0,3 user reviews,2,1,3
467810,7,Positive,47,0,47
467820,8,Very Positive,540,40,580
467850,5,Mixed,69,33,102
467930,6,Mostly Positive,344,111,455
467940,7,Positive,15,2,17
467950,6,Mostly Positive,140,52,192
467960,8,Very Positive,3277,449,3726
468000,4,Mostly Negative,83,128,211
468080,0,6 user reviews,3,3,6
468100,6,Mostly Positive,50,14,64
468110,7,Positive,16,0,16
468150,0,8 user reviews,6,2,8
468160,5,Mixed,35,16,51
468240,8,Very Positive,76,4,80
468250,5,Mixed,538,278,816
468330,7,Positive,19,4,23
468490,8,Very Positive,272,66,338
468530,8,Very Positive,806,120,926
468560,5,Mixed,619,559,1178
468570,5,Mixed,42,34,76
468650,0,5 user reviews,1,4,5
468670,0,No user reviews,0,0,0
468700,6,Mostly Positive,373,96,469
468920,6,Mostly Positive,250,85,335
468930,5,Mixed,76,44,120
469560,5,Mixed,7,4,11
469610,6,Mostly Positive,563,199,762
469720,8,Very Positive,176,36,212
469790,8,Very Positive,344,4,348
469820,8,Very Positive,3615,347,3962
469830,6,Mostly Positive,314,127,441
469890,8,Very Positive,160,35,195
469980,5,Mixed,20,15,35
470030,6,Mostly Positive,18,5,23
470040,5,Mixed,47,24,71
470060,8,Very Positive,76,19,95
470090,7,Positive,17,1,18
470140,5,Mixed,6,6,12
470210,6,Mostly Positive,183,51,234
470260,8,Very Positive,1164,285,1449
470270,6,Mostly Positive,194,49,243
470300,6,Mostly Positive,28,11,39
470310,8,Very Positive,305,26,331
470440,8,Very Positive,60,1,61
470480,6,Mostly Positive,17,6,23
470580,7,Positive,24,0,24
470590,6,Mostly Positive,40,14,54
470600,5,Mixed,359,212,571
470780,8,Very Positive,94,3,97
471010,6,Mostly Positive,267,74,341
471160,7,Positive,15,2,17
471170,5,Mixed,45,20,65
471200,0,3 user reviews,3,0,3
471220,0,6 user reviews,6,0,6
471260,6,Mostly Positive,33,10,43
471270,7,Positive,8,2,10
471330,8,Very Positive,291,71,362
471380,6,Mostly Positive,29,10,39
471570,8,Very Positive,52,0,52
471640,0,9 user reviews,7,2,9
471700,8,Very Positive,48,4,52
471710,9,Overwhelmingly Positive,2476,105,2581
471730,6,Mostly Positive,15,5,20
471810,8,Very Positive,54,1,55
471920,8,Very Positive,88,6,94
472060,8,Very Positive,99,22,121
472420,8,Very Positive,92,18,110
472680,6,Mostly Positive,443,120,563
472690,5,Mixed,21,18,39
472830,5,Mixed,8,5,13
472870,8,Very Positive,129,2,131
473050,3,Negative,2,15,17
473140,5,Mixed,38,22,60
473450,8,Very Positive,81,15,96
473460,8,Very Positive,483,41,524
473480,5,Mixed,9,7,16
473530,8,Very Positive,163,22,185
473540,4,Mostly Negative,4,7,11
473610,5,Mixed,40,52,92
473670,5,Mixed,88,101,189
473690,5,Mixed,4739,2313,7052
473710,4,Mostly Negative,165,264,429
473720,7,Positive,12,1,13
473740,8,Very Positive,524,72,596
473770,8,Very Positive,846,86,932
473910,5,Mixed,109,58,167
473920,8,Very Positive,76,0,76
473970,6,Mostly Positive,105,35,140
474010,5,Mixed,198,111,309
474050,5,Mixed,41,38,79
474210,8,Very Positive,468,48,516
474620,6,Mostly Positive,11,3,14
474730,5,Mixed,6,7,13
474750,8,Very Positive,4094,458,4552
474820,6,Mostly Positive,202,86,288
474830,5,Mixed,26,13,39
474890,6,Mostly Positive,31,10,41
474910,5,Mixed,86,51,137
474980,8,Very Positive,57,6,63
475070,7,Positive,23,5,28
475090,5,Mixed,24,31,55
475150,8,Very Positive,8737,730,9467
475470,5,Mixed,9,6,15
475490,8,Very Positive,286,71,357
475520,6,Mostly Positive,7,3,10
475530,5,Mixed,11,5,16
475620,0,8 user reviews,6,2,8
475960,8,Very Positive,47,4,51
476020,8,Very Positive,105,13,118
476240,8,Very Positive,392,17,409
476370,7,Positive,12,3,15
476410,7,Positive,33,0,33
476420,8,Very Positive,109,25,134
476450,5,Mixed,24,16,40
476460,8,Very Positive,469,47,516
476480,5,Mixed,245,110,355
476490,8,Very Positive,70,6,76
476510,5,Mixed,80,36,116
476530,8,Very Positive,211,17,228
476600,5,Mixed,8703,6815,15518
476650,8,Very Positive,145,17,162
476710,5,Mixed,16,9,25
476920,5,Mixed,71,39,110
476930,6,Mostly Positive,44,15,59
477140,5,Mixed,21,27,48
477160,8,Very Positive,16184,1475,17659
477170,5,Mixed,28,13,41
477310,7,Positive,37,2,39
477720,5,Mixed,5,5,10
477730,8,Very Positive,753,129,882
477740,8,Very Positive,451,20,471
477770,8,Very Positive,1012,174,1186
477870,8,Very Positive,572,103,675
477910,0,7 user reviews,7,0,7
477950,7,Positive,13,3,16
478210,5,Mixed,34,33,67
479040,5,Mixed,20,9,29
479110,6,Mostly Positive,25,10,35
479140,7,Positive,12,2,14
479310,7,Positive,18,0,18
479990,5,Mixed,31,14,45
480410,7,Positive,11,1,12
480430,6,Mostly Positive,1353,343,1696
480450,8,Very Positive,207,12,219
480480,8,Very Positive,188,26,214
480490,8,Very Positive,13570,1450,15020
480640,5,Mixed,214,99,313
480650,8,Very Positive,1513,278,1791
480770,0,6 user reviews,5,1,6
480900,8,Very Positive,78,11,89
481110,6,Mostly Positive,337,95,432
481180,8,Very Positive,79,8,87
481420,5,Mixed,21,17,38
481510,8,Very Positive,5002,300,5302
481600,6,Mostly Positive,17,7,24
481870,6,Mostly Positive,186,49,235
481890,2,Very Negative,57,244,301
482120,5,Mixed,214,93,307
482300,6,Mostly Positive,403,124,527
482330,6,Mostly Positive,37,10,47
482450,8,Very Positive,320,32,352
482990,7,Positive,32,1,33
483420,8,Very Positive,418,32,450
483490,0,4 user reviews,3,1,4
483770,4,Mostly Negative,74,148,222
483820,0,3 user reviews,3,0,3
483960,5,Mixed,160,77,237
483980,9,Overwhelmingly Positive,826,28,854
484350,6,Mostly Positive,149,50,199
484390,7,Positive,16,0,16
484830,7,Positive,25,6,31
484890,0,6 user reviews,4,2,6
484900,6,Mostly Positive,516,189,705
484930,7,Positive,38,2,40
484950,6,Mostly Positive,705,218,923
484990,0,2 user reviews,2,0,2
485030,0,No user reviews,0,0,0
485040,8,Very Positive,400,26,426
485080,5,Mixed,49,22,71
485160,7,Positive,27,3,30
485220,5,Mixed,137,84,221
485260,7,Positive,31,4,35
485340,6,Mostly Positive,12,5,17
485350,8,Very Positive,338,64,402
485360,8,Very Positive,45,8,53
485370,5,Mixed,199,90,289
485380,8,Very Positive,1112,225,1337
485390,8,Very Positive,87,16,103
485430,5,Mixed,7,5,12
485450,5,Mixed,132,68,200
485460,0,No user reviews,0,0,0
485510,8,Very Positive,7030,1568,8598
485600,7,Positive,31,3,34
485610,6,Mostly Positive,1430,485,1915
485620,6,Mostly Positive,29,10,39
485630,5,Mixed,17,22,39
485650,5,Mixed,140,175,315
485670,5,Mixed,9,11,20
485680,7,Positive,23,1,24
485690,6,Mostly Positive,218,69,287
485730,6,Mostly Positive,117,46,163
485740,5,Mixed,56,36,92
485750,5,Mixed,11,6,17
485790,0,7 user reviews,5,2,7
485800,6,Mostly Positive,57,19,76
485860,6,Mostly Positive,154,58,212
485870,6,Mostly Positive,256,69,325
485890,5,Mixed,497,343,840
485920,7,Positive,28,5,33
485970,7,Positive,32,2,34
485980,8,Very Positive,1353,183,1536
486120,5,Mixed,23,13,36
486130,5,Mixed,12,8,20
486230,0,7 user reviews,6,1,7
486290,7,Positive,25,2,27
486310,8,Very Positive,3065,361,3426
486350,7,Positive,14,2,16
486380,8,Very Positive,52,1,53
486430,0,2 user reviews,2,0,2
486460,5,Mixed,27,24,51
486470,5,Mixed,9,9,18
486500,5,Mixed,18,9,27
486510,8,Very Positive,190,42,232
486540,6,Mostly Positive,123,48,171
486550,0,5 user reviews,3,2,5
486630,0,7 user reviews,6,1,7
486640,5,Mixed,10,9,19
486690,6,Mostly Positive,447,138,585
486720,8,Very Positive,273,32,305
486760,0,2 user reviews,0,2,2
486780,8,Very Positive,387,55,442
486810,7,Positive,21,4,25
486820,5,Mixed,351,386,737
486850,6,Mostly Positive,55,15,70
486880,4,Mostly Negative,45,82,127
486890,0,4 user reviews,3,1,4
486940,7,Positive,10,0,10
486990,5,Mixed,8,9,17
487000,8,Very Positive,190,44,234
487030,6,Mostly Positive,50,18,68
487040,7,Positive,16,3,19
487120,5,Mixed,1880,1058,2938
487160,8,Very Positive,53,5,58
487180,6,Mostly Positive,143,61,204
487220,6,Mostly Positive,846,280,1126
487330,8,Very Positive,66,15,81
487350,5,Mixed,72,44,116
487370,8,Very Positive,140,19,159
487380,7,Positive,11,2,13
487430,8,Very Positive,1023,98,1121
487530,8,Very Positive,54,12,66
487630,5,Mixed,28,14,42
487720,5,Mixed,787,872,1659
487730,7,Positive,10,0,10
487740,0,6 user reviews,2,4,6
487770,8,Very Positive,44,9,53
488020,0,4 user reviews,2,2,4
488040,7,Positive,43,4,47
488070,5,Mixed,6,4,10
488080,0,2 user reviews,1,1,2
488220,6,Mostly Positive,15,5,20
488280,8,Very Positive,415,42,457
488300,8,Very Positive,163,27,190
488330,5,Mixed,10,5,15
488460,6,Mostly Positive,17,6,23
488500,0,4 user reviews,3,1,4
488660,8,Very Positive,147,32,179
488690,8,Very Positive,57,12,69
488730,0,No user reviews,0,0,0
488760,8,Very Positive,96,15,111
488770,8,Very Positive,147,32,179
488790,5,Mixed,3558,1533,5091
488910,5,Mixed,147,65,212
488920,8,Very Positive,166,35,201
488960,7,Positive,36,2,38
489000,5,Mixed,95,51,146
489050,4,Mostly Negative,3,7,10
489080,0,5 user reviews,3,2,5
489110,7,Positive,27,0,27
489120,0,9 user reviews,9,0,9
489140,8,Very Positive,678,93,771
489160,7,Positive,11,2,13
489170,5,Mixed,110,51,161
489260,6,Mostly Positive,50,16,66
489360,8,Very Positive,555,104,659
489380,8,Very Positive,365,29,394
489400,6,Mostly Positive,12,5,17
489440,6,Mostly Positive,27,8,35
489460,6,Mostly Positive,296,83,379
489520,8,Very Positive,4847,909,5756
489570,6,Mostly Positive,32,13,45
489580,6,Mostly Positive,50,17,67
489610,8,Very Positive,370,17,387
489660,8,Very Positive,98,10,108
489720,7,Positive,35,3,38
489730,0,4 user reviews,1,3,4
489760,7,Positive,29,3,32
489830,6,Mostly Positive,36579,11540,48119
489930,6,Mostly Positive,38,15,53
490040,0,8 user reviews,8,0,8
490080,5,Mixed,19,20,39
490100,7,Positive,25,0,25
490220,8,Very Positive,430,81,511
490230,8,Very Positive,278,26,304
490250,7,Positive,17,3,20
490280,8,Very Positive,78,6,84
490300,6,Mostly Positive,17,7,24
490360,0,No user reviews,0,0,0
490450,6,Mostly Positive,226,70,296
490490,8,Very Positive,141,14,155
490690,6,Mostly Positive,17,7,24
490820,8,Very Positive,223,48,271
490860,6,Mostly Positive,27,8,35
490870,8,Very Positive,69,14,83
490880,7,Positive,32,6,38
490910,5,Mixed,6,9,15
490950,8,Very Positive,66,3,69
490980,6,Mostly Positive,80,21,101
491000,8,Very Positive,261,45,306
491010,7,Positive,17,2,19
491030,5,Mixed,23,10,33
491040,9,Overwhelmingly Positive,557,22,579
491060,7,Positive,13,2,15
491080,5,Mixed,207,118,325
491090,5,Mixed,79,55,134
491100,0,9 user reviews,8,1,9
491130,8,Very Positive,1435,154,1589
491160,6,Mostly Positive,73,22,95
491180,0,No user reviews,0,0,0
491220,8,Very Positive,97,10,107
491240,7,Positive,16,0,16
491260,5,Mixed,122,73,195
491330,8,Very Positive,210,22,232
491350,7,Positive,24,1,25
491390,0,9 user reviews,9,0,9
491420,8,Very Positive,232,17,249
491530,5,Mixed,534,363,897
491560,5,Mixed,12,9,21
491620,6,Mostly Positive,54,14,68
491650,5,Mixed,109,48,157
491660,6,Mostly Positive,9,3,12
491670,7,Positive,13,3,16
491700,7,Positive,16,3,19
491710,3,Negative,2,10,12
491720,7,Positive,21,5,26
491770,4,Mostly Negative,51,114,165
491830,6,Mostly Positive,17,5,22
491950,8,Very Positive,4050,318,4368
492090,6,Mostly Positive,39,12,51
492100,0,No user reviews,0,0,0
492130,8,Very Positive,265,56,321
492150,6,Mostly Positive,214,63,277
492170,5,Mixed,37,17,54
492180,7,Positive,23,1,24
492200,7,Positive,17,0,17
492220,6,Mostly Positive,100,27,127
492230,0,No user reviews,0,0,0
492270,8,Very Positive,169,34,203
492280,7,Positive,16,4,20
492290,6,Mostly Positive,206,63,269
492340,8,Very Positive,191,15,206
492370,6,Mostly Positive,37,11,48
492400,0,5 user reviews,4,1,5
492430,6,Mostly Positive,70,29,99
492500,6,Mostly Positive,150,46,196
492600,5,Mixed,11,9,20
492610,4,Mostly Negative,6,13,19
492630,8,Very Positive,564,74,638
492710,8,Very Positive,98,19,117
492720,0,No user reviews,0,0,0
492800,5,Mixed,205,160,365
492860,0,1 user reviews,1,0,1
492870,6,Mostly Positive,42,13,55
493000,0,9 user reviews,7,2,9
493080,8,Very Positive,104,5,109
493100,7,Positive,28,5,33
493110,0,6 user reviews,5,1,6
493180,8,Very Positive,46,8,54
493200,8,Very Positive,1485,150,1635
493220,6,Mostly Positive,30,9,39
493280,8,Very Positive,59,14,73
493340,8,Very Positive,18366,2076,20442
493370,6,Mostly Positive,659,274,933
493380,5,Mixed,9,4,13
493480,5,Mixed,7,10,17
493500,0,9 user reviews,1,8,9
493540,8,Very Positive,163,10,173
493620,7,Positive,10,2,12
493650,4,Mostly Negative,74,188,262
493720,6,Mostly Positive,132,42,174
493730,6,Mostly Positive,125,37,162
493760,5,Mixed,29,31,60
493780,5,Mixed,16,7,23
493790,5,Mixed,13,6,19
493820,6,Mostly Positive,28,8,36
493840,5,Mixed,746,548,1294
493900,8,Very Positive,4668,246,4914
493980,6,Mostly Positive,22,7,29
494100,7,Positive,46,1,47
494160,0,8 user reviews,5,3,8
494170,7,Positive,27,4,31
494230,8,Very Positive,486,35,521
494290,4,Mostly Negative,16,31,47
494320,5,Mixed,75,42,117
494350,5,Mixed,7,9,16
494440,5,Mixed,41,22,63
494450,5,Mixed,25,26,51
494460,5,Mixed,19,22,41
494470,5,Mixed,30,25,55
494580,6,Mostly Positive,68,26,94
494600,8,Very Positive,92,22,114
494670,5,Mixed,127,119,246
494700,7,Positive,35,4,39
494810,8,Very Positive,171,27,198
494850,0,3 user reviews,2,1,3
494960,8,Very Positive,67,8,75
494980,5,Mixed,6,8,14
494990,6,Mostly Positive,15,5,20
495010,4,Mostly Negative,17,29,46
495050,8,Very Positive,252,47,299
495090,6,Mostly Positive,31,11,42
495110,8,Very Positive,346,27,373
495120,6,Mostly Positive,27,9,36
495140,5,Mixed,308,189,497
495200,0,2 user reviews,2,0,2
495280,8,Very Positive,490,47,537
495350,6,Mostly Positive,165,61,226
495390,0,7 user reviews,4,3,7
495570,6,Mostly Positive,28,12,40
495580,5,Mixed,79,58,137
495680,7,Positive,23,3,26
495720,8,Very Positive,111,18,129
495730,4,Mostly Negative,2,8,10
495750,7,Positive,12,1,13
495820,7,Positive,12,2,14
495890,9,Overwhelmingly Positive,8446,403,8849
495910,6,Mostly Positive,1388,408,1796
495960,5,Mixed,21,12,33
495980,6,Mostly Positive,81,22,103
495990,8,Very Positive,666,127,793
496030,0,5 user reviews,5,0,5
496040,6,Mostly Positive,23,9,32
496230,0,9 user reviews,5,4,9
496250,8,Very Positive,195,24,219
496260,8,Very Positive,143,9,152
496290,7,Positive,29,7,36
496300,8,Very Positive,3407,538,3945
496320,7,Positive,12,2,14
496340,6,Mostly Positive,59,17,76
496390,7,Positive,16,2,18
496400,5,Mixed,25,13,38
496450,7,Positive,39,5,44
496460,5,Mixed,1776,885,2661
496480,7,Positive,14,3,17
496490,5,Mixed,35,29,64
496500,5,Mixed,127,188,315
496520,0,2 user reviews,1,1,2
496540,0,8 user reviews,8,0,8
496590,7,Positive,21,4,25
496610,0,5 user reviews,2,3,5
496620,8,Very Positive,444,84,528
496630,8,Very Positive,49,6,55
496660,5,Mixed,9,8,17
496670,0,9 user reviews,7,2,9
496680,5,Mixed,161,187,348
496730,5,Mixed,116,71,187
496790,0,5 user reviews,4,1,5
496810,8,Very Positive,849,97,946
496850,7,Positive,10,2,12
496870,5,Mixed,82,45,127
496890,8,Very Positive,2044,274,2318
496930,8,Very Positive,97,22,119
496940,0,1 user reviews,1,0,1
496960,5,Mixed,9,4,13
496980,7,Positive,9,2,11
497000,0,9 user reviews,5,4,9
497020,5,Mixed,15,16,31
497040,6,Mostly Positive,30,11,41
497060,0,5 user reviews,2,3,5
497080,8,Very Positive,50,12,62
497100,5,Mixed,53,24,77
497180,8,Very Positive,917,220,1137
497190,0,9 user reviews,8,1,9
497300,0,9 user reviews,5,4,9
497350,4,Mostly Negative,62,112,174
497400,6,Mostly Positive,288,83,371
497420,7,Positive,22,4,26
497430,0,9 user reviews,6,3,9
497460,8,Very Positive,49,1,50
497470,5,Mixed,20,22,42
497510,7,Positive,10,1,11
497580,5,Mixed,72,31,103
497640,9,Overwhelmingly Positive,1289,49,1338
497680,6,Mostly Positive,33,9,42
497700,8,Very Positive,116,17,133
497710,5,Mixed,9,5,14
497720,5,Mixed,22,26,48
497730,8,Very Positive,147,23,170
497780,8,Very Positive,125,1,126
497790,0,6 user reviews,6,0,6
497800,8,Very Positive,67,1,68
497850,8,Very Positive,299,62,361
497960,0,No user reviews,0,0,0
498190,6,Mostly Positive,116,33,149
498240,6,Mostly Positive,5119,1615,6734
498320,4,Mostly Negative,46,97,143
498330,8,Very Positive,353,41,394
498340,5,Mixed,50,25,75
498370,0,3 user reviews,0,3,3
498380,0,8 user reviews,8,0,8
498470,7,Positive,33,1,34
498500,8,Very Positive,387,76,463
498570,8,Very Positive,123,25,148
498580,6,Mostly Positive,23,9,32
498660,8,Very Positive,314,78,392
498680,7,Positive,10,2,12
498710,6,Mostly Positive,81,31,112
498720,0,9 user reviews,8,1,9
498740,6,Mostly Positive,29,8,37
498830,7,Positive,26,6,32
498840,0,5 user reviews,3,2,5
498850,6,Mostly Positive,19,6,25
498990,6,Mostly Positive,38,12,50
499140,7,Positive,15,0,15
499210,3,Negative,2,10,12
499340,7,Positive,38,2,40
499440,9,Overwhelmingly Positive,3065,79,3144
499450,0,No user reviews,0,0,0
499510,0,4 user reviews,4,0,4
499520,8,Very Positive,2312,357,2669
499540,8,Very Positive,62,10,72
499560,0,9 user reviews,4,5,9
499610,6,Mostly Positive,39,16,55
499620,8,Very Positive,181,44,225
499660,8,Very Positive,734,145,879
499890,8,Very Positive,188,10,198
499900,5,Mixed,9,4,13
499910,7,Positive,43,1,44
500090,0,No user reviews,0,0,0
500150,6,Mostly Positive,42,18,60
500170,5,Mixed,20,20,40
500180,7,Positive,9,1,10
500260,8,Very Positive,378,74,452
500320,6,Mostly Positive,20,6,26
500350,0,9 user reviews,8,1,9
500420,8,Very Positive,47,10,57
500440,0,7 user reviews,5,2,7
500660,5,Mixed,15,11,26
500670,8,Very Positive,240,27,267
500690,7,Positive,28,3,31
500710,5,Mixed,519,326,845
500790,7,Positive,17,1,18
500870,6,Mostly Positive,110,29,139
500880,0,8 user reviews,8,0,8
500940,7,Positive,16,4,20
501080,6,Mostly Positive,506,188,694
501110,6,Mostly Positive,48,17,65
501120,8,Very Positive,289,31,320
501190,6,Mostly Positive,85,26,111
501220,5,Mixed,27,19,46
501300,9,Overwhelmingly Positive,6905,310,7215
501310,0,9 user reviews,7,2,9
501320,6,Mostly Positive,351,142,493
501440,5,Mixed,11,5,16
501530,7,Positive,16,1,17
501590,8,Very Positive,650,144,794
501740,5,Mixed,21,16,37
501790,8,Very Positive,78,3,81
501830,5,Mixed,30,33,63
501860,5,Mixed,36,20,56
501920,5,Mixed,66,37,103
501930,6,Mostly Positive,53,14,67
501940,5,Mixed,24,12,36
501950,6,Mostly Positive,44,13,57
502070,0,2 user reviews,2,0,2
502100,5,Mixed,22,16,38
502140,5,Mixed,94,88,182
502150,7,Positive,21,3,24
502200,5,Mixed,7,6,13
502210,7,Positive,36,8,44
502280,6,Mostly Positive,807,206,1013
502300,5,Mixed,27,19,46
502320,6,Mostly Positive,36,11,47
502380,6,Mostly Positive,26,7,33
502400,6,Mostly Positive,128,49,177
502410,4,Mostly Negative,7,20,27
502420,4,Mostly Negative,12,26,38
502430,4,Mostly Negative,3,7,10
502440,4,Mostly Negative,4,7,11
502450,3,Negative,2,15,17
502520,8,Very Positive,2027,290,2317
502540,7,Positive,9,2,11
502600,7,Positive,9,2,11
502650,6,Mostly Positive,22,6,28
502700,7,Positive,18,1,19
502720,6,Mostly Positive,16,6,22
502730,0,3 user reviews,3,0,3
502740,8,Very Positive,192,24,216
502770,6,Mostly Positive,325,105,430
502780,0,7 user reviews,5,2,7
502800,9,Overwhelmingly Positive,2128,84,2212
502810,5,Mixed,11,8,19
502820,6,Mostly Positive,530,169,699
502880,4,Mostly Negative,22,64,86
502920,7,Positive,13,0,13
502940,8,Very Positive,427,65,492
503140,6,Mostly Positive,15,4,19
503180,8,Very Positive,56,4,60
503210,8,Very Positive,69,17,86
503290,0,7 user reviews,4,3,7
503300,8,Very Positive,2485,605,3090
503340,8,Very Positive,95,4,99
503350,8,Very Positive,1370,295,1665
503400,8,Very Positive,169,6,175
503420,5,Mixed,8,10,18
503430,0,5 user reviews,0,5,5
503450,5,Mixed,28,25,53
503460,8,Very Positive,119,7,126
503480,5,Mixed,70,34,104
503490,0,No user reviews,0,0,0
503550,7,Positive,32,8,40
503560,8,Very Positive,2696,540,3236
503580,8,Very Positive,339,54,393
503620,6,Mostly Positive,168,68,236
503650,7,Positive,10,0,10
503680,5,Mixed,6,4,10
503690,0,6 user reviews,5,1,6
503750,0,No user reviews,0,0,0
503770,8,Very Positive,208,24,232
503860,7,Positive,30,2,32
503940,8,Very Positive,1988,401,2389
503950,7,Positive,33,7,40
503960,6,Mostly Positive,26,7,33
503980,7,Positive,8,2,10
504000,8,Very Positive,65,3,68
504010,5,Mixed,22,12,34
504050,5,Mixed,627,276,903
504090,7,Positive,23,1,24
504110,0,8 user reviews,6,2,8
504130,8,Very Positive,419,70,489
504210,9,Overwhelmingly Positive,1293,36,1329
504230,9,Overwhelmingly Positive,2258,50,2308
504240,0,4 user reviews,1,3,4
504260,0,8 user reviews,5,3,8
504280,5,Mixed,14,7,21
504310,6,Mostly Positive,72,25,97
504380,7,Positive,30,3,33
504390,8,Very Positive,177,9,186
504400,8,Very Positive,144,22,166
504420,6,Mostly Positive,19,5,24
504430,7,Positive,18,4,22
504450,5,Mixed,6,8,14
504460,8,Very Positive,61,15,76
504470,5,Mixed,6,8,14
504500,0,6 user reviews,4,2,6
504560,7,Positive,22,3,25
504620,0,6 user reviews,6,0,6
504810,5,Mixed,22,14,36
504840,0,8 user reviews,8,0,8
504850,7,Positive,10,2,12
504880,6,Mostly Positive,30,11,41
504920,8,Very Positive,50,2,52
505070,7,Positive,22,2,24
505080,5,Mixed,21,10,31
505090,5,Mixed,27,12,39
505110,0,9 user reviews,7,2,9
505120,5,Mixed,7,5,12
505140,0,9 user reviews,5,4,9
505170,6,Mostly Positive,1060,314,1374
505210,6,Mostly Positive,172,55,227
505270,0,6 user reviews,4,2,6
505290,0,3 user reviews,3,0,3
505330,8,Very Positive,57,13,70
505400,7,Positive,11,0,11
505550,5,Mixed,6,6,12
505630,8,Very Positive,203,29,232
505640,8,Very Positive,267,42,309
505730,5,Mixed,322,153,475
505750,5,Mixed,368,200,568
506090,7,Positive,12,2,14
506150,7,Positive,23,1,24
506260,6,Mostly Positive,27,7,34
506470,7,Positive,9,2,11
506500,6,Mostly Positive,389,151,540
506510,8,Very Positive,109,4,113
506560,0,1 user reviews,1,0,1
506570,0,4 user reviews,2,2,4
506590,5,Mixed,49,26,75
506730,5,Mixed,182,164,346
506760,4,Mostly Negative,9,16,25
506830,6,Mostly Positive,13,4,17
506840,5,Mixed,11,5,16
506870,8,Very Positive,378,15,393
506900,8,Very Positive,197,44,241
506980,0,3 user reviews,2,1,3
507010,6,Mostly Positive,1379,464,1843
507030,5,Mixed,10,5,15
507050,6,Mostly Positive,40,17,57
507060,7,Positive,16,1,17
507120,7,Positive,35,6,41
507340,0,7 user reviews,5,2,7
507360,0,9 user reviews,5,4,9
507490,6,Mostly Positive,1186,329,1515
508170,6,Mostly Positive,265,68,333
508180,6,Mostly Positive,103,44,147
508190,8,Very Positive,1429,350,1779
508200,6,Mostly Positive,7,3,10
508230,5,Mixed,34,16,50
508300,5,Mixed,76,40,116
508390,6,Mostly Positive,536,175,711
508520,5,Mixed,9,6,15
508530,6,Mostly Positive,90,38,128
508620,0,No user reviews,0,0,0
508650,0,No user reviews,0,0,0
508680,0,3 user reviews,2,1,3
508710,6,Mostly Positive,19,8,27
508730,6,Mostly Positive,11,3,14
508740,5,Mixed,48,25,73
508760,6,Mostly Positive,24,9,33
508790,8,Very Positive,213,23,236
508820,5,Mixed,24,13,37
508840,6,Mostly Positive,17,7,24
508900,8,Very Positive,288,17,305
508930,0,7 user reviews,3,4,7
508940,7,Positive,11,2,13
508980,8,Very Positive,482,53,535
508990,8,Very Positive,103,6,109
509000,6,Mostly Positive,18,6,24
509110,8,Very Positive,258,55,313
509160,7,Positive,23,1,24
509170,5,Mixed,7,7,14
509190,5,Mixed,30,27,57
509210,5,Mixed,29,13,42
509220,8,Very Positive,1160,130,1290
509250,8,Very Positive,333,26,359
509260,4,Mostly Negative,10,17,27
509290,6,Mostly Positive,24,9,33
509310,0,4 user reviews,3,1,4
509400,0,2 user reviews,2,0,2
509420,5,Mixed,219,101,320
509570,8,Very Positive,176,16,192
509580,0,No user reviews,0,0,0
509600,6,Mostly Positive,88,25,113
509620,7,Positive,8,2,10
509800,5,Mixed,142,98,240
509820,7,Positive,9,1,10
509880,5,Mixed,55,33,88
509920,0,3 user reviews,3,0,3
509960,5,Mixed,20,21,41
510040,7,Positive,23,1,24
510060,7,Positive,35,0,35
510240,7,Positive,34,5,39
510290,7,Positive,29,6,35
510360,6,Mostly Positive,14,6,20
510390,0,No user reviews,0,0,0
510420,0,No user reviews,0,0,0
510510,5,Mixed,712,485,1197
510520,8,Very Positive,69,6,75
510550,0,7 user reviews,4,3,7
510570,5,Mixed,29,18,47
510620,8,Very Positive,173,30,203
510650,6,Mostly Positive,73,19,92
510680,8,Very Positive,92,2,94
510710,0,3 user reviews,3,0,3
510740,7,Positive,19,4,23
510840,5,Mixed,21,12,33
510850,5,Mixed,36,18,54
510990,7,Positive,10,0,10
511010,5,Mixed,18,11,29
511070,5,Mixed,6,8,14
511090,8,Very Positive,171,26,197
511120,0,5 user reviews,4,1,5
511140,8,Very Positive,119,11,130
511160,6,Mostly Positive,79,27,106
511190,5,Mixed,19,13,32
511250,7,Positive,12,2,14
511330,5,Mixed,9,9,18
511350,8,Very Positive,126,6,132
511380,7,Positive,19,1,20
511390,0,7 user reviews,6,1,7
511430,5,Mixed,40,21,61
511460,6,Mostly Positive,10,4,14
511470,9,Overwhelmingly Positive,1262,24,1286
511490,5,Mixed,20,9,29
511500,7,Positive,29,6,35
511610,0,4 user reviews,3,1,4
511630,8,Very Positive,63,12,75
511670,5,Mixed,7,6,13
511680,8,Very Positive,2180,146,2326
511700,7,Positive,11,1,12
511740,8,Very Positive,1001,170,1171
511750,6,Mostly Positive,40,14,54
511820,7,Positive,13,2,15
511920,0,3 user reviews,2,1,3
512000,7,Positive,20,1,21
512020,5,Mixed,57,26,83
512070,0,No user reviews,0,0,0
512090,0,6 user reviews,3,3,6
512160,0,6 user reviews,6,0,6
512170,5,Mixed,47,26,73
512180,8,Very Positive,237,4,241
512230,8,Very Positive,130,12,142
512240,7,Positive,37,2,39
512250,8,Very Positive,2122,184,2306
512260,7,Positive,23,2,25
512300,8,Very Positive,320,62,382
512370,0,5 user reviews,5,0,5
512550,6,Mostly Positive,17,7,24
512560,5,Mixed,38,37,75
512680,0,8 user reviews,8,0,8
512720,0,No user reviews,0,0,0
512740,8,Very Positive,49,2,51
512770,5,Mixed,18,8,26
512790,8,Very Positive,781,54,835
512900,9,Overwhelmingly Positive,4163,208,4371
512920,0,5 user reviews,4,1,5
513210,6,Mostly Positive,33,12,45
513230,8,Very Positive,963,164,1127
513250,7,Positive,27,1,28
513300,7,Positive,17,1,18
513320,5,Mixed,56,64,120
513330,5,Mixed,85,61,146
513340,8,Very Positive,48,2,50
513370,5,Mixed,44,46,90
513440,5,Mixed,73,65,138
513450,8,Very Positive,889,103,992
513460,5,Mixed,19,25,44
513480,8,Very Positive,61,8,69
513510,8,Very Positive,1216,171,1387
513530,5,Mixed,43,64,107
513550,5,Mixed,37,20,57
513580,5,Mixed,16,7,23
513590,4,Mostly Negative,30,65,95
513620,5,Mixed,71,59,130
513630,5,Mixed,50,47,97
513650,5,Mixed,3097,1408,4505
513660,0,No user reviews,0,0,0
513680,0,9 user reviews,5,4,9
513780,6,Mostly Positive,863,252,1115
513820,6,Mostly Positive,25,7,32
513840,0,7 user reviews,6,1,7
513880,5,Mixed,37,16,53
513890,8,Very Positive,141,12,153
513920,0,8 user reviews,6,2,8
513960,7,Positive,10,0,10
513980,6,Mostly Positive,33,9,42
513990,5,Mixed,29,16,45
514090,8,Very Positive,79,12,91
514200,0,4 user reviews,3,1,4
514220,0,7 user reviews,4,3,7
514240,5,Mixed,50,58,108
514290,5,Mixed,43,44,87
514310,8,Very Positive,362,22,384
514340,8,Very Positive,47,5,52
514360,0,2 user reviews,1,1,2
514520,0,9 user reviews,6,3,9
514530,0,1 user reviews,1,0,1
514540,0,2 user reviews,2,0,2
514570,5,Mixed,5,7,12
514580,8,Very Positive,158,21,179
514620,8,Very Positive,158,5,163
514640,7,Positive,10,2,12
514650,7,Positive,35,5,40
514660,5,Mixed,104,45,149
514670,5,Mixed,37,23,60
514710,0,6 user reviews,0,6,6
514780,5,Mixed,7,7,14
514810,7,Positive,20,5,25
514820,0,8 user reviews,6,2,8
514830,0,No user reviews,0,0,0
514890,8,Very Positive,56,7,63
514900,8,Very Positive,1473,277,1750
514930,0,7 user reviews,4,3,7
514990,5,Mixed,50,28,78
515040,8,Very Positive,1317,175,1492
515180,6,Mostly Positive,800,297,1097
515220,8,Very Positive,2698,548,3246
515230,5,Mixed,16,9,25
515260,6,Mostly Positive,126,37,163
515470,5,Mixed,105,130,235
515570,8,Very Positive,132,10,142
515650,8,Very Positive,86,5,91
515690,5,Mixed,51,61,112
515740,7,Positive,12,3,15
515890,0,6 user reviews,6,0,6
515910,5,Mixed,77,34,111
515980,5,Mixed,22,27,49
516010,7,Positive,14,1,15
516030,0,No user reviews,0,0,0
516040,5,Mixed,11,7,18
516110,0,No user reviews,0,0,0
516120,7,Positive,9,1,10
516130,6,Mostly Positive,44,18,62
516410,6,Mostly Positive,20,7,27
516460,0,2 user reviews,1,1,2
516480,8,Very Positive,175,2,177
516580,7,Positive,35,3,38
516600,8,Very Positive,233,7,240
516750,8,Very Positive,9472,894,10366
516790,7,Positive,13,1,14
516840,7,Positive,44,4,48
516870,0,2 user reviews,1,1,2
516890,7,Positive,18,3,21
516920,5,Mixed,6,4,10
516940,7,Positive,18,3,21
516960,0,5 user reviews,4,1,5
517100,7,Positive,10,0,10
517110,6,Mostly Positive,11,3,14
517140,6,Mostly Positive,12,5,17
517190,0,1 user reviews,1,0,1
517210,7,Positive,10,0,10
517230,7,Positive,13,1,14
517240,0,9 user reviews,3,6,9
517280,0,No user reviews,0,0,0
517330,8,Very Positive,47,7,54
517350,8,Very Positive,51,9,60
517360,6,Mostly Positive,57,17,74
517370,8,Very Positive,111,27,138
517460,5,Mixed,19,10,29
517470,7,Positive,19,2,21
517510,0,9 user reviews,8,1,9
517620,7,Positive,8,2,10
517630,0,No user reviews,0,0,0
517660,0,9 user reviews,8,1,9
517680,6,Mostly Positive,18,7,25
517710,8,Very Positive,1989,280,2269
517720,6,Mostly Positive,102,34,136
517780,8,Very Positive,58,10,68
517860,0,8 user reviews,8,0,8
517910,8,Very Positive,611,41,652
517930,7,Positive,18,1,19
517970,7,Positive,16,1,17
518000,0,8 user reviews,8,0,8
518060,6,Mostly Positive,97,33,130
518100,5,Mixed,103,82,185
518120,6,Mostly Positive,98,32,130
518130,7,Positive,20,5,25
518140,0,8 user reviews,4,4,8
518320,6,Mostly Positive,19,8,27
518620,4,Mostly Negative,50,106,156
518650,7,Positive,22,2,24
518660,5,Mixed,286,231,517
518670,8,Very Positive,137,19,156
518720,8,Very Positive,154,37,191
518730,8,Very Positive,171,18,189
518740,0,1 user reviews,1,0,1
518790,8,Very Positive,11458,2821,14279
518920,5,Mixed,71,37,108
519020,5,Mixed,8,6,14
519080,8,Very Positive,195,21,216
519190,5,Mixed,3990,2079,6069
519490,0,9 user reviews,1,8,9
519870,0,7 user reviews,7,0,7
519990,3,Negative,2,10,12
520080,0,6 user reviews,3,3,6
520150,7,Positive,18,3,21
520230,0,6 user reviews,6,0,6
520290,5,Mixed,18,8,26
520300,0,2 user reviews,2,0,2
520370,0,7 user reviews,6,1,7
520380,5,Mixed,20,19,39
520440,8,Very Positive,1688,106,1794
520470,6,Mostly Positive,36,15,51
520530,5,Mixed,658,283,941
520540,0,No user reviews,0,0,0
520600,8,Very Positive,90,6,96
520610,7,Positive,31,6,37
520670,8,Very Positive,53,11,64
520680,0,8 user reviews,4,4,8
520720,6,Mostly Positive,467,163,630
520750,7,Positive,17,1,18
520850,8,Very Positive,128,8,136
520910,8,Very Positive,62,3,65
520930,7,Positive,14,1,15
520940,5,Mixed,169,109,278
520960,5,Mixed,47,21,68
521100,5,Mixed,23,17,40
521130,8,Very Positive,57,4,61
521140,0,3 user reviews,1,2,3
521200,9,Overwhelmingly Positive,628,30,658
521280,7,Positive,20,4,24
521300,0,3 user reviews,3,0,3
521340,5,Mixed,855,405,1260
521350,8,Very Positive,116,28,144
521510,0,5 user reviews,2,3,5
521540,7,Positive,20,3,23
521580,6,Mostly Positive,46,14,60
521590,5,Mixed,15,10,25
521630,8,Very Positive,229,45,274
521790,6,Mostly Positive,49,15,64
521890,5,Mixed,853,450,1303
521920,8,Very Positive,196,25,221
521940,6,Mostly Positive,60,21,81
522010,7,Positive,30,4,34
522020,8,Very Positive,94,22,116
522030,5,Mixed,67,35,102
522070,0,No user reviews,0,0,0
522080,5,Mixed,7,4,11
522090,4,Mostly Negative,45,84,129
522130,7,Positive,18,2,20
522200,4,Mostly Negative,10,21,31
522210,8,Very Positive,183,29,212
522220,7,Positive,15,3,18
522230,5,Mixed,108,53,161
522240,0,No user reviews,0,0,0
522250,5,Mixed,22,10,32
522340,7,Positive,27,1,28
522470,8,Very Positive,428,42,470
522490,8,Very Positive,77,2,79
522570,4,Mostly Negative,211,372,583
522710,7,Positive,17,0,17
522740,7,Positive,9,1,10
522880,7,Positive,30,2,32
522890,0,6 user reviews,6,0,6
522900,0,5 user reviews,5,0,5
522940,0,No user reviews,0,0,0
522990,7,Positive,16,2,18
523000,8,Very Positive,415,35,450
523060,0,4 user reviews,2,2,4
523070,5,Mixed,7,4,11
523090,7,Positive,43,6,49
523150,7,Positive,22,4,26
523160,6,Mostly Positive,68,22,90
523210,8,Very Positive,786,88,874
523550,0,5 user reviews,5,0,5
523610,5,Mixed,17,10,27
523650,6,Mostly Positive,368,128,496
523680,6,Mostly Positive,25,7,32
523720,7,Positive,13,0,13
523730,5,Mixed,37,16,53
523740,6,Mostly Positive,41,12,53
523750,0,8 user reviews,3,5,8
523760,7,Positive,22,5,27
523780,8,Very Positive,2417,156,2573
523810,6,Mostly Positive,43,14,57
523870,7,Positive,24,1,25
523880,0,4 user reviews,3,1,4
523900,0,2 user reviews,2,0,2
523960,7,Positive,26,6,32
524050,7,Positive,14,0,14
524200,5,Mixed,9,5,14
524220,8,Very Positive,29155,6972,36127
524340,5,Mixed,139,151,290
524350,0,1 user reviews,1,0,1
524430,0,6 user reviews,6,0,6
524540,7,Positive,26,4,30
524560,7,Positive,28,2,30
524580,8,Very Positive,1304,234,1538
524610,0,3 user reviews,0,3,3
524640,8,Very Positive,408,60,468
524660,6,Mostly Positive,127,35,162
524680,5,Mixed,31,15,46
524690,7,Positive,21,0,21
524850,8,Very Positive,291,36,327
524940,0,8 user reviews,6,2,8
524970,5,Mixed,230,292,522
525040,8,Very Positive,195,15,210
525070,7,Positive,12,2,14
525150,7,Positive,43,5,48
525190,5,Mixed,17,22,39
525240,5,Mixed,52,28,80
525290,5,Mixed,12,10,22
525300,5,Mixed,20,16,36
525330,0,5 user reviews,3,2,5
525350,5,Mixed,10,11,21
525360,6,Mostly Positive,786,224,1010
525370,6,Mostly Positive,35,10,45
525380,5,Mixed,98,45,143
525450,7,Positive,30,3,33
525460,0,5 user reviews,4,1,5
525480,8,Very Positive,822,92,914
525500,7,Positive,27,6,33
525510,8,Very Positive,501,37,538
525610,5,Mixed,82,58,140
525620,8,Very Positive,109,17,126
525680,8,Very Positive,114,11,125
525690,7,Positive,34,1,35
525700,5,Mixed,208,189,397
525740,7,Positive,18,1,19
525860,0,2 user reviews,2,0,2
525870,0,4 user reviews,3,1,4
525920,5,Mixed,178,97,275
526130,7,Positive,22,1,23
526140,8,Very Positive,194,25,219
526160,6,Mostly Positive,2268,792,3060
526290,6,Mostly Positive,31,9,40
526400,6,Mostly Positive,39,11,50
526430,5,Mixed,46,22,68
526460,5,Mixed,222,252,474
526490,8,Very Positive,88,3,91
526510,7,Positive,21,3,24
526540,5,Mixed,129,68,197
526590,5,Mixed,13,9,22
526740,5,Mixed,1077,694,1771
526780,7,Positive,12,0,12
526800,7,Positive,41,3,44
526890,0,7 user reviews,7,0,7
526920,8,Very Positive,94,19,113
526980,5,Mixed,14,14,28
527150,7,Positive,33,3,36
527210,6,Mostly Positive,14,6,20
527230,8,Very Positive,2839,525,3364
527240,5,Mixed,22,19,41
527260,0,7 user reviews,6,1,7
527270,8,Very Positive,931,117,1048
527280,6,Mostly Positive,308,132,440
527290,8,Very Positive,347,73,420
527320,7,Positive,12,0,12
527380,7,Positive,21,3,24
527420,8,Very Positive,55,9,64
527430,5,Mixed,2526,1165,3691
527460,5,Mixed,27,14,41
527470,8,Very Positive,47,8,55
527480,5,Mixed,128,58,186
527520,0,7 user reviews,1,6,7
527540,5,Mixed,24,23,47
527720,7,Positive,26,1,27
527730,5,Mixed,11,13,24
527740,7,Positive,36,5,41
527760,5,Mixed,108,95,203
527770,5,Mixed,79,87,166
527790,5,Mixed,17,15,32
527820,7,Positive,19,1,20
527990,6,Mostly Positive,85,33,118
528070,6,Mostly Positive,19,7,26
528080,4,Mostly Negative,18,34,52
528090,5,Mixed,64,53,117
528110,7,Positive,17,4,21
528120,5,Mixed,9,4,13
528160,6,Mostly Positive,179,62,241
528170,5,Mixed,15,8,23
528180,5,Mixed,7,7,14
528250,7,Positive,24,5,29
528260,8,Very Positive,54,9,63
528270,7,Positive,28,3,31
528300,6,Mostly Positive,125,38,163
528420,0,5 user reviews,5,0,5
528430,6,Mostly Positive,51,15,66
528450,5,Mixed,8,5,13
528460,6,Mostly Positive,193,72,265
528510,5,Mixed,157,76,233
528610,5,Mixed,301,166,467
528660,6,Mostly Positive,226,60,286
528670,0,9 user reviews,8,1,9
528720,8,Very Positive,98,20,118
528730,5,Mixed,31,19,50
528740,5,Mixed,98,145,243
528770,7,Positive,13,1,14
528820,5,Mixed,64,47,111
528860,7,Positive,11,0,11
528950,7,Positive,12,1,13
528980,0,9 user reviews,8,1,9
528990,7,Positive,11,1,12
529130,5,Mixed,40,20,60
529150,8,Very Positive,316,7,323
529160,8,Very Positive,209,22,231
529180,5,Mixed,3871,3343,7214
529240,5,Mixed,102,120,222
529280,5,Mixed,9,9,18
529360,6,Mostly Positive,27,7,34
529410,7,Positive,30,5,35
529420,5,Mixed,7,5,12
529440,8,Very Positive,280,25,305
529480,6,Mostly Positive,37,13,50
529490,5,Mixed,49,23,72
529500,5,Mixed,23,12,35
529520,8,Very Positive,281,14,295
529580,7,Positive,9,2,11
529590,8,Very Positive,120,15,135
529660,8,Very Positive,364,36,400
529730,0,5 user reviews,2,3,5
529760,4,Mostly Negative,76,170,246
529780,8,Very Positive,1092,79,1171
529840,6,Mostly Positive,484,189,673
529870,7,Positive,29,5,34
529900,8,Very Positive,95,15,110
529910,5,Mixed,100,87,187
529920,5,Mixed,11,5,16
529940,0,7 user reviews,4,3,7
529950,8,Very Positive,153,22,175
530010,0,2 user reviews,2,0,2
530020,6,Mostly Positive,150,40,190
530040,5,Mixed,102,79,181
530070,5,Mixed,1192,601,1793
530300,0,4 user reviews,3,1,4
530320,0,No user reviews,0,0,0
530370,7,Positive,21,1,22
530390,9,Overwhelmingly Positive,503,16,519
530510,7,Positive,33,4,37
530540,5,Mixed,32,25,57
530560,5,Mixed,230,260,490
530630,5,Mixed,193,114,307
530650,0,6 user reviews,4,2,6
530680,0,3 user reviews,1,2,3
530740,6,Mostly Positive,12,4,16
530820,5,Mixed,5,5,10
530830,7,Positive,8,2,10
530890,8,Very Positive,2026,358,2384
530930,6,Mostly Positive,26,9,35
530940,5,Mixed,59,32,91
530950,6,Mostly Positive,215,71,286
530960,5,Mixed,72,36,108
531110,7,Positive,15,3,18
531180,7,Positive,31,2,33
531240,5,Mixed,14,12,26
531270,6,Mostly Positive,218,88,306
531480,7,Positive,14,2,16
531510,8,Very Positive,463,9,472
531530,8,Very Positive,84,11,95
531540,6,Mostly Positive,32,10,42
531640,6,Mostly Positive,2499,648,3147
531680,8,Very Positive,182,39,221
531730,8,Very Positive,97,4,101
531740,6,Mostly Positive,45,14,59
531780,6,Mostly Positive,11,4,15
531890,6,Mostly Positive,73,26,99
531910,7,Positive,28,3,31
531930,6,Mostly Positive,205,52,257
531960,6,Mostly Positive,629,183,812
531990,7,Positive,33,1,34
532030,5,Mixed,41,37,78
532070,0,1 user reviews,1,0,1
532110,9,Overwhelmingly Positive,1512,71,1583
532120,7,Positive,14,1,15
532170,7,Positive,32,3,35
532190,8,Very Positive,278,26,304
532210,0,No user reviews,0,0,0
532270,8,Very Positive,84,10,94
532290,8,Very Positive,81,17,98
532320,8,Very Positive,64,3,67
532470,0,9 user reviews,9,0,9
532660,5,Mixed,14,13,27
532690,6,Mostly Positive,10,4,14
532700,5,Mixed,9,5,14
532840,8,Very Positive,738,172,910
532890,0,8 user reviews,5,3,8
532900,0,5 user reviews,5,0,5
532920,5,Mixed,13,6,19
532980,7,Positive,30,0,30
533010,6,Mostly Positive,47,17,64
533120,8,Very Positive,1289,272,1561
533150,5,Mixed,174,89,263
533180,4,Mostly Negative,11,31,42
533260,6,Mostly Positive,14,6,20
533300,8,Very Positive,4876,306,5182
533320,5,Mixed,15,13,28
533330,5,Mixed,39,32,71
533480,6,Mostly Positive,101,35,136
533540,5,Mixed,768,402,1170
533580,7,Positive,36,3,39
533620,4,Mostly Negative,106,178,284
533660,0,8 user reviews,3,5,8
533690,6,Mostly Positive,160,64,224
533820,6,Mostly Positive,64,24,88
533860,4,Mostly Negative,34,52,86
533890,5,Mixed,13,6,19
533950,8,Very Positive,117,18,135
534190,7,Positive,42,7,49
534200,6,Mostly Positive,12,4,16
534210,0,9 user reviews,2,7,9
534220,5,Mixed,247,127,374
534230,8,Very Positive,68,15,83
534240,0,1 user reviews,1,0,1
534290,8,Very Positive,237,41,278
534320,5,Mixed,6,6,12
534370,5,Mixed,412,198,610
534430,0,6 user reviews,4,2,6
534440,7,Positive,19,4,23
534550,0,No user reviews,0,0,0
534560,0,5 user reviews,5,0,5
534570,5,Mixed,25,14,39
534680,7,Positive,10,1,11
534780,8,Very Positive,105,8,113
534910,5,Mixed,19,10,29
534920,0,5 user reviews,3,2,5
534960,5,Mixed,22,10,32
534980,0,8 user reviews,5,3,8
535000,7,Positive,23,1,24
535010,0,4 user reviews,3,1,4
535160,7,Positive,35,3,38
535170,5,Mixed,17,15,32
535230,8,Very Positive,3336,480,3816
535240,0,3 user reviews,3,0,3
535380,7,Positive,10,1,11
535400,8,Very Positive,128,21,149
535410,7,Positive,27,4,31
535440,4,Mostly Negative,6,16,22
535480,6,Mostly Positive,670,174,844
535490,5,Mixed,103,68,171
535520,6,Mostly Positive,282,78,360
535630,7,Positive,27,6,33
535690,6,Mostly Positive,79,20,99
535700,5,Mixed,23,10,33
535750,6,Mostly Positive,7,3,10
535840,7,Positive,10,0,10
535850,4,Mostly Negative,86,276,362
535890,7,Positive,13,3,16
535910,7,Positive,19,1,20
535930,0,No user reviews,0,0,0
535980,7,Positive,31,2,33
536040,5,Mixed,44,20,64
536050,0,No user reviews,0,0,0
536220,6,Mostly Positive,5776,1809,7585
536320,5,Mixed,16,23,39
536370,0,4 user reviews,3,1,4
536410,5,Mixed,27,14,41
536430,7,Positive,22,5,27
536450,6,Mostly Positive,33,10,43
536460,0,No user reviews,0,0,0
536470,7,Positive,16,0,16
536490,7,Positive,18,4,22
536530,5,Mixed,10,7,17
536560,8,Very Positive,46,6,52
536630,5,Mixed,14,14,28
536640,5,Mixed,31,36,67
536660,5,Mixed,41,36,77
536670,0,No user reviews,0,0,0
536690,7,Positive,11,1,12
536750,7,Positive,32,8,40
536770,7,Positive,22,0,22
536780,8,Very Positive,57,8,65
536800,0,7 user reviews,2,5,7
536920,0,3 user reviews,2,1,3
536930,5,Mixed,2116,924,3040
536990,8,Very Positive,59,12,71
537000,6,Mostly Positive,39,13,52
537020,0,4 user reviews,4,0,4
537100,8,Very Positive,68,13,81
537200,5,Mixed,22,16,38
537380,0,2 user reviews,2,0,2
537430,5,Mixed,110,128,238
537520,5,Mixed,62,45,107
537740,5,Mixed,23,14,37
537760,0,7 user reviews,6,1,7
537800,8,Very Positive,2739,318,3057
537990,5,Mixed,300,168,468
538050,0,9 user reviews,4,5,9
538060,5,Mixed,45,38,83
538070,8,Very Positive,259,16,275
538100,8,Very Positive,1113,129,1242
538170,0,8 user reviews,6,2,8
538390,0,3 user reviews,2,1,3
538490,0,3 user reviews,1,2,3
538510,0,3 user reviews,1,2,3
538550,7,Positive,17,4,21
538590,4,Mostly Negative,68,123,191
538680,9,Overwhelmingly Positive,1551,59,1610
538710,7,Positive,31,1,32
538790,5,Mixed,7,10,17
538840,8,Very Positive,72,16,88
538920,5,Mixed,11,13,24
538950,7,Positive,31,6,37
538990,5,Mixed,26,17,43
539270,7,Positive,26,5,31
539280,0,7 user reviews,3,4,7
539290,0,7 user reviews,3,4,7
539300,5,Mixed,6,9,15
539340,8,Very Positive,59,5,64
539370,7,Positive,24,5,29
539380,6,Mostly Positive,52,16,68
539400,8,Very Positive,81,4,85
539450,5,Mixed,128,55,183
539460,7,Positive,19,3,22
539560,0,8 user reviews,5,3,8
539640,5,Mixed,130,99,229
539670,8,Very Positive,178,23,201
539700,8,Very Positive,72,9,81
539720,8,Very Positive,361,47,408
539750,6,Mostly Positive,47,16,63
540010,0,9 user reviews,8,1,9
540020,5,Mixed,46,59,105
540060,8,Very Positive,42,10,52
540100,5,Mixed,98,51,149
540150,5,Mixed,6,4,10
540190,0,8 user reviews,7,1,8
540230,0,9 user reviews,8,1,9
540250,0,5 user reviews,2,3,5
540410,7,Positive,14,0,14
540550,5,Mixed,8,8,16
540610,8,Very Positive,962,144,1106
540640,6,Mostly Positive,13,5,18
540660,7,Positive,13,3,16
540690,5,Mixed,23,15,38
540770,0,No user reviews,0,0,0
540780,7,Positive,24,0,24
540840,8,Very Positive,828,87,915
540880,8,Very Positive,83,6,89
540900,5,Mixed,80,92,172
541160,7,Positive,10,2,12
541200,8,Very Positive,47,4,51
541230,8,Very Positive,285,45,330
541240,7,Positive,21,2,23
541300,5,Mixed,578,535,1113
541310,0,No user reviews,0,0,0
541370,4,Mostly Negative,93,217,310
541380,4,Mostly Negative,15,24,39
541450,5,Mixed,42,20,62
541570,9,Overwhelmingly Positive,726,30,756
541720,5,Mixed,18,13,31
541960,0,1 user reviews,1,0,1
542030,7,Positive,32,1,33
542050,8,Very Positive,118,5,123
542100,0,4 user reviews,2,2,4
542200,8,Very Positive,96,5,101
542220,7,Positive,23,0,23
542260,8,Very Positive,303,16,319
542290,7,Positive,38,1,39
542340,5,Mixed,528,560,1088
542350,8,Very Positive,106,22,128
542400,8,Very Positive,96,24,120
542550,5,Mixed,31,15,46
542570,7,Positive,16,3,19
542660,8,Very Positive,73,12,85
542680,5,Mixed,7,7,14
542910,0,6 user reviews,3,3,6
542930,4,Mostly Negative,6,10,16
543010,5,Mixed,120,66,186
543070,7,Positive,20,1,21
543140,8,Very Positive,405,92,497
543180,5,Mixed,70,47,117
543240,8,Very Positive,187,35,222
543260,8,Very Positive,738,70,808
543320,6,Mostly Positive,35,15,50
543360,5,Mixed,49,37,86
543390,6,Mostly Positive,112,34,146
543410,6,Mostly Positive,10,3,13
543430,5,Mixed,14,8,22
543440,7,Positive,17,1,18
543460,5,Mixed,1024,1186,2210
543540,0,7 user reviews,4,3,7
543650,5,Mixed,19,16,35
543710,6,Mostly Positive,11,3,14
543740,0,4 user reviews,2,2,4
543870,8,Very Positive,181,38,219
543900,5,Mixed,1847,1014,2861
543910,0,2 user reviews,2,0,2
543920,0,3 user reviews,1,2,3
543930,8,Very Positive,212,16,228
543940,0,4 user reviews,4,0,4
543980,8,Very Positive,65,7,72
544180,8,Very Positive,166,1,167
544190,7,Positive,38,8,46
544310,8,Very Positive,50,2,52
544330,8,Very Positive,642,146,788
544400,7,Positive,15,0,15
544530,7,Positive,38,3,41
544550,8,Very Positive,878,172,1050
544580,7,Positive,35,6,41
544600,8,Very Positive,68,9,77
544610,6,Mostly Positive,475,121,596
544630,4,Mostly Negative,20,32,52
544650,7,Positive,17,4,21
544680,4,Mostly Negative,15,23,38
544710,7,Positive,19,2,21
544730,5,Mixed,322,470,792
544790,6,Mostly Positive,29,8,37
544800,5,Mixed,7,10,17
544840,6,Mostly Positive,37,14,51
544870,5,Mixed,17,16,33
544970,8,Very Positive,180,6,186
545030,7,Positive,46,2,48
545050,5,Mixed,128,83,211
545060,7,Positive,17,2,19
545180,8,Very Positive,59,8,67
545200,5,Mixed,11,8,19
545270,6,Mostly Positive,769,314,1083
545320,5,Mixed,18,23,41
545330,5,Mixed,13,19,32
545410,5,Mixed,60,27,87
545430,8,Very Positive,58,5,63
545540,8,Very Positive,159,31,190
545570,5,Mixed,19,14,33
545580,6,Mostly Positive,97,41,138
545590,7,Positive,48,0,48
545620,0,No user reviews,0,0,0
545650,5,Mixed,377,460,837
545660,7,Positive,12,0,12
545670,7,Positive,32,1,33
545690,8,Very Positive,383,22,405
545700,4,Mostly Negative,22,44,66
545750,0,No user reviews,0,0,0
545820,5,Mixed,75,66,141
545830,7,Positive,21,5,26
545850,0,7 user reviews,7,0,7
545860,5,Mixed,46,29,75
545890,6,Mostly Positive,9,3,12
545960,8,Very Positive,60,6,66
545980,8,Very Positive,166,6,172
546030,5,Mixed,5,6,11
546040,0,1 user reviews,1,0,1
546050,8,Very Positive,622,153,775
546070,8,Very Positive,49,12,61
546080,8,Very Positive,248,16,264
546090,8,Very Positive,87,7,94
546100,0,5 user reviews,5,0,5
546170,7,Positive,14,2,16
546180,5,Mixed,10,5,15
546200,7,Positive,16,1,17
546220,8,Very Positive,99,17,116
546330,7,Positive,9,1,10
546350,6,Mostly Positive,56,24,80
546380,5,Mixed,104,97,201
546410,7,Positive,37,6,43
546430,0,No user reviews,0,0,0
546490,5,Mixed,27,31,58
546550,8,Very Positive,56,7,63
546660,5,Mixed,28,36,64
546700,5,Mixed,77,49,126
546780,7,Positive,20,3,23
546790,5,Mixed,8,4,12
546800,0,2 user reviews,1,1,2
546900,5,Mixed,27,19,46
546930,5,Mixed,156,137,293
547000,0,4 user reviews,3,1,4
547010,5,Mixed,57,45,102
547090,5,Mixed,11,5,16
547140,0,5 user reviews,5,0,5
547210,0,4 user reviews,4,0,4
547250,0,7 user reviews,2,5,7
547260,6,Mostly Positive,43,11,54
547310,5,Mixed,46,30,76
547340,8,Very Positive,144,22,166
547360,6,Mostly Positive,274,97,371
547390,7,Positive,40,0,40
547410,5,Mixed,449,257,706
547480,7,Positive,14,0,14
547520,0,3 user reviews,2,1,3
547540,8,Very Positive,48,6,54
547590,8,Very Positive,135,27,162
547680,6,Mostly Positive,894,379,1273
547730,6,Mostly Positive,10,3,13
547820,5,Mixed,37,24,61
547900,8,Very Positive,96,23,119
547960,5,Mixed,244,227,471
547970,5,Mixed,12,7,19
547980,7,Positive,32,1,33
547990,5,Mixed,6,4,10
548050,7,Positive,11,2,13
548080,6,Mostly Positive,16,6,22
548110,0,9 user reviews,9,0,9
548130,7,Positive,17,1,18
548220,0,3 user reviews,3,0,3
548230,8,Very Positive,51,7,58
548280,6,Mostly Positive,10,3,13
548320,0,7 user reviews,6,1,7
548330,7,Positive,44,1,45
548340,8,Very Positive,204,12,216
548350,3,Negative,1,9,10
548370,5,Mixed,105,119,224
548390,0,6 user reviews,4,2,6
548450,7,Positive,14,2,16
548500,7,Positive,27,6,33
548650,6,Mostly Positive,25,8,33
548680,7,Positive,36,6,42
548710,5,Mixed,6,7,13
548720,7,Positive,10,1,11
548810,6,Mostly Positive,18,6,24
548840,8,Very Positive,100,8,108
548860,6,Mostly Positive,21,6,27
549100,6,Mostly Positive,38,10,48
549190,7,Positive,16,1,17
549240,5,Mixed,46,20,66
549260,8,Very Positive,218,32,250
549280,0,6 user reviews,4,2,6
549400,7,Positive,13,3,16
549660,0,1 user reviews,1,0,1
549670,4,Mostly Negative,7,11,18
549700,0,No user reviews,0,0,0
549740,8,Very Positive,47,4,51
549770,4,Mostly Negative,13,34,47
549790,0,No user reviews,0,0,0
549810,5,Mixed,61,54,115
549860,8,Very Positive,324,31,355
549950,5,Mixed,11,5,16
550010,8,Very Positive,664,134,798
550080,8,Very Positive,618,78,696
550170,7,Positive,16,0,16
550200,0,4 user reviews,4,0,4
550240,5,Mixed,15,8,23
550310,8,Very Positive,218,23,241
550340,8,Very Positive,81,15,96
550360,5,Mixed,30,13,43
550400,7,Positive,21,1,22
550440,5,Mixed,5,6,11
550450,5,Mixed,12,7,19
550580,8,Very Positive,62,14,76
550590,8,Very Positive,103,4,107
550650,6,Mostly Positive,20242,6951,27193
550810,8,Very Positive,52,3,55
550840,8,Very Positive,777,117,894
550930,0,6 user reviews,5,1,6
550990,7,Positive,37,2,39
551050,6,Mostly Positive,27,10,37
551060,0,9 user reviews,8,1,9
551100,0,4 user reviews,3,1,4
551110,8,Very Positive,441,49,490
551150,0,2 user reviews,2,0,2
551170,5,Mixed,316,182,498
551190,8,Very Positive,53,9,62
551320,5,Mixed,9,4,13
551450,8,Very Positive,141,25,166
551520,7,Positive,31,6,37
551550,4,Mostly Negative,26,54,80
551580,7,Positive,44,5,49
551630,5,Mixed,11,7,18
551650,6,Mostly Positive,11,4,15
551700,8,Very Positive,161,39,200
551720,6,Mostly Positive,22,9,31
551730,8,Very Positive,712,169,881
551770,8,Very Positive,437,83,520
551840,0,4 user reviews,4,0,4
552030,6,Mostly Positive,91,29,120
552060,7,Positive,40,3,43
552110,6,Mostly Positive,255,70,325
552130,4,Mostly Negative,40,66,106
552160,8,Very Positive,59,6,65
552200,7,Positive,12,0,12
552210,0,1 user reviews,1,0,1
552230,6,Mostly Positive,9,3,12
552300,7,Positive,8,2,10
552330,0,3 user reviews,2,1,3
552370,7,Positive,14,1,15
552390,7,Positive,23,3,26
552400,0,7 user reviews,7,0,7
552410,5,Mixed,31,17,48
552440,8,Very Positive,232,19,251
552450,8,Very Positive,294,60,354
552460,8,Very Positive,76,11,87
552500,6,Mostly Positive,13543,4365,17908
552540,0,9 user reviews,6,3,9
552550,0,3 user reviews,0,3,3
552580,5,Mixed,10,5,15
552590,8,Very Positive,1549,97,1646
552610,7,Positive,11,2,13
552620,8,Very Positive,281,43,324
552690,0,4 user reviews,4,0,4
552700,8,Very Positive,699,157,856
552720,6,Mostly Positive,7,3,10
552780,6,Mostly Positive,26,9,35
552800,0,7 user reviews,4,3,7
552870,0,7 user reviews,3,4,7
552900,7,Positive,21,3,24
552910,4,Mostly Negative,7,16,23
552920,6,Mostly Positive,222,73,295
552970,8,Very Positive,120,20,140
552990,6,Mostly Positive,5075,1801,6876
553000,4,Mostly Negative,7,14,21
553020,0,4 user reviews,4,0,4
553040,0,8 user reviews,7,1,8
553050,0,9 user reviews,6,3,9
553140,0,No user reviews,0,0,0
553150,0,9 user reviews,5,4,9
553180,0,5 user reviews,3,2,5
553210,5,Mixed,422,189,611
553260,5,Mixed,343,212,555
553310,0,No user reviews,0,0,0
553340,8,Very Positive,104,15,119
553350,0,5 user reviews,3,2,5
553430,0,5 user reviews,3,2,5
553440,0,8 user reviews,7,1,8
553450,5,Mixed,19,13,32
553470,6,Mostly Positive,12,5,17
553570,0,5 user reviews,1,4,5
553590,8,Very Positive,57,3,60
553610,6,Mostly Positive,12,5,17
553630,0,2 user reviews,1,1,2
553640,8,Very Positive,14985,1299,16284
553690,6,Mostly Positive,8,3,11
553760,7,Positive,44,1,45
553780,7,Positive,12,1,13
553790,8,Very Positive,510,84,594
553800,5,Mixed,23,13,36
553820,6,Mostly Positive,17,7,24
553910,0,4 user reviews,2,2,4
553950,7,Positive,42,3,45
553960,5,Mixed,176,258,434
554150,7,Positive,35,3,38
554220,7,Positive,40,8,48
554280,7,Positive,24,3,27
554310,6,Mostly Positive,183,72,255
554330,7,Positive,21,3,24
554510,5,Mixed,241,154,395
554550,0,9 user reviews,4,5,9
554600,8,Very Positive,130,10,140
554620,8,Very Positive,16040,1084,17124
554640,6,Mostly Positive,279,89,368
554660,0,3 user reviews,3,0,3
554680,5,Mixed,9,4,13
554690,0,5 user reviews,5,0,5
554710,0,No user reviews,0,0,0
554750,5,Mixed,93,46,139
554770,4,Mostly Negative,4,12,16
554800,8,Very Positive,53,12,65
554810,7,Positive,30,5,35
554870,7,Positive,13,1,14
554940,0,9 user reviews,7,2,9
555010,5,Mixed,37,16,53
555050,8,Very Positive,106,15,121
555060,8,Very Positive,66,9,75
555080,0,4 user reviews,1,3,4
555100,0,1 user reviews,1,0,1
555150,8,Very Positive,637,157,794
555210,8,Very Positive,2456,285,2741
555220,8,Very Positive,5805,339,6144
555260,5,Mixed,38,32,70
555280,5,Mixed,19,17,36
555290,7,Positive,35,6,41
555310,7,Positive,22,3,25
555320,8,Very Positive,57,6,63
555370,0,2 user reviews,0,2,2
555400,8,Very Positive,110,23,133
555440,0,No user reviews,0,0,0
555450,5,Mixed,72,108,180
555510,5,Mixed,189,105,294
555570,5,Mixed,11579,12174,23753
555580,7,Positive,26,3,29
555600,7,Positive,21,1,22
555610,8,Very Positive,63,12,75
555620,5,Mixed,96,51,147
555640,6,Mostly Positive,124,34,158
555710,6,Mostly Positive,98,29,127
555720,7,Positive,29,6,35
555730,6,Mostly Positive,11,3,14
555750,5,Mixed,188,102,290
555830,5,Mixed,8,8,16
555850,5,Mixed,13,6,19
555880,8,Very Positive,760,54,814
555890,5,Mixed,15,7,22
555940,6,Mostly Positive,66,17,83
555950,8,Very Positive,634,35,669
556000,0,9 user reviews,0,9,9
556010,5,Mixed,37,18,55
556050,0,No user reviews,0,0,0
556060,7,Positive,19,0,19
556090,0,1 user reviews,1,0,1
556130,0,5 user reviews,4,1,5
556160,5,Mixed,57,76,133
556190,7,Positive,16,2,18
556250,7,Positive,13,3,16
556260,0,4 user reviews,3,1,4
556280,6,Mostly Positive,121,45,166
556310,0,7 user reviews,5,2,7
556340,8,Very Positive,92,18,110
556480,5,Mixed,16,18,34
556710,7,Positive,12,3,15
556740,6,Mostly Positive,106,27,133
556780,5,Mixed,33,15,48
556820,6,Mostly Positive,490,172,662
556840,5,Mixed,13,19,32
556850,0,1 user reviews,1,0,1
556870,5,Mixed,107,57,164
556890,7,Positive,29,5,34
556960,0,7 user reviews,7,0,7
557030,0,8 user reviews,6,2,8
557040,8,Very Positive,242,34,276
557400,8,Very Positive,1220,154,1374
557520,0,No user reviews,0,0,0
557570,7,Positive,15,0,15
557580,6,Mostly Positive,55,20,75
557600,9,Overwhelmingly Positive,2939,80,3019
557680,5,Mixed,87,64,151
557700,6,Mostly Positive,7,3,10
557770,6,Mostly Positive,13,5,18
557790,7,Positive,13,1,14
557810,5,Mixed,267,229,496
557830,7,Positive,16,2,18
557860,7,Positive,10,1,11
557880,5,Mixed,81,53,134
557890,8,Very Positive,75,9,84
557960,4,Mostly Negative,4,8,12
558020,0,3 user reviews,2,1,3
558030,0,2 user reviews,2,0,2
558110,6,Mostly Positive,82,23,105
558260,6,Mostly Positive,151,47,198
558320,7,Positive,19,3,22
558340,5,Mixed,31,26,57
558410,7,Positive,13,2,15
558420,8,Very Positive,1636,197,1833
558450,8,Very Positive,113,15,128
558490,7,Positive,25,5,30
558610,5,Mixed,161,113,274
558620,6,Mostly Positive,131,41,172
558740,0,9 user reviews,4,5,9
558750,7,Positive,9,1,10
558780,6,Mostly Positive,10,4,14
558790,8,Very Positive,46,5,51
558810,5,Mixed,17,17,34
558850,5,Mixed,14,8,22
558870,4,Mostly Negative,23,44,67
558990,9,Overwhelmingly Positive,1170,22,1192
559030,7,Positive,15,1,16
559100,0,No user reviews,0,0,0
559130,6,Mostly Positive,25,10,35
559140,0,5 user reviews,1,4,5
559210,9,Overwhelmingly Positive,1406,38,1444
559250,0,5 user reviews,5,0,5
559280,0,5 user reviews,5,0,5
559300,0,4 user reviews,2,2,4
559310,5,Mixed,55,35,90
559340,5,Mixed,98,84,182
559450,6,Mostly Positive,7,3,10
559610,9,Overwhelmingly Positive,616,27,643
559650,8,Very Positive,1427,134,1561
559870,6,Mostly Positive,64,22,86
559900,5,Mixed,75,34,109
559910,6,Mostly Positive,144,58,202
559930,7,Positive,23,0,23
559960,8,Very Positive,71,4,75
560000,8,Very Positive,132,5,137
560010,5,Mixed,6,4,10
560050,8,Very Positive,51,6,57
560080,0,7 user reviews,7,0,7
560130,8,Very Positive,2523,487,3010
560180,0,8 user reviews,8,0,8
560200,0,8 user reviews,7,1,8
560220,7,Positive,25,3,28
560250,5,Mixed,42,21,63
560260,8,Very Positive,1833,186,2019
560300,7,Positive,29,0,29
560340,0,3 user reviews,1,2,3
560510,7,Positive,12,2,14
560710,5,Mixed,13,8,21
560720,8,Very Positive,66,3,69
560730,5,Mixed,23,26,49
560740,6,Mostly Positive,31,9,40
560750,7,Positive,37,9,46
560760,5,Mixed,22,18,40
560770,6,Mostly Positive,7,3,10
560820,5,Mixed,20,12,32
561000,7,Positive,18,1,19
561010,7,Positive,8,2,10
561190,7,Positive,29,3,32
561230,6,Mostly Positive,14,4,18
561340,8,Very Positive,97,16,113
561420,5,Mixed,8,9,17
561450,6,Mostly Positive,18,6,24
561510,7,Positive,13,1,14
561590,5,Mixed,18,11,29
561600,6,Mostly Positive,248,64,312
561610,5,Mixed,156,79,235
561690,0,6 user reviews,2,4,6
561740,8,Very Positive,140,24,164
561770,6,Mostly Positive,146,43,189
561930,7,Positive,13,0,13
562050,6,Mostly Positive,41,12,53
562090,5,Mixed,8,7,15
562210,8,Very Positive,105,17,122
562220,9,Overwhelmingly Positive,3835,187,4022
562230,8,Very Positive,190,19,209
562250,7,Positive,32,5,37
562260,7,Positive,28,4,32
562280,7,Positive,17,1,18
562290,5,Mixed,9,5,14
562310,7,Positive,9,1,10
562320,7,Positive,29,5,34
562330,7,Positive,32,6,38
562340,5,Mixed,32,37,69
562360,8,Very Positive,324,40,364
562410,8,Very Positive,537,47,584
562430,5,Mixed,49,31,80
562460,7,Positive,22,0,22
562470,5,Mixed,122,54,176
562480,8,Very Positive,50,2,52
562490,8,Very Positive,65,12,77
562500,8,Very Positive,884,88,972
562520,5,Mixed,31,35,66
562570,8,Very Positive,105,26,131
562590,5,Mixed,980,494,1474
562660,7,Positive,29,5,34
562680,0,5 user reviews,5,0,5
562690,4,Mostly Negative,6,16,22
562730,5,Mixed,8,10,18
563120,5,Mixed,56,49,105
563130,6,Mostly Positive,14,4,18
563150,7,Positive,29,5,34
563170,0,No user reviews,0,0,0
563180,7,Positive,38,0,38
563190,7,Positive,23,4,27
563250,7,Positive,9,2,11
563370,0,4 user reviews,3,1,4
563380,0,4 user reviews,3,1,4
563390,0,8 user reviews,8,0,8
563410,7,Positive,10,1,11
563520,7,Positive,16,4,20
563550,7,Positive,37,4,41
563560,8,Very Positive,6180,400,6580
563610,0,3 user reviews,2,1,3
563680,0,9 user reviews,1,8,9
563750,5,Mixed,44,27,71
563810,7,Positive,30,1,31
563860,6,Mostly Positive,8,3,11
564010,4,Mostly Negative,57,115,172
564040,7,Positive,14,0,14
564050,8,Very Positive,475,22,497
564070,4,Mostly Negative,5,9,14
564080,7,Positive,12,0,12
564100,0,5 user reviews,2,3,5
564140,0,1 user reviews,0,1,1
564150,8,Very Positive,133,26,159
564160,7,Positive,40,1,41
564210,7,Positive,10,2,12
564230,8,Very Positive,884,82,966
564280,0,9 user reviews,6,3,9
564310,8,Very Positive,1167,86,1253
564470,7,Positive,21,5,26
564480,0,8 user reviews,8,0,8
564710,8,Very Positive,2918,197,3115
564750,6,Mostly Positive,19,6,25
564810,7,Positive,25,0,25
564940,7,Positive,23,1,24
564950,5,Mixed,11,16,27
565110,7,Positive,13,1,14
565120,8,Very Positive,145,34,179
565180,0,No user reviews,0,0,0
565190,7,Positive,17,0,17
565340,5,Mixed,175,112,287
565380,6,Mostly Positive,27,9,36
565390,8,Very Positive,57,3,60
565640,0,8 user reviews,3,5,8
565660,5,Mixed,20,9,29
565720,8,Very Positive,182,34,216
565980,5,Mixed,10,5,15
566060,4,Mostly Negative,7,14,21
566160,8,Very Positive,743,48,791
566180,0,4 user reviews,3,1,4
566190,5,Mixed,21,13,34
566220,5,Mixed,150,202,352
566320,0,9 user reviews,8,1,9
566350,6,Mostly Positive,7,3,10
566410,4,Mostly Negative,3,9,12
566430,6,Mostly Positive,18,5,23
566530,8,Very Positive,125,22,147
566540,0,No user reviews,0,0,0
566550,5,Mixed,14,16,30
566670,8,Very Positive,78,5,83
566700,7,Positive,29,0,29
566750,7,Positive,15,2,17
566780,7,Positive,37,8,45
566870,7,Positive,12,2,14
566880,7,Positive,19,2,21
566900,7,Positive,18,0,18
566970,7,Positive,14,0,14
567000,5,Mixed,50,26,76
567030,8,Very Positive,136,6,142
567040,4,Mostly Negative,12,22,34
567060,6,Mostly Positive,93,25,118
567140,7,Positive,10,1,11
567160,0,No user reviews,0,0,0
567170,4,Mostly Negative,21,36,57
567200,7,Positive,17,4,21
567210,7,Positive,38,5,43
567250,5,Mixed,32,32,64
567260,4,Mostly Negative,16,58,74
567270,6,Mostly Positive,50,19,69
567280,8,Very Positive,430,50,480
567290,8,Very Positive,712,67,779
567320,5,Mixed,42,33,75
567340,7,Positive,16,0,16
567370,8,Very Positive,58,2,60
567430,0,1 user reviews,1,0,1
567480,5,Mixed,11,6,17
567580,8,Very Positive,186,46,232
567600,5,Mixed,16,18,34
567620,0,2 user reviews,1,1,2
567640,8,Very Positive,2129,366,2495
567660,0,8 user reviews,6,2,8
567670,8,Very Positive,179,13,192
567680,5,Mixed,63,60,123
567780,6,Mostly Positive,18,6,24
567800,8,Very Positive,80,9,89
567840,0,5 user reviews,3,2,5
567860,0,7 user reviews,6,1,7
567890,7,Positive,12,1,13
568020,7,Positive,40,0,40
568030,7,Positive,15,1,16
568060,0,2 user reviews,2,0,2
568090,8,Very Positive,1012,122,1134
568130,6,Mostly Positive,10,3,13
568180,7,Positive,11,1,12
568190,5,Mixed,13,19,32
568200,7,Positive,21,0,21
568300,0,8 user reviews,7,1,8
568320,8,Very Positive,216,14,230
568340,5,Mixed,34,23,57
568370,7,Positive,25,2,27
568440,8,Very Positive,98,22,120
568460,7,Positive,18,0,18
568470,6,Mostly Positive,12,5,17
568490,0,6 user reviews,6,0,6
568500,7,Positive,12,2,14
568570,6,Mostly Positive,1343,479,1822
568610,7,Positive,23,2,25
568750,6,Mostly Positive,113,40,153
568770,9,Overwhelmingly Positive,1563,52,1615
568780,6,Mostly Positive,15,6,21
568830,7,Positive,23,3,26
568840,0,3 user reviews,3,0,3
568860,6,Mostly Positive,14,5,19
568910,0,7 user reviews,7,0,7
568920,7,Positive,19,1,20
569210,5,Mixed,6,5,11
569290,7,Positive,37,9,46
569340,6,Mostly Positive,51,15,66
569360,7,Positive,29,0,29
569380,7,Positive,10,1,11
569420,7,Positive,11,1,12
569430,5,Mixed,21,10,31
569480,8,Very Positive,4597,811,5408
569570,7,Positive,38,4,42
569610,6,Mostly Positive,105,36,141
569630,6,Mostly Positive,43,11,54
569720,8,Very Positive,56,4,60
569770,6,Mostly Positive,132,43,175
569800,6,Mostly Positive,48,13,61
569810,7,Positive,28,2,30
569860,8,Very Positive,1680,100,1780
569970,5,Mixed,61,50,111
570050,5,Mixed,52,35,87
570350,5,Mixed,18,9,27
570420,5,Mixed,87,50,137
570460,8,Very Positive,870,137,1007
570490,7,Positive,38,2,40
570600,0,4 user reviews,4,0,4
570710,4,Mostly Negative,22,74,96
570770,6,Mostly Positive,425,112,537
570780,6,Mostly Positive,645,212,857
570790,4,Mostly Negative,7,12,19
570810,0,7 user reviews,7,0,7
570840,8,Very Positive,1829,119,1948
570890,5,Mixed,13,12,25
570910,3,Negative,2,13,15
570940,5,Mixed,5162,2702,7864
570950,0,No user reviews,0,0,0
570970,5,Mixed,60,27,87
570980,8,Very Positive,373,32,405
571260,8,Very Positive,981,211,1192
571310,9,Overwhelmingly Positive,1051,39,1090
571340,5,Mixed,23,17,40
571350,8,Very Positive,259,59,318
571520,5,Mixed,9,4,13
571530,8,Very Positive,503,28,531
571660,0,7 user reviews,5,2,7
571680,0,3 user reviews,3,0,3
571720,5,Mixed,47,23,70
571740,6,Mostly Positive,1746,466,2212
571860,0,7 user reviews,6,1,7
571880,9,Overwhelmingly Positive,630,12,642
572000,6,Mostly Positive,44,15,59
572020,7,Positive,25,1,26
572170,0,9 user reviews,4,5,9
572180,7,Positive,17,0,17
572240,7,Positive,13,2,15
572290,0,2 user reviews,1,1,2
572300,6,Mostly Positive,42,15,57
572410,6,Mostly Positive,2673,937,3610
572480,0,3 user reviews,3,0,3
572520,6,Mostly Positive,493,204,697
572570,0,9 user reviews,8,1,9
572580,5,Mixed,6,6,12
572660,6,Mostly Positive,34,10,44
573050,7,Positive,18,0,18
573060,8,Very Positive,98,23,121
573070,7,Positive,16,3,19
573080,8,Very Positive,61,14,75
573120,8,Very Positive,233,50,283
573130,8,Very Positive,194,29,223
573170,8,Very Positive,203,4,207
573210,5,Mixed,18,13,31
573260,4,Mostly Negative,3,7,10
573370,7,Positive,15,2,17
573490,8,Very Positive,141,20,161
573520,7,Positive,36,2,38
573600,5,Mixed,39,20,59
573660,5,Mixed,17,20,37
573680,4,Mostly Negative,30,69,99
573770,8,Very Positive,189,8,197
573780,6,Mostly Positive,58,22,80
573800,6,Mostly Positive,28,9,37
574030,5,Mixed,57,39,96
574050,6,Mostly Positive,350,147,497
574070,5,Mixed,92,57,149
574090,0,No user reviews,0,0,0
574120,0,No user reviews,0,0,0
574160,6,Mostly Positive,23,8,31
574200,7,Positive,28,6,34
574220,0,5 user reviews,5,0,5
574260,6,Mostly Positive,37,11,48
574270,7,Positive,38,7,45
574310,8,Very Positive,310,19,329
574420,0,7 user reviews,6,1,7
574440,5,Mixed,32,17,49
574500,0,8 user reviews,7,1,8
574520,0,3 user reviews,1,2,3
574560,6,Mostly Positive,114,32,146
574580,6,Mostly Positive,35,13,48
574590,7,Positive,14,0,14
574640,6,Mostly Positive,91,39,130
574710,0,7 user reviews,4,3,7
574850,5,Mixed,49,26,75
574860,5,Mixed,8,11,19
574890,7,Positive,24,0,24
574940,8,Very Positive,61,9,70
575010,6,Mostly Positive,65,21,86
575050,8,Very Positive,385,23,408
575330,8,Very Positive,122,16,138
575340,6,Mostly Positive,11,4,15
575400,8,Very Positive,54,11,65
575450,7,Positive,12,1,13
575460,5,Mixed,29,16,45
575480,8,Very Positive,62,3,65
575510,6,Mostly Positive,203,81,284
575550,8,Very Positive,2284,222,2506
575570,6,Mostly Positive,76,31,107
575580,6,Mostly Positive,35,9,44
575590,7,Positive,29,1,30
575630,5,Mixed,17,14,31
575640,8,Very Positive,2857,423,3280
575650,8,Very Positive,110,11,121
575670,7,Positive,16,3,19
575700,5,Mixed,86,70,156
575710,0,7 user reviews,6,1,7
575720,5,Mixed,597,358,955
575740,6,Mostly Positive,26,8,34
575800,0,7 user reviews,4,3,7
575810,0,8 user reviews,7,1,8
575820,8,Very Positive,60,4,64
575830,5,Mixed,67,44,111
575840,5,Mixed,47,32,79
575850,5,Mixed,14,8,22
575860,5,Mixed,42,63,105
575880,7,Positive,19,4,23
575890,7,Positive,9,2,11
575940,8,Very Positive,52,6,58
575950,5,Mixed,128,72,200
575960,5,Mixed,32,16,48
575970,8,Very Positive,58,6,64
575990,7,Positive,12,1,13
576010,5,Mixed,48,39,87
576020,0,9 user reviews,5,4,9
576030,8,Very Positive,151,17,168
576050,5,Mixed,22,22,44
576090,0,No user reviews,0,0,0
576110,0,7 user reviews,3,4,7
576130,8,Very Positive,109,20,129
576160,7,Positive,23,0,23
576230,0,No user reviews,0,0,0
576260,6,Mostly Positive,74,30,104
576280,7,Positive,28,3,31
576290,0,No user reviews,0,0,0
576310,5,Mixed,88,82,170
576370,7,Positive,10,2,12
576380,5,Mixed,11,6,17
576390,4,Mostly Negative,5,10,15
576400,6,Mostly Positive,56,19,75
576410,7,Positive,20,2,22
576420,7,Positive,33,1,34
576440,4,Mostly Negative,159,318,477
576470,6,Mostly Positive,342,104,446
576540,5,Mixed,36,19,55
576560,5,Mixed,352,279,631
576620,7,Positive,34,4,38
576660,4,Mostly Negative,9,14,23
576670,7,Positive,8,2,10
576770,8,Very Positive,792,58,850
576810,8,Very Positive,76,18,94
576820,0,4 user reviews,4,0,4
576860,5,Mixed,150,146,296
576880,4,Mostly Negative,12,34,46
576960,0,No user reviews,0,0,0
576980,6,Mostly Positive,69,20,89
577150,7,Positive,16,0,16
577160,0,6 user reviews,6,0,6
577180,8,Very Positive,72,18,90
577210,6,Mostly Positive,18,7,25
577230,6,Mostly Positive,784,228,1012
577290,7,Positive,43,4,47
577320,0,5 user reviews,2,3,5
577360,0,4 user reviews,3,1,4
577380,7,Positive,10,0,10
577460,5,Mixed,97,82,179
577470,0,4 user reviews,4,0,4
577480,8,Very Positive,97,4,101
577490,7,Positive,21,1,22
577580,7,Positive,14,2,16
577670,6,Mostly Positive,101,43,144
577690,8,Very Positive,224,21,245
577700,8,Very Positive,53,0,53
577730,6,Mostly Positive,66,20,86
577740,5,Mixed,60,31,91
577760,7,Positive,14,1,15
577800,4,Mostly Negative,3660,9800,13460
577890,0,8 user reviews,0,8,8
577910,7,Positive,29,3,32
577940,8,Very Positive,990,124,1114
578010,0,7 user reviews,3,4,7
578050,0,No user reviews,0,0,0
578080,5,Mixed,394617,372037,766654
578210,8,Very Positive,167,13,180
578310,8,Very Positive,5914,1476,7390
578330,6,Mostly Positive,581,228,809
578430,7,Positive,26,0,26
578470,6,Mostly Positive,16,6,22
578590,5,Mixed,10,6,16
578600,4,Mostly Negative,44,126,170
578690,7,Positive,12,1,13
578720,5,Mixed,158,99,257
578830,6,Mostly Positive,25,10,35
578850,8,Very Positive,634,63,697
578870,7,Positive,12,2,14
578900,8,Very Positive,136,2,138
578920,5,Mixed,12,8,20
578930,8,Very Positive,74,2,76
579020,5,Mixed,236,108,344
579080,0,8 user reviews,3,5,8
579110,8,Very Positive,82,7,89
579130,5,Mixed,9,7,16
579180,5,Mixed,464,298,762
579210,5,Mixed,4,6,10
579230,8,Very Positive,79,9,88
579820,5,Mixed,59,49,108
579840,6,Mostly Positive,47,15,62
579870,0,5 user reviews,2,3,5
579950,8,Very Positive,1143,172,1315
580040,6,Mostly Positive,238,85,323
580150,6,Mostly Positive,396,127,523
580170,5,Mixed,325,143,468
580200,8,Very Positive,1284,285,1569
580300,7,Positive,19,0,19
580320,5,Mixed,8,4,12
580420,6,Mostly Positive,39,14,53
580510,0,8 user reviews,7,1,8
580520,6,Mostly Positive,15,6,21
580560,5,Mixed,15,18,33
580570,5,Mixed,9,6,15
580590,7,Positive,38,1,39
580680,5,Mixed,6,6,12
580710,6,Mostly Positive,121,33,154
580720,8,Very Positive,220,39,259
580820,6,Mostly Positive,26,7,33
580890,5,Mixed,38,18,56
580950,4,Mostly Negative,5,8,13
580990,5,Mixed,27,25,52
581000,5,Mixed,27,30,57
581030,4,Mostly Negative,74,118,192
581060,5,Mixed,53,24,77
581100,5,Mixed,21,26,47
581130,6,Mostly Positive,610,182,792
581210,0,5 user reviews,4,1,5
581220,5,Mixed,40,48,88
581300,5,Mixed,90,83,173
581310,5,Mixed,28,18,46
581370,5,Mixed,50,27,77
581380,5,Mixed,10,9,19
581470,5,Mixed,363,199,562
581520,6,Mostly Positive,86,33,119
581600,5,Mixed,10,13,23
581610,4,Mostly Negative,44,94,138
581620,4,Mostly Negative,754,1212,1966
581640,8,Very Positive,143,25,168
581650,8,Very Positive,64,16,80
581670,5,Mixed,27,24,51
581710,4,Mostly Negative,6,15,21
581740,0,3 user reviews,1,2,3
581760,8,Very Positive,116,12,128
581800,7,Positive,19,4,23
581970,6,Mostly Positive,44,18,62
581980,4,Mostly Negative,10,22,32
582160,8,Very Positive,24697,4063,28760
582270,8,Very Positive,1271,236,1507
582280,5,Mixed,61,72,133
582290,5,Mixed,6,8,14
582330,8,Very Positive,224,36,260
582350,0,4 user reviews,4,0,4
582360,0,3 user reviews,2,1,3
582370,7,Positive,11,2,13
582500,8,Very Positive,6664,521,7185
582530,0,8 user reviews,8,0,8
582550,6,Mostly Positive,1325,343,1668
582560,8,Very Positive,118,4,122
582610,5,Mixed,6,6,12
582620,8,Very Positive,107,25,132
582660,5,Mixed,7048,3356,10404
582890,8,Very Positive,243,55,298
582920,0,6 user reviews,3,3,6
582980,7,Positive,21,3,24
582990,6,Mostly Positive,38,11,49
583000,0,2 user reviews,2,0,2
583030,0,No user reviews,0,0,0
583040,8,Very Positive,94,22,116
583090,7,Positive,25,1,26
583150,6,Mostly Positive,22,9,31
583270,8,Very Positive,60,3,63
583470,8,Very Positive,1138,77,1215
583490,6,Mostly Positive,94,29,123
583530,0,9 user reviews,6,3,9
583590,5,Mixed,29,13,42
583760,8,Very Positive,637,39,676
583890,8,Very Positive,75,7,82
583930,8,Very Positive,77,12,89
584100,6,Mostly Positive,17,6,23
584150,5,Mixed,8,4,12
584220,8,Very Positive,67,15,82
584370,8,Very Positive,90,21,111
584400,8,Very Positive,6322,666,6988
584800,6,Mostly Positive,35,14,49
584890,6,Mostly Positive,147,44,191
584940,5,Mixed,13,9,22
584980,8,Very Positive,2938,310,3248
584990,8,Very Positive,47,6,53
585080,5,Mixed,60,78,138
585090,0,6 user reviews,2,4,6
585180,8,Very Positive,141,3,144
585220,6,Mostly Positive,23,7,30
585290,5,Mixed,68,30,98
585450,0,No user reviews,0,0,0
585500,7,Positive,17,0,17
585550,8,Very Positive,745,158,903
585690,5,Mixed,163,75,238
585740,0,9 user reviews,3,6,9
585750,0,8 user reviews,6,2,8
585830,5,Mixed,47,52,99
585840,8,Very Positive,403,100,503
585880,8,Very Positive,86,9,95
585890,8,Very Positive,241,13,254
585900,6,Mostly Positive,303,94,397
585910,8,Very Positive,104,9,113
585950,8,Very Positive,123,8,131
585970,5,Mixed,15,7,22
585990,7,Positive,28,7,35
586030,6,Mostly Positive,719,218,937
586060,5,Mixed,28,17,45
586090,5,Mixed,123,146,269
586140,8,Very Positive,1535,183,1718
586150,4,Mostly Negative,3,8,11
586160,4,Mostly Negative,3,7,10
586170,6,Mostly Positive,21,6,27
586200,5,Mixed,305,190,495
586230,7,Positive,10,0,10
586240,8,Very Positive,116,11,127
586310,8,Very Positive,80,17,97
586320,7,Positive,15,1,16
586340,7,Positive,29,2,31
586350,8,Very Positive,97,4,101
586380,6,Mostly Positive,256,100,356
586390,8,Very Positive,47,3,50
586430,7,Positive,12,0,12
586450,7,Positive,11,1,12
586600,4,Mostly Negative,4,14,18
586660,7,Positive,38,2,40
586670,7,Positive,13,0,13
586750,5,Mixed,109,71,180
586770,6,Mostly Positive,9,3,12
586830,6,Mostly Positive,14,5,19
586880,8,Very Positive,237,5,242
586920,0,5 user reviews,5,0,5
586950,8,Very Positive,110,11,121
586960,8,Very Positive,280,37,317
586970,6,Mostly Positive,91,27,118
587000,8,Very Positive,403,53,456
587030,0,No user reviews,0,0,0
587050,4,Mostly Negative,41,65,106
587070,0,5 user reviews,4,1,5
587100,8,Very Positive,172,14,186
587110,0,No user reviews,0,0,0
587160,0,No user reviews,0,0,0
587180,7,Positive,44,5,49
587210,5,Mixed,9,7,16
587260,8,Very Positive,226,20,246
587290,5,Mixed,28,16,44
587310,7,Positive,21,0,21
587390,5,Mixed,6,9,15
587400,7,Positive,24,5,29
587420,6,Mostly Positive,231,84,315
587430,8,Very Positive,411,29,440
587450,5,Mixed,445,207,652
587460,5,Mixed,55,41,96
587480,0,3 user reviews,3,0,3
587490,5,Mixed,13,13,26
587560,0,6 user reviews,5,1,6
587570,6,Mostly Positive,37,15,52
587620,8,Very Positive,2047,171,2218
587710,0,3 user reviews,3,0,3
587810,4,Mostly Negative,18,41,59
587830,4,Mostly Negative,12,26,38
587860,6,Mostly Positive,190,61,251
588040,9,Overwhelmingly Positive,2665,120,2785
588070,0,9 user reviews,2,7,9
588080,7,Positive,18,3,21
588090,7,Positive,39,6,45
588110,6,Mostly Positive,63,25,88
588120,5,Mixed,42,22,64
588160,5,Mixed,192,283,475
588180,8,Very Positive,169,25,194
588190,5,Mixed,118,87,205
588230,7,Positive,21,0,21
588240,8,Very Positive,134,21,155
588340,5,Mixed,20,16,36
588420,5,Mixed,57,38,95
588430,8,Very Positive,16096,2741,18837
588540,6,Mostly Positive,11,4,15
588560,7,Positive,35,5,40
588620,7,Positive,22,3,25
588650,9,Overwhelmingly Positive,15661,669,16330
588690,8,Very Positive,751,48,799
588710,8,Very Positive,46,4,50
588730,8,Very Positive,228,8,236
588750,5,Mixed,10,11,21
588880,7,Positive,11,1,12
588890,6,Mostly Positive,32,13,45
588920,5,Mixed,14,12,26
588950,8,Very Positive,541,62,603
588970,8,Very Positive,916,113,1029
589060,7,Positive,13,1,14
589080,0,5 user reviews,1,4,5
589150,6,Mostly Positive,16,6,22
589170,0,9 user reviews,5,4,9
589220,5,Mixed,26,17,43
589250,7,Positive,29,5,34
589260,0,8 user reviews,8,0,8
589270,7,Positive,10,0,10
589280,7,Positive,25,0,25
589320,5,Mixed,136,118,254
589360,8,Very Positive,1685,294,1979
589380,7,Positive,8,2,10
589390,5,Mixed,125,187,312
589420,8,Very Positive,127,15,142
589430,4,Mostly Negative,4,16,20
589440,0,7 user reviews,5,2,7
589460,6,Mostly Positive,71,22,93
589470,7,Positive,19,3,22
589480,7,Positive,28,1,29
589510,8,Very Positive,73,8,81
589530,8,Very Positive,166,27,193
589590,8,Very Positive,1656,98,1754
589640,6,Mostly Positive,25,8,33
589670,8,Very Positive,90,20,110
589680,0,8 user reviews,8,0,8
589690,6,Mostly Positive,23,8,31
589730,5,Mixed,16,9,25
589740,5,Mixed,18,23,41
589780,8,Very Positive,1068,83,1151
589860,7,Positive,41,1,42
589870,8,Very Positive,1410,203,1613
590270,6,Mostly Positive,15,4,19
590370,6,Mostly Positive,9,3,12
590560,0,5 user reviews,1,4,5
590570,0,1 user reviews,0,1,1
590590,8,Very Positive,199,6,205
590690,8,Very Positive,346,32,378
590820,0,8 user reviews,6,2,8
590910,5,Mixed,163,79,242
590970,5,Mixed,73,85,158
591000,8,Very Positive,57,3,60
591010,7,Positive,22,3,25
591020,0,No user reviews,0,0,0
591080,5,Mixed,7,5,12
591090,0,1 user reviews,1,0,1
591130,0,6 user reviews,3,3,6
591350,6,Mostly Positive,19,5,24
591370,8,Very Positive,537,93,630
591390,0,No user reviews,0,0,0
591420,8,Very Positive,1451,207,1658
591460,0,No user reviews,0,0,0
591560,8,Very Positive,52,9,61
591580,0,1 user reviews,1,0,1
591610,0,1 user reviews,1,0,1
591630,8,Very Positive,388,12,400
591640,0,3 user reviews,3,0,3
591680,8,Very Positive,53,1,54
591740,5,Mixed,515,762,1277
591750,7,Positive,44,5,49
591960,5,Mixed,842,395,1237
591990,5,Mixed,9,5,14
592020,7,Positive,17,0,17
592030,6,Mostly Positive,63,16,79
592040,0,7 user reviews,6,1,7
592120,7,Positive,8,2,10
592130,6,Mostly Positive,10,3,13
592200,7,Positive,12,3,15
592240,7,Positive,14,2,16
592270,8,Very Positive,51,0,51
592300,8,Very Positive,50,2,52
592340,5,Mixed,47,32,79
592380,0,No user reviews,0,0,0
592390,5,Mixed,64,44,108
592400,0,7 user reviews,6,1,7
592490,7,Positive,42,7,49
592550,5,Mixed,15,11,26
592570,0,6 user reviews,3,3,6
592620,7,Positive,8,2,10
592660,5,Mixed,8,4,12
592730,5,Mixed,32,14,46
592750,7,Positive,21,1,22
592780,5,Mixed,7,8,15
592990,0,No user reviews,0,0,0
593070,7,Positive,8,2,10
593100,0,No user reviews,0,0,0
593150,0,No user reviews,0,0,0
593200,8,Very Positive,1121,70,1191
593280,9,Overwhelmingly Positive,1788,71,1859
593290,5,Mixed,57,59,116
593330,5,Mixed,62,33,95
593340,7,Positive,30,7,37
593410,6,Mostly Positive,13,4,17
593490,6,Mostly Positive,90,32,122
593540,0,9 user reviews,6,3,9
593600,5,Mixed,1949,1143,3092
593670,7,Positive,21,2,23
593680,7,Positive,27,1,28
593700,7,Positive,34,5,39
593730,0,7 user reviews,4,3,7
593740,0,5 user reviews,4,1,5
593850,7,Positive,36,8,44
593980,0,6 user reviews,2,4,6
594120,0,2 user reviews,0,2,2
594130,7,Positive,24,1,25
594200,7,Positive,11,0,11
594300,8,Very Positive,42,9,51
594310,5,Mixed,13,6,19
594320,7,Positive,26,1,27
594360,7,Positive,8,2,10
594370,6,Mostly Positive,36,10,46
594390,0,No user reviews,0,0,0
594410,0,4 user reviews,4,0,4
594490,8,Very Positive,154,26,180
594570,8,Very Positive,11698,1225,12923
594660,6,Mostly Positive,33,9,42
594680,8,Very Positive,118,12,130
594730,5,Mixed,134,105,239
594750,7,Positive,40,3,43
594810,7,Positive,11,0,11
594820,0,5 user reviews,4,1,5
594950,7,Positive,46,0,46
594980,7,Positive,17,0,17
595010,6,Mostly Positive,9,3,12
595030,4,Mostly Negative,4,10,14
595090,6,Mostly Positive,52,21,73
595110,8,Very Positive,49,12,61
595120,6,Mostly Positive,88,23,111
595140,8,Very Positive,781,51,832
595260,6,Mostly Positive,29,8,37
595300,0,3 user reviews,3,0,3
595340,4,Mostly Negative,422,766,1188
595420,5,Mixed,80,36,116
595430,8,Very Positive,195,9,204
595440,8,Very Positive,295,59,354
595460,8,Very Positive,131,22,153
595480,5,Mixed,27,27,54
595520,8,Very Positive,1211,186,1397
595550,5,Mixed,48,26,74
595560,7,Positive,19,0,19
595660,5,Mixed,17,8,25
595730,8,Very Positive,48,5,53
595740,6,Mostly Positive,132,47,179
595770,8,Very Positive,67,15,82
595780,5,Mixed,5,5,10
595920,5,Mixed,18,11,29
595960,7,Positive,29,6,35
596050,0,No user reviews,0,0,0
596080,7,Positive,19,2,21
596170,5,Mixed,67,100,167
596240,5,Mixed,31,25,56
596260,0,3 user reviews,3,0,3
596370,7,Positive,14,0,14
596380,8,Very Positive,57,0,57
596390,0,8 user reviews,8,0,8
596540,5,Mixed,12,9,21
596590,8,Very Positive,64,5,69
596630,7,Positive,27,3,30
596650,5,Mixed,441,216,657
596740,5,Mixed,13,6,19
596890,7,Positive,15,2,17
596910,7,Positive,36,3,39
596950,5,Mixed,33,15,48
596990,0,4 user reviews,2,2,4
597020,0,5 user reviews,4,1,5
597030,8,Very Positive,67,8,75
597040,0,8 user reviews,4,4,8
597090,0,1 user reviews,0,1,1
597110,4,Mostly Negative,10,24,34
597120,0,6 user reviews,6,0,6
597150,8,Very Positive,403,42,445
597170,9,Overwhelmingly Positive,1177,40,1217
597190,0,8 user reviews,6,2,8
597200,6,Mostly Positive,14,4,18
597220,9,Overwhelmingly Positive,2171,49,2220
597230,8,Very Positive,130,2,132
597240,5,Mixed,14,14,28
597590,7,Positive,19,1,20
597670,0,3 user reviews,2,1,3
597700,8,Very Positive,164,10,174
597730,0,8 user reviews,7,1,8
597840,6,Mostly Positive,125,47,172
597860,7,Positive,16,2,18
597920,4,Mostly Negative,8,14,22
597990,0,5 user reviews,3,2,5
598060,8,Very Positive,128,14,142
598070,8,Very Positive,137,13,150
598230,0,3 user reviews,3,0,3
598330,6,Mostly Positive,1079,296,1375
598350,7,Positive,25,4,29
598440,6,Mostly Positive,148,55,203
598470,5,Mixed,139,131,270
598480,6,Mostly Positive,51,16,67
598490,8,Very Positive,67,4,71
598500,0,9 user reviews,6,3,9
598610,6,Mostly Positive,11,3,14
598640,0,No user reviews,0,0,0
598670,7,Positive,18,1,19
598680,5,Mixed,22,29,51
598690,6,Mostly Positive,83,34,117
598700,8,Very Positive,991,91,1082
598820,5,Mixed,40,32,72
598840,7,Positive,9,1,10
598880,7,Positive,34,1,35
598940,6,Mostly Positive,37,12,49
598960,8,Very Positive,799,115,914
599010,4,Mostly Negative,20,44,64
599060,5,Mixed,15,19,34
599100,5,Mixed,39,21,60
599180,0,3 user reviews,2,1,3
599420,0,2 user reviews,2,0,2
599460,8,Very Positive,751,169,920
599480,5,Mixed,44,32,76
599490,0,No user reviews,0,0,0
599510,7,Positive,8,2,10
599560,6,Mostly Positive,44,17,61
599630,5,Mixed,9,4,13
599750,8,Very Positive,485,97,582
599840,7,Positive,27,0,27
599880,5,Mixed,15,13,28
599960,6,Mostly Positive,122,38,160
599990,0,8 user reviews,5,3,8
600000,0,5 user reviews,4,1,5
600190,0,7 user reviews,5,2,7
600210,5,Mixed,22,12,34
600230,0,2 user reviews,2,0,2
600280,6,Mostly Positive,32,13,45
600290,0,4 user reviews,3,1,4
600310,6,Mostly Positive,19,5,24
600370,8,Very Positive,456,8,464
600410,6,Mostly Positive,17,5,22
600430,0,4 user reviews,3,1,4
600440,0,3 user reviews,2,1,3
600460,8,Very Positive,81,17,98
600530,0,8 user reviews,8,0,8
600630,5,Mixed,58,30,88
600640,0,9 user reviews,8,1,9
600740,5,Mixed,7,6,13
600750,5,Mixed,195,196,391
601010,6,Mostly Positive,108,38,146
601020,5,Mixed,7,7,14
601050,8,Very Positive,342,53,395
601110,0,3 user reviews,2,1,3
601120,7,Positive,33,0,33
601130,0,7 user reviews,7,0,7
601240,5,Mixed,11,6,17
601380,4,Mostly Negative,31,54,85
601430,8,Very Positive,6688,553,7241
601500,5,Mixed,11,6,17
601510,8,Very Positive,4939,1221,6160
601530,8,Very Positive,222,23,245
601570,7,Positive,18,4,22
601640,5,Mixed,29,26,55
601650,6,Mostly Positive,191,52,243
601770,8,Very Positive,161,25,186
601790,7,Positive,20,4,24
601810,8,Very Positive,217,20,237
601870,5,Mixed,9,7,16
601920,7,Positive,9,1,10
601930,7,Positive,20,4,24
601980,5,Mixed,164,144,308
602070,7,Positive,34,1,35
602080,7,Positive,21,0,21
602120,7,Positive,46,1,47
602170,6,Mostly Positive,31,10,41
602480,7,Positive,35,4,39
602520,9,Overwhelmingly Positive,6265,154,6419
602590,6,Mostly Positive,23,9,32
602790,0,5 user reviews,4,1,5
602880,0,5 user reviews,4,1,5
602890,5,Mixed,351,157,508
602930,5,Mixed,27,19,46
602940,5,Mixed,46,38,84
602990,6,Mostly Positive,167,57,224
603020,6,Mostly Positive,68,25,93
603040,6,Mostly Positive,43,16,59
603060,7,Positive,11,1,12
603090,6,Mostly Positive,7,3,10
603100,8,Very Positive,75,16,91
603120,5,Mixed,20,26,46
603130,5,Mixed,55,27,82
603140,8,Very Positive,123,20,143
603150,4,Mostly Negative,16,25,41
603220,7,Positive,12,1,13
603230,7,Positive,13,0,13
603250,5,Mixed,10,10,20
603260,8,Very Positive,395,45,440
603290,5,Mixed,25,27,52
603330,8,Very Positive,47,4,51
603350,8,Very Positive,100,22,122
603360,5,Mixed,33,32,65
603400,6,Mostly Positive,30,12,42
603420,7,Positive,19,2,21
603450,0,3 user reviews,3,0,3
603530,8,Very Positive,213,18,231
603550,3,Negative,1,9,10
603570,6,Mostly Positive,76,23,99
603750,4,Mostly Negative,40,69,109
603800,6,Mostly Positive,70,26,96
603810,8,Very Positive,46,5,51
603840,6,Mostly Positive,11,3,14
603870,7,Positive,14,1,15
603890,5,Mixed,58,72,130
603940,8,Very Positive,94,22,116
603960,8,Very Positive,354,3,357
604000,7,Positive,41,6,47
604010,7,Positive,19,3,22
604040,0,8 user reviews,5,3,8
604160,5,Mixed,32,28,60
604170,7,Positive,28,5,33
604240,8,Very Positive,320,45,365
604450,8,Very Positive,3589,346,3935
604490,5,Mixed,615,301,916
604550,0,1 user reviews,1,0,1
604570,5,Mixed,80,78,158
604740,6,Mostly Positive,87,33,120
604780,6,Mostly Positive,152,53,205
604810,5,Mixed,28,38,66
604920,0,8 user reviews,8,0,8
604950,5,Mixed,9,10,19
604980,7,Positive,16,2,18
605210,7,Positive,12,2,14
605220,7,Positive,25,5,30
605250,7,Positive,16,1,17
605310,5,Mixed,28,16,44
605490,0,8 user reviews,6,2,8
605500,6,Mostly Positive,321,111,432
605510,6,Mostly Positive,28,12,40
605520,5,Mixed,65,33,98
605530,5,Mixed,67,32,99
605610,8,Very Positive,437,47,484
605910,4,Mostly Negative,30,60,90
605990,8,Very Positive,131,5,136
606000,7,Positive,38,6,44
606030,0,7 user reviews,5,2,7
606060,0,8 user reviews,3,5,8
606150,6,Mostly Positive,1261,407,1668
606190,7,Positive,16,2,18
606300,0,8 user reviews,8,0,8
606330,6,Mostly Positive,94,25,119
606370,5,Mixed,58,42,100
606480,8,Very Positive,121,2,123
606500,0,No user reviews,0,0,0
606510,8,Very Positive,85,8,93
606520,7,Positive,35,0,35
606690,7,Positive,38,4,42
606710,8,Very Positive,108,6,114
606720,0,4 user reviews,4,0,4
606730,5,Mixed,102,48,150
606800,6,Mostly Positive,1119,310,1429
606850,0,2 user reviews,1,1,2
606860,5,Mixed,95,48,143
606890,8,Very Positive,79,7,86
606950,5,Mixed,15,10,25
607030,0,5 user reviews,3,2,5
607040,7,Positive,10,2,12
607160,0,2 user reviews,2,0,2
607180,0,No user reviews,0,0,0
607210,5,Mixed,10,8,18
607230,0,1 user reviews,1,0,1
607330,7,Positive,15,0,15
607400,8,Very Positive,94,7,101
607660,6,Mostly Positive,28,10,38
607700,5,Mixed,26,21,47
607720,0,5 user reviews,4,1,5
607760,7,Positive,12,1,13
607820,0,No user reviews,0,0,0
607880,8,Very Positive,424,87,511
607890,8,Very Positive,1995,418,2413
608390,5,Mixed,53,52,105
608440,0,6 user reviews,6,0,6
608530,5,Mixed,81,54,135
608540,5,Mixed,6,4,10
608560,6,Mostly Positive,139,42,181
608660,7,Positive,41,2,43
608760,7,Positive,36,6,42
608800,6,Mostly Positive,388,113,501
608830,5,Mixed,15,13,28
608990,5,Mixed,122,117,239
609150,6,Mostly Positive,390,148,538
609170,5,Mixed,25,11,36
609320,8,Very Positive,1483,115,1598
609400,0,1 user reviews,0,1,1
609410,7,Positive,43,5,48
609420,0,No user reviews,0,0,0
609490,8,Very Positive,319,23,342
609720,7,Positive,10,2,12
609760,7,Positive,20,2,22
609940,6,Mostly Positive,427,171,598
610080,8,Very Positive,1588,339,1927
610130,8,Very Positive,84,21,105
610180,8,Very Positive,170,32,202
610190,6,Mostly Positive,244,67,311
610250,7,Positive,18,0,18
610310,8,Very Positive,91,11,102
610350,5,Mixed,12,9,21
610360,8,Very Positive,986,81,1067
610380,5,Mixed,76,46,122
610410,7,Positive,27,0,27
610500,6,Mostly Positive,143,41,184
610610,7,Positive,15,3,18
610660,5,Mixed,8,7,15
610670,5,Mixed,34,43,77
610680,6,Mostly Positive,50,15,65
610730,0,6 user reviews,6,0,6
610750,6,Mostly Positive,106,43,149
610810,5,Mixed,243,136,379
610840,7,Positive,44,1,45
610930,4,Mostly Negative,109,167,276
610960,8,Very Positive,569,76,645
611020,0,No user reviews,0,0,0
611040,5,Mixed,88,45,133
611050,0,6 user reviews,4,2,6
611060,7,Positive,41,6,47
611080,0,1 user reviews,1,0,1
611140,5,Mixed,11,10,21
611160,8,Very Positive,155,8,163
611230,0,No user reviews,0,0,0
611320,7,Positive,27,1,28
611500,5,Mixed,8546,3790,12336
611530,5,Mixed,60,38,98
611620,6,Mostly Positive,62,17,79
611630,7,Positive,21,3,24
611660,6,Mostly Positive,2248,949,3197
611670,8,Very Positive,1692,239,1931
611750,5,Mixed,50,41,91
611770,7,Positive,28,5,33
611780,7,Positive,44,2,46
611790,8,Very Positive,1585,302,1887
611800,5,Mixed,148,91,239
611820,0,No user reviews,0,0,0
611850,7,Positive,21,3,24
611960,7,Positive,36,1,37
611980,8,Very Positive,678,56,734
612010,0,3 user reviews,2,1,3
612020,8,Very Positive,816,114,930
612070,8,Very Positive,749,181,930
612100,8,Very Positive,71,5,76
612110,8,Very Positive,191,34,225
612140,0,8 user reviews,8,0,8
612150,0,5 user reviews,3,2,5
612160,7,Positive,10,0,10
612170,8,Very Positive,70,12,82
612250,4,Mostly Negative,5,9,14
612310,7,Positive,16,1,17
612370,8,Very Positive,138,8,146
612390,8,Very Positive,95,12,107
612470,8,Very Positive,487,53,540
612510,6,Mostly Positive,33,13,46
612590,7,Positive,30,3,33
612600,7,Positive,14,0,14
612610,4,Mostly Negative,31,57,88
612620,6,Mostly Positive,115,31,146
612670,7,Positive,33,8,41
612720,6,Mostly Positive,188,49,237
612740,8,Very Positive,65,10,75
612750,0,No user reviews,0,0,0
612810,5,Mixed,8,10,18
612820,5,Mixed,35,17,52
612840,0,6 user reviews,6,0,6
612880,6,Mostly Positive,8845,3403,12248
612890,0,9 user reviews,9,0,9
612930,8,Very Positive,520,88,608
613010,5,Mixed,52,25,77
613020,7,Positive,10,1,11
613050,0,No user reviews,0,0,0
613100,6,Mostly Positive,2747,746,3493
613120,0,5 user reviews,5,0,5
613130,7,Positive,25,1,26
613190,8,Very Positive,143,14,157
613200,0,9 user reviews,9,0,9
613210,7,Positive,31,2,33
613270,5,Mixed,94,84,178
613390,8,Very Positive,97,6,103
613400,0,5 user reviews,3,2,5
613450,8,Very Positive,84,8,92
613470,8,Very Positive,79,7,86
613670,8,Very Positive,143,34,177
613730,6,Mostly Positive,527,176,703
613790,5,Mixed,13,6,19
613830,5,Mixed,426,220,646
613860,6,Mostly Positive,15,6,21
613970,0,9 user reviews,4,5,9
614030,6,Mostly Positive,86,25,111
614090,0,9 user reviews,9,0,9
614140,5,Mixed,11,7,18
614150,0,8 user reviews,8,0,8
614570,8,Very Positive,2134,396,2530
614630,6,Mostly Positive,154,39,193
614660,7,Positive,18,3,21
614850,0,3 user reviews,2,1,3
614860,6,Mostly Positive,115,40,155
614880,0,7 user reviews,3,4,7
614890,6,Mostly Positive,27,9,36
614900,5,Mixed,19,15,34
614910,8,Very Positive,270,39,309
614950,8,Very Positive,73,5,78
614960,7,Positive,38,3,41
614970,5,Mixed,24,11,35
615010,8,Very Positive,68,6,74
615080,0,6 user reviews,4,2,6
615090,7,Positive,37,7,44
615160,0,4 user reviews,2,2,4
615180,8,Very Positive,47,9,56
615330,7,Positive,14,0,14
615340,5,Mixed,32,35,67
615350,7,Positive,36,8,44
615390,0,4 user reviews,0,4,4
615400,4,Mostly Negative,28,43,71
615490,6,Mostly Positive,9,3,12
615550,0,4 user reviews,3,1,4
615610,9,Overwhelmingly Positive,1473,28,1501
615670,7,Positive,35,6,41
615970,5,Mixed,60,42,102
616000,8,Very Positive,80,4,84
616030,7,Positive,22,1,23
616040,0,8 user reviews,7,1,8
616240,5,Mixed,47,36,83
616250,8,Very Positive,419,12,431
616360,5,Mixed,83,78,161
616520,7,Positive,28,0,28
616610,0,No user reviews,0,0,0
616640,0,4 user reviews,4,0,4
616650,0,3 user reviews,0,3,3
616740,8,Very Positive,207,21,228
616750,0,5 user reviews,5,0,5
616860,0,No user reviews,0,0,0
616880,7,Positive,18,1,19
616890,7,Positive,14,0,14
617020,0,8 user reviews,4,4,8
617030,5,Mixed,79,60,139
617060,7,Positive,9,2,11
617160,8,Very Positive,786,133,919
617240,4,Mostly Negative,52,79,131
617270,0,8 user reviews,8,0,8
617360,0,3 user reviews,3,0,3
617420,5,Mixed,23,16,39
617440,8,Very Positive,131,5,136
617480,8,Very Positive,444,41,485
617610,7,Positive,45,4,49
617620,0,5 user reviews,5,0,5
617630,5,Mixed,16,8,24
617660,8,Very Positive,280,32,312
617680,6,Mostly Positive,11,4,15
617690,7,Positive,25,0,25
617700,8,Very Positive,216,39,255
617710,5,Mixed,41,34,75
617820,7,Positive,37,2,39
617830,8,Very Positive,1306,158,1464
617970,0,6 user reviews,6,0,6
618030,4,Mostly Negative,30,72,102
618050,5,Mixed,41,48,89
618070,7,Positive,18,0,18
618080,8,Very Positive,344,70,414
618120,6,Mostly Positive,78,20,98
618140,5,Mixed,21,12,33
618170,7,Positive,21,5,26
618190,0,5 user reviews,5,0,5
618270,6,Mostly Positive,16,6,22
618310,8,Very Positive,53,12,65
618360,7,Positive,19,4,23
618370,7,Positive,23,1,24
618470,7,Positive,16,1,17
618490,5,Mixed,11,11,22
618510,8,Very Positive,197,14,211
618550,7,Positive,35,1,36
618610,6,Mostly Positive,64,27,91
618630,6,Mostly Positive,9,3,12
618640,7,Positive,14,3,17
618650,0,6 user reviews,5,1,6
618670,0,6 user reviews,4,2,6
618690,7,Positive,39,3,42
618720,8,Very Positive,168,6,174
618750,0,7 user reviews,6,1,7
618950,8,Very Positive,84,3,87
618970,8,Very Positive,224,28,252
618990,0,No user reviews,0,0,0
619000,0,3 user reviews,1,2,3
619010,0,8 user reviews,6,2,8
619080,4,Mostly Negative,1515,2692,4207
619100,0,1 user reviews,1,0,1
619140,0,7 user reviews,1,6,7
619220,0,7 user reviews,7,0,7
619280,8,Very Positive,153,20,173
619290,8,Very Positive,226,29,255
619340,5,Mixed,24,11,35
619350,7,Positive,13,3,16
619380,0,5 user reviews,5,0,5
619400,4,Mostly Negative,57,108,165
619470,0,7 user reviews,5,2,7
619600,6,Mostly Positive,22,9,31
619700,0,No user reviews,0,0,0
619730,5,Mixed,36,32,68
619780,5,Mixed,492,471,963
619810,7,Positive,25,1,26
619870,7,Positive,44,3,47
619880,6,Mostly Positive,458,134,592
619890,7,Positive,24,2,26
620070,0,No user reviews,0,0,0
620130,0,4 user reviews,4,0,4
620140,0,4 user reviews,2,2,4
620170,7,Positive,31,4,35
620180,0,No user reviews,0,0,0
620190,8,Very Positive,121,24,145
620200,7,Positive,45,2,47
620210,8,Very Positive,66,4,70
620220,8,Very Positive,67,9,76
620240,8,Very Positive,211,40,251
620280,0,8 user reviews,8,0,8
620330,0,4 user reviews,3,1,4
620340,7,Positive,16,0,16
620530,8,Very Positive,129,24,153
620580,0,8 user reviews,5,3,8
620590,8,Very Positive,766,184,950
620630,0,2 user reviews,1,1,2
620640,0,1 user reviews,1,0,1
620650,7,Positive,39,1,40
620700,5,Mixed,21,19,40
620710,7,Positive,20,3,23
620800,0,7 user reviews,6,1,7
620900,7,Positive,15,0,15
620940,7,Positive,22,0,22
621010,7,Positive,15,1,16
621020,5,Mixed,47,24,71
621050,5,Mixed,11,15,26
621080,8,Very Positive,48,3,51
621090,0,No user reviews,0,0,0
621220,6,Mostly Positive,268,71,339
621780,5,Mixed,6,4,10
621810,8,Very Positive,79,16,95
621830,5,Mixed,534,229,763
621850,7,Positive,13,1,14
621880,5,Mixed,98,134,232
621930,8,Very Positive,87,12,99
621940,7,Positive,33,6,39
621970,6,Mostly Positive,25,7,32
622020,5,Mixed,14,7,21
622060,8,Very Positive,65,14,79
622080,4,Mostly Negative,6,15,21
622170,5,Mixed,188,97,285
622370,5,Mixed,92,43,135
622420,8,Very Positive,49,11,60
622460,8,Very Positive,103,15,118
622480,0,8 user reviews,8,0,8
622510,0,1 user reviews,1,0,1
622650,8,Very Positive,6341,815,7156
622700,5,Mixed,8,4,12
622770,6,Mostly Positive,120,37,157
622810,7,Positive,16,0,16
622870,8,Very Positive,89,5,94
622880,6,Mostly Positive,21,9,30
622890,7,Positive,21,1,22
622910,7,Positive,19,3,22
622920,5,Mixed,25,29,54
622930,0,5 user reviews,5,0,5
623070,6,Mostly Positive,34,12,46
623080,9,Overwhelmingly Positive,750,9,759
623090,8,Very Positive,78,18,96
623160,7,Positive,15,1,16
623170,7,Positive,16,1,17
623180,0,7 user reviews,6,1,7
623320,7,Positive,19,0,19
623370,0,7 user reviews,5,2,7
623380,7,Positive,18,1,19
623550,5,Mixed,31,25,56
623640,8,Very Positive,59,6,65
623700,0,No user reviews,0,0,0
623810,5,Mixed,46,20,66
623900,5,Mixed,12,8,20
623940,8,Very Positive,2479,140,2619
624050,0,6 user reviews,5,1,6
624090,5,Mixed,3155,1993,5148
624120,5,Mixed,50,41,91
624270,8,Very Positive,159,20,179
624320,7,Positive,27,2,29
624430,5,Mixed,9,8,17
624680,6,Mostly Positive,12,5,17
624710,7,Positive,11,1,12
624780,0,3 user reviews,2,1,3
624830,7,Positive,26,2,28
624900,0,No user reviews,0,0,0
624910,5,Mixed,271,303,574
624970,8,Very Positive,181,21,202
624990,0,8 user reviews,8,0,8
625040,5,Mixed,11,6,17
625120,7,Positive,26,4,30
625180,0,8 user reviews,2,6,8
625320,7,Positive,11,1,12
625370,5,Mixed,26,19,45
625400,5,Mixed,173,190,363
625430,5,Mixed,282,149,431
625470,8,Very Positive,103,8,111
625560,0,8 user reviews,8,0,8
625630,0,3 user reviews,3,0,3
625680,7,Positive,28,2,30
625700,6,Mostly Positive,10,3,13
625730,7,Positive,31,2,33
625740,0,No user reviews,0,0,0
625770,7,Positive,15,2,17
625830,7,Positive,21,1,22
625910,7,Positive,36,1,37
625980,8,Very Positive,136,3,139
625990,7,Positive,25,3,28
626010,6,Mostly Positive,106,43,149
626160,5,Mixed,10,5,15
626170,0,7 user reviews,6,1,7
626200,4,Mostly Negative,20,53,73
626250,7,Positive,18,4,22
626510,6,Mostly Positive,62,16,78
626580,7,Positive,32,7,39
626600,8,Very Positive,46,9,55
626610,6,Mostly Positive,294,120,414
626630,5,Mixed,10,6,16
626640,7,Positive,11,0,11
626690,6,Mostly Positive,3668,1313,4981
626760,0,9 user reviews,2,7,9
627070,7,Positive,37,6,43
627220,0,5 user reviews,5,0,5
627270,8,Very Positive,2242,476,2718
627420,0,5 user reviews,4,1,5
627450,5,Mixed,22,31,53
627460,5,Mixed,8,5,13
627530,0,7 user reviews,7,0,7
627620,5,Mixed,45,52,97
627670,7,Positive,30,1,31
627690,8,Very Positive,1855,431,2286
627820,5,Mixed,34,15,49
627910,5,Mixed,48,44,92
628290,8,Very Positive,112,15,127
628330,0,No user reviews,0,0,0
628420,5,Mixed,95,72,167
628460,7,Positive,32,2,34
628490,5,Mixed,155,139,294
628530,5,Mixed,9,4,13
628560,0,8 user reviews,4,4,8
628580,0,5 user reviews,3,2,5
628650,0,2 user reviews,0,2,2
628660,7,Positive,44,5,49
628750,8,Very Positive,239,47,286
628770,8,Very Positive,320,29,349
628800,8,Very Positive,78,2,80
628840,5,Mixed,21,23,44
628850,5,Mixed,23,12,35
628860,5,Mixed,8,7,15
628890,4,Mostly Negative,89,202,291
628900,5,Mixed,42,37,79
628920,8,Very Positive,65,8,73
628950,6,Mostly Positive,73,31,104
629000,8,Very Positive,196,17,213
629030,4,Mostly Negative,22,73,95
629220,8,Very Positive,229,50,279
629280,4,Mostly Negative,59,102,161
629340,0,No user reviews,0,0,0
629350,0,1 user reviews,1,0,1
629360,0,4 user reviews,2,2,4
629400,5,Mixed,6,4,10
629410,7,Positive,12,0,12
629420,0,4 user reviews,4,0,4
629430,7,Positive,29,1,30
629540,7,Positive,33,5,38
629650,8,Very Positive,174,6,180
629690,8,Very Positive,261,25,286
629770,8,Very Positive,160,19,179
629840,6,Mostly Positive,274,70,344
629860,7,Positive,16,3,19
629960,6,Mostly Positive,139,45,184
630020,7,Positive,22,3,25
630030,8,Very Positive,90,16,106
630050,6,Mostly Positive,19,5,24
630060,8,Very Positive,308,9,317
630070,7,Positive,10,0,10
630080,0,8 user reviews,8,0,8
630140,0,No user reviews,0,0,0
630160,7,Positive,16,2,18
630310,8,Very Positive,122,23,145
630460,7,Positive,24,0,24
630690,0,5 user reviews,3,2,5
630720,0,No user reviews,0,0,0
630790,0,1 user reviews,1,0,1
630830,7,Positive,12,0,12
631010,5,Mixed,52,40,92
631220,0,5 user reviews,3,2,5
631490,7,Positive,23,2,25
631510,8,Very Positive,547,105,652
631540,5,Mixed,54,63,117
631660,6,Mostly Positive,52,18,70
631770,7,Positive,21,2,23
631830,6,Mostly Positive,13,4,17
631900,8,Very Positive,116,5,121
631920,7,Positive,16,4,20
631980,8,Very Positive,81,11,92
631990,6,Mostly Positive,15,4,19
632000,8,Very Positive,198,36,234
632020,6,Mostly Positive,35,12,47
632050,5,Mixed,8,6,14
632070,8,Very Positive,286,64,350
632080,0,5 user reviews,5,0,5
632100,5,Mixed,14,8,22
632110,0,No user reviews,0,0,0
632170,6,Mostly Positive,20,6,26
632200,0,5 user reviews,1,4,5
632290,7,Positive,13,3,16
632350,8,Very Positive,2064,268,2332
632380,0,4 user reviews,2,2,4
632470,0,No user reviews,0,0,0
632800,7,Positive,41,6,47
632840,7,Positive,12,3,15
632880,0,9 user reviews,9,0,9
633060,6,Mostly Positive,274,78,352
633130,5,Mixed,211,135,346
633350,5,Mixed,9,6,15
633360,8,Very Positive,528,130,658
633370,8,Very Positive,175,19,194
633440,7,Positive,15,3,18
633460,8,Very Positive,1725,292,2017
633580,6,Mostly Positive,8,3,11
633880,5,Mixed,28,40,68
633930,7,Positive,16,0,16
633950,5,Mixed,101,47,148
634090,5,Mixed,14,11,25
634120,5,Mixed,34,27,61
634150,0,7 user reviews,3,4,7
634160,8,Very Positive,266,8,274
634180,6,Mostly Positive,23,9,32
634200,7,Positive,23,4,27
634340,7,Positive,28,1,29
634700,5,Mixed,96,69,165
635070,8,Very Positive,209,27,236
635200,6,Mostly Positive,636,171,807
635250,6,Mostly Positive,255,96,351
635260,8,Very Positive,1857,215,2072
635310,8,Very Positive,103,16,119
635320,8,Very Positive,1185,138,1323
635390,0,No user reviews,0,0,0
635410,8,Very Positive,40,10,50
635430,0,3 user reviews,2,1,3
635550,7,Positive,36,8,44
635590,0,7 user reviews,5,2,7
635670,6,Mostly Positive,64,25,89
635730,8,Very Positive,3579,498,4077
635790,0,9 user reviews,9,0,9
635830,0,4 user reviews,2,2,4
635850,7,Positive,40,0,40
635900,6,Mostly Positive,17,6,23
635930,0,2 user reviews,2,0,2
635940,8,Very Positive,252,2,254
636070,7,Positive,8,2,10
636100,8,Very Positive,284,33,317
636150,8,Very Positive,181,34,215
636170,5,Mixed,23,11,34
636220,7,Positive,17,0,17
636230,5,Mixed,10,8,18
636310,0,7 user reviews,4,3,7
636320,0,No user reviews,0,0,0
636330,6,Mostly Positive,12,4,16
636390,7,Positive,33,3,36
636400,6,Mostly Positive,25,10,35
636450,8,Very Positive,449,42,491
636570,8,Very Positive,137,34,171
636910,0,7 user reviews,7,0,7
636960,6,Mostly Positive,38,11,49
637060,6,Mostly Positive,32,13,45
637090,6,Mostly Positive,5448,1396,6844
637100,5,Mixed,1524,784,2308
637120,7,Positive,12,1,13
637340,0,No user reviews,0,0,0
637650,8,Very Positive,7397,1666,9063
637670,5,Mixed,729,432,1161
637850,8,Very Positive,2759,166,2925
637860,5,Mixed,75,49,124
637870,0,6 user reviews,5,1,6
637880,8,Very Positive,100,5,105
638000,8,Very Positive,110,6,116
638070,6,Mostly Positive,160,52,212
638110,8,Very Positive,224,36,260
638160,6,Mostly Positive,215,76,291
638680,6,Mostly Positive,41,16,57
638720,5,Mixed,7,4,11
638780,0,4 user reviews,4,0,4
638850,6,Mostly Positive,228,67,295
639130,8,Very Positive,171,13,184
639170,8,Very Positive,839,80,919
639240,0,3 user reviews,1,2,3
639270,8,Very Positive,156,4,160
639300,5,Mixed,40,19,59
639320,0,8 user reviews,6,2,8
639450,7,Positive,25,5,30
639470,8,Very Positive,66,14,80
639490,7,Positive,44,0,44
639560,0,8 user reviews,6,2,8
639650,8,Very Positive,440,23,463
639720,8,Very Positive,48,9,57
639770,7,Positive,19,1,20
639780,9,Overwhelmingly Positive,1045,49,1094
639790,9,Overwhelmingly Positive,5024,155,5179
639840,6,Mostly Positive,12,5,17
639920,0,3 user reviews,1,2,3
640050,5,Mixed,171,145,316
640120,7,Positive,14,0,14
640150,5,Mixed,258,270,528
640210,8,Very Positive,47,9,56
640290,0,8 user reviews,8,0,8
640300,7,Positive,25,4,29
640310,4,Mostly Negative,32,60,92
640330,5,Mixed,35,23,58
640380,8,Very Positive,146,4,150
640430,5,Mixed,42,19,61
640590,8,Very Positive,126,25,151
640600,0,3 user reviews,0,3,3
640850,5,Mixed,23,10,33
640880,7,Positive,21,0,21
640890,7,Positive,17,1,18
640970,6,Mostly Positive,62,16,78
640990,8,Very Positive,67,6,73
641320,0,No user reviews,0,0,0
641910,5,Mixed,20,11,31
641980,7,Positive,42,7,49
641990,8,Very Positive,3340,830,4170
642000,7,Positive,21,4,25
642090,8,Very Positive,234,17,251
642170,7,Positive,21,3,24
642520,5,Mixed,32,25,57
642560,8,Very Positive,270,17,287
642580,8,Very Positive,41,9,50
642600,7,Positive,11,0,11
642610,8,Very Positive,66,0,66
642650,7,Positive,29,1,30
642710,0,No user reviews,0,0,0
642730,7,Positive,18,1,19
642830,6,Mostly Positive,14,4,18
643260,0,6 user reviews,5,1,6
643270,9,Overwhelmingly Positive,3506,180,3686
643570,7,Positive,15,0,15
643590,5,Mixed,14,10,24
643600,4,Mostly Negative,24,84,108
643610,7,Positive,32,7,39
643700,6,Mostly Positive,23,9,32
643820,0,No user reviews,0,0,0
643870,8,Very Positive,209,13,222
643880,8,Very Positive,281,11,292
643900,7,Positive,33,4,37
643930,0,No user reviews,0,0,0
643950,0,9 user reviews,4,5,9
643960,8,Very Positive,73,14,87
643980,6,Mostly Positive,120,51,171
644080,8,Very Positive,60,13,73
644100,6,Mostly Positive,104,33,137
644110,0,7 user reviews,6,1,7
644130,4,Mostly Negative,8,28,36
644200,8,Very Positive,93,20,113
644290,5,Mixed,275,172,447
644310,6,Mostly Positive,195,70,265
644380,5,Mixed,7,4,11
644390,8,Very Positive,159,29,188
644480,6,Mostly Positive,116,42,158
644550,8,Very Positive,198,20,218
644560,9,Overwhelmingly Positive,9352,278,9630
644640,5,Mixed,134,96,230
644680,0,4 user reviews,3,1,4
644760,5,Mixed,6,7,13
644930,8,Very Positive,8157,1302,9459
645090,8,Very Positive,1180,104,1284
645260,5,Mixed,327,170,497
645330,0,9 user reviews,5,4,9
645340,5,Mixed,20,9,29
645360,0,5 user reviews,1,4,5
645380,7,Positive,17,3,20
645450,7,Positive,32,6,38
645460,6,Mostly Positive,26,11,37
645630,6,Mostly Positive,6637,1995,8632
645690,8,Very Positive,116,9,125
645710,5,Mixed,73,58,131
645750,7,Positive,21,0,21
645760,6,Mostly Positive,60,21,81
645780,0,7 user reviews,5,2,7
645820,8,Very Positive,59,1,60
645860,6,Mostly Positive,7,3,10
645920,7,Positive,38,7,45
646010,6,Mostly Positive,12,5,17
646050,4,Mostly Negative,14,26,40
646200,8,Very Positive,523,96,619
646210,7,Positive,17,1,18
646240,0,No user reviews,0,0,0
646280,7,Positive,12,1,13
646300,0,9 user reviews,7,2,9
646330,0,5 user reviews,5,0,5
646370,7,Positive,15,0,15
646380,7,Positive,9,1,10
646450,5,Mixed,113,102,215
646460,7,Positive,11,0,11
646470,7,Positive,31,5,36
646500,8,Very Positive,138,19,157
646570,9,Overwhelmingly Positive,13118,503,13621
646600,6,Mostly Positive,64,23,87
646960,5,Mixed,17,17,34
647040,7,Positive,40,6,46
647050,5,Mixed,8,6,14
647280,4,Mostly Negative,6,17,23
647570,0,No user reviews,0,0,0
647820,0,No user reviews,0,0,0
647830,6,Mostly Positive,530,153,683
647990,7,Positive,14,1,15
648070,5,Mixed,14,10,24
648190,0,8 user reviews,8,0,8
648350,6,Mostly Positive,5158,2022,7180
648380,0,1 user reviews,0,1,1
648390,9,Overwhelmingly Positive,2360,123,2483
648430,5,Mixed,657,446,1103
648530,0,3 user reviews,1,2,3
648550,6,Mostly Positive,8,3,11
648570,6,Mostly Positive,11,3,14
648580,0,No user reviews,0,0,0
648590,0,No user reviews,0,0,0
648630,5,Mixed,9,13,22
648750,7,Positive,25,6,31
648780,6,Mostly Positive,22,7,29
648800,8,Very Positive,5524,1208,6732
648810,6,Mostly Positive,15,6,21
648880,0,9 user reviews,9,0,9
649000,0,5 user reviews,4,1,5
649170,7,Positive,26,5,31
649190,0,No user reviews,0,0,0
649300,0,6 user reviews,2,4,6
649360,7,Positive,19,3,22
649450,7,Positive,27,6,33
649460,0,9 user reviews,6,3,9
649510,4,Mostly Negative,3,7,10
649570,0,5 user reviews,5,0,5
649640,6,Mostly Positive,82,31,113
649670,5,Mixed,14,10,24
649730,0,5 user reviews,3,2,5
649790,6,Mostly Positive,54,21,75
649810,6,Mostly Positive,38,11,49
649820,0,4 user reviews,4,0,4
649880,5,Mixed,19,12,31
649900,5,Mixed,150,116,266
649990,7,Positive,18,2,20
650000,5,Mixed,730,476,1206
650010,0,6 user reviews,4,2,6
650070,7,Positive,46,3,49
650110,5,Mixed,93,67,160
650120,0,No user reviews,0,0,0
650220,8,Very Positive,107,16,123
650350,5,Mixed,72,46,118
650440,6,Mostly Positive,147,47,194
650490,4,Mostly Negative,25,47,72
650510,0,No user reviews,0,0,0
650570,8,Very Positive,50,1,51
650580,0,7 user reviews,2,5,7
650680,5,Mixed,21,11,32
650690,0,No user reviews,0,0,0
650720,0,No user reviews,0,0,0
650750,7,Positive,40,6,46
650780,8,Very Positive,247,17,264
650810,5,Mixed,4,6,10
650860,5,Mixed,18,11,29
650940,8,Very Positive,55,3,58
651010,0,5 user reviews,5,0,5
651060,6,Mostly Positive,10,3,13
651170,0,7 user reviews,5,2,7
651340,7,Positive,28,6,34
651470,6,Mostly Positive,69,21,90
651490,0,No user reviews,0,0,0
651500,0,No user reviews,0,0,0
651550,6,Mostly Positive,10,3,13
651560,0,9 user reviews,4,5,9
651660,6,Mostly Positive,220,59,279
651680,7,Positive,11,2,13
651690,0,4 user reviews,3,1,4
651970,0,4 user reviews,2,2,4
651990,0,1 user reviews,1,0,1
652000,0,6 user reviews,5,1,6
652040,0,4 user reviews,2,2,4
652050,7,Positive,13,1,14
652070,0,4 user reviews,3,1,4
652090,0,3 user reviews,2,1,3
652130,0,5 user reviews,4,1,5
652190,6,Mostly Positive,53,15,68
652200,0,3 user reviews,3,0,3
652230,4,Mostly Negative,8,20,28
652270,0,7 user reviews,6,1,7
652340,7,Positive,22,1,23
652460,0,4 user reviews,4,0,4
652510,0,7 user reviews,7,0,7
652520,0,4 user reviews,4,0,4
652530,7,Positive,9,1,10
652550,2,Very Negative,20,102,122
652560,0,4 user reviews,2,2,4
652570,7,Positive,13,1,14
652730,0,No user reviews,0,0,0
652760,0,6 user reviews,5,1,6
652810,7,Positive,13,0,13
652880,7,Positive,17,0,17
652980,8,Very Positive,4570,742,5312
652990,0,3 user reviews,3,0,3
653080,0,5 user reviews,4,1,5
653100,0,1 user reviews,1,0,1
653120,5,Mixed,79,113,192
653190,7,Positive,15,2,17
653210,5,Mixed,16,8,24
653220,8,Very Positive,147,36,183
653760,6,Mostly Positive,14,6,20
653780,0,7 user reviews,7,0,7
653870,0,4 user reviews,2,2,4
653940,8,Very Positive,55,11,66
653950,8,Very Positive,328,17,345
653970,0,3 user reviews,2,1,3
654010,0,4 user reviews,4,0,4
654020,7,Positive,15,2,17
654050,8,Very Positive,261,37,298
654080,7,Positive,11,1,12
654100,0,No user reviews,0,0,0
654200,0,No user reviews,0,0,0
654220,7,Positive,36,7,43
654240,0,5 user reviews,4,1,5
654260,8,Very Positive,306,51,357
654300,5,Mixed,16,16,32
654390,0,3 user reviews,2,1,3
654430,7,Positive,36,0,36
654440,8,Very Positive,57,5,62
654470,5,Mixed,40,20,60
654490,5,Mixed,16,22,38
654520,7,Positive,13,0,13
654550,7,Positive,42,1,43
654580,0,9 user reviews,9,0,9
654610,7,Positive,9,2,11
654630,0,1 user reviews,1,0,1
654650,5,Mixed,6,4,10
654660,5,Mixed,8,6,14
654670,7,Positive,10,0,10
654700,0,5 user reviews,2,3,5
654710,6,Mostly Positive,27,7,34
654750,7,Positive,10,2,12
654800,0,2 user reviews,1,1,2
654810,7,Positive,16,0,16
654820,0,5 user reviews,3,2,5
654850,5,Mixed,140,68,208
654870,8,Very Positive,137,21,158
654880,8,Very Positive,2556,304,2860
654900,8,Very Positive,238,23,261
654910,7,Positive,13,0,13
654920,6,Mostly Positive,7,3,10
654940,0,4 user reviews,1,3,4
654970,4,Mostly Negative,3,8,11
655000,6,Mostly Positive,20,8,28
655010,8,Very Positive,144,10,154
655020,7,Positive,22,2,24
655030,0,3 user reviews,3,0,3
655080,8,Very Positive,73,12,85
655100,8,Very Positive,156,20,176
655170,5,Mixed,11,12,23
655200,0,3 user reviews,3,0,3
655250,5,Mixed,7,10,17
655260,5,Mixed,66,75,141
655300,5,Mixed,50,51,101
655310,5,Mixed,44,23,67
655340,0,No user reviews,0,0,0
655360,0,2 user reviews,1,1,2
655370,7,Positive,23,0,23
655380,7,Positive,30,1,31
655460,5,Mixed,15,22,37
655470,5,Mixed,7,10,17
655480,8,Very Positive,82,0,82
655490,0,4 user reviews,4,0,4
655600,0,1 user reviews,0,1,1
655610,5,Mixed,6,9,15
655630,0,9 user reviews,7,2,9
655660,7,Positive,8,2,10
655700,3,Negative,3,22,25
655730,8,Very Positive,66,9,75
655760,5,Mixed,11,5,16
655770,8,Very Positive,100,3,103
655790,5,Mixed,58,33,91
655910,7,Positive,37,1,38
655930,4,Mostly Negative,8,17,25
655950,0,7 user reviews,5,2,7
656020,0,1 user reviews,1,0,1
656040,7,Positive,25,3,28
656090,8,Very Positive,619,60,679
656140,5,Mixed,84,71,155
656170,0,No user reviews,0,0,0
656180,4,Mostly Negative,11,28,39
656200,5,Mixed,607,456,1063
656210,6,Mostly Positive,55,21,76
656220,0,5 user reviews,1,4,5
656270,5,Mixed,150,101,251
656290,4,Mostly Negative,11,34,45
656310,4,Mostly Negative,11,26,37
656320,0,8 user reviews,6,2,8
656330,0,9 user reviews,8,1,9
656360,0,5 user reviews,3,2,5
656370,4,Mostly Negative,10,18,28
656380,0,1 user reviews,1,0,1
656440,5,Mixed,8,4,12
656450,6,Mostly Positive,28,12,40
656460,5,Mixed,38,17,55
656510,5,Mixed,18,16,34
656550,8,Very Positive,68,3,71
656570,7,Positive,25,1,26
656580,0,No user reviews,0,0,0
656600,6,Mostly Positive,114,34,148
656610,4,Mostly Negative,17,39,56
656630,0,5 user reviews,4,1,5
656640,0,No user reviews,0,0,0
656680,4,Mostly Negative,11,40,51
656700,0,No user reviews,0,0,0
656710,5,Mixed,13,7,20
656740,0,7 user reviews,6,1,7
656830,0,No user reviews,0,0,0
656880,7,Positive,24,1,25
656970,7,Positive,46,2,48
657040,6,Mostly Positive,26,8,34
657050,8,Very Positive,70,13,83
657080,0,No user reviews,0,0,0
657090,8,Very Positive,55,8,63
657120,7,Positive,28,5,33
657170,0,No user reviews,0,0,0
657200,6,Mostly Positive,4896,1558,6454
657260,6,Mostly Positive,26,7,33
657280,7,Positive,40,2,42
657290,7,Positive,17,4,21
657400,0,4 user reviews,1,3,4
657440,6,Mostly Positive,34,9,43
657470,5,Mixed,18,15,33
657550,0,4 user reviews,4,0,4
657560,0,6 user reviews,5,1,6
657590,5,Mixed,19,11,30
657630,6,Mostly Positive,226,63,289
657680,6,Mostly Positive,100,35,135
657690,8,Very Positive,71,5,76
657700,6,Mostly Positive,10,4,14
657740,6,Mostly Positive,109,34,143
657770,5,Mixed,24,30,54
657860,5,Mixed,66,39,105
657900,6,Mostly Positive,29,10,39
657930,7,Positive,32,0,32
658060,7,Positive,9,1,10
658150,7,Positive,24,0,24
658160,8,Very Positive,196,34,230
658210,0,2 user reviews,2,0,2
658230,7,Positive,12,1,13
658260,8,Very Positive,258,50,308
658320,6,Mostly Positive,181,77,258
658330,7,Positive,11,0,11
658360,0,No user reviews,0,0,0
658420,0,6 user reviews,1,5,6
658430,5,Mixed,7,4,11
658440,0,3 user reviews,1,2,3
658490,5,Mixed,30,15,45
658530,7,Positive,30,1,31
658560,9,Overwhelmingly Positive,545,27,572
658570,6,Mostly Positive,287,78,365
658590,0,No user reviews,0,0,0
658610,4,Mostly Negative,21,50,71
658630,5,Mixed,148,71,219
658660,5,Mixed,15,17,32
658700,0,No user reviews,0,0,0
658710,0,No user reviews,0,0,0
658750,5,Mixed,8,8,16
658760,0,2 user reviews,2,0,2
658770,0,7 user reviews,7,0,7
658790,7,Positive,41,4,45
658810,0,4 user reviews,4,0,4
658850,0,No user reviews,0,0,0
658870,0,7 user reviews,7,0,7
658970,5,Mixed,42,34,76
658980,5,Mixed,337,214,551
658990,7,Positive,31,0,31
659040,7,Positive,14,1,15
659110,8,Very Positive,43,7,50
659130,5,Mixed,20,12,32
659160,0,1 user reviews,0,1,1
659180,0,5 user reviews,5,0,5
659190,8,Very Positive,249,54,303
659220,0,3 user reviews,3,0,3
659250,5,Mixed,72,37,109
659260,7,Positive,10,2,12
659350,5,Mixed,36,38,74
659460,4,Mostly Negative,5,9,14
659480,8,Very Positive,55,12,67
659560,5,Mixed,8,4,12
659570,0,3 user reviews,3,0,3
659720,0,No user reviews,0,0,0
659780,0,No user reviews,0,0,0
659790,0,1 user reviews,1,0,1
659810,0,6 user reviews,1,5,6
659820,4,Mostly Negative,9,17,26
659870,0,3 user reviews,2,1,3
659920,5,Mixed,31,14,45
659940,7,Positive,15,0,15
659950,6,Mostly Positive,10,3,13
660070,7,Positive,12,1,13
660120,0,5 user reviews,1,4,5
660160,8,Very Positive,171,16,187
660170,0,7 user reviews,5,2,7
660270,0,8 user reviews,3,5,8
660290,7,Positive,16,4,20
660320,5,Mixed,8,4,12
660340,5,Mixed,15,18,33
660390,0,9 user reviews,3,6,9
660400,0,8 user reviews,6,2,8
660450,0,3 user reviews,3,0,3
660560,0,6 user reviews,3,3,6
660900,0,9 user reviews,5,4,9
660940,0,5 user reviews,3,2,5
660980,0,6 user reviews,6,0,6
660990,4,Mostly Negative,27,43,70
661000,6,Mostly Positive,98,31,129
661030,7,Positive,10,1,11
661040,6,Mostly Positive,50,19,69
661090,5,Mixed,50,31,81
661110,0,4 user reviews,1,3,4
661120,7,Positive,20,4,24
661270,0,3 user reviews,3,0,3
661280,6,Mostly Positive,31,9,40
661330,0,1 user reviews,1,0,1
661360,0,5 user reviews,5,0,5
661370,5,Mixed,32,38,70
661390,4,Mostly Negative,12,25,37
661420,0,1 user reviews,1,0,1
661430,8,Very Positive,109,9,118
661440,0,7 user reviews,7,0,7
661460,5,Mixed,4,6,10
661480,7,Positive,20,2,22
661490,0,5 user reviews,3,2,5
661560,0,2 user reviews,1,1,2
661590,5,Mixed,15,21,36
661650,0,1 user reviews,1,0,1
661670,0,4 user reviews,2,2,4
661740,6,Mostly Positive,42,14,56
661790,8,Very Positive,239,25,264
661800,5,Mixed,57,31,88
661810,6,Mostly Positive,89,37,126
661820,7,Positive,13,0,13
661830,6,Mostly Positive,27,7,34
661900,0,4 user reviews,2,2,4
661920,6,Mostly Positive,96,30,126
661960,5,Mixed,49,24,73
661990,8,Very Positive,47,8,55
662190,7,Positive,29,3,32
662200,7,Positive,20,1,21
662210,8,Very Positive,87,3,90
662230,7,Positive,19,4,23
662240,0,No user reviews,0,0,0
662320,5,Mixed,634,644,1278
662330,4,Mostly Negative,33,67,100
662380,0,8 user reviews,2,6,8
662390,0,2 user reviews,2,0,2
662410,7,Positive,13,0,13
662470,6,Mostly Positive,10,3,13
662540,8,Very Positive,53,5,58
662570,0,No user reviews,0,0,0
662610,0,2 user reviews,2,0,2
662640,5,Mixed,13,6,19
662680,7,Positive,18,1,19
662690,0,3 user reviews,3,0,3
662730,7,Positive,11,0,11
662840,7,Positive,21,3,24
662910,6,Mostly Positive,22,6,28
662920,7,Positive,20,3,23
662940,0,1 user reviews,1,0,1
663100,0,7 user reviews,5,2,7
663130,7,Positive,15,3,18
663140,0,7 user reviews,6,1,7
663210,7,Positive,25,1,26
663240,8,Very Positive,74,8,82
663250,0,4 user reviews,0,4,4
663300,6,Mostly Positive,234,62,296
663340,4,Mostly Negative,24,48,72
663370,7,Positive,21,1,22
663380,6,Mostly Positive,1001,264,1265
663390,5,Mixed,407,375,782
663480,0,3 user reviews,3,0,3
663530,0,2 user reviews,1,1,2
663540,6,Mostly Positive,10,4,14
663600,0,No user reviews,0,0,0
663730,5,Mixed,25,15,40
663830,0,No user reviews,0,0,0
663920,5,Mixed,7,5,12
664000,8,Very Positive,47,7,54
664040,0,3 user reviews,2,1,3
664050,0,4 user reviews,4,0,4
664090,8,Very Positive,202,24,226
664140,7,Positive,10,1,11
664180,8,Very Positive,485,8,493
664190,0,3 user reviews,3,0,3
664250,7,Positive,9,1,10
664290,4,Mostly Negative,7,11,18
664320,5,Mixed,24,11,35
664340,0,4 user reviews,0,4,4
664420,5,Mixed,6,6,12
664430,5,Mixed,713,753,1466
664460,0,No user reviews,0,0,0
664510,0,6 user reviews,6,0,6
664570,0,7 user reviews,4,3,7
664610,8,Very Positive,63,9,72
664620,5,Mixed,20,11,31
664650,5,Mixed,13,6,19
664660,0,2 user reviews,2,0,2
664750,8,Very Positive,72,2,74
664850,7,Positive,19,0,19
665030,7,Positive,29,6,35
665060,0,1 user reviews,0,1,1
665090,6,Mostly Positive,1216,316,1532
665120,8,Very Positive,122,25,147
665140,5,Mixed,8,4,12
665270,8,Very Positive,226,7,233
665310,0,3 user reviews,3,0,3
665350,0,8 user reviews,7,1,8
665400,5,Mixed,32,48,80
665430,4,Mostly Negative,8,18,26
665440,0,4 user reviews,3,1,4
665490,8,Very Positive,857,114,971
665590,6,Mostly Positive,9,3,12
665600,6,Mostly Positive,27,9,36
665630,0,1 user reviews,1,0,1
665650,7,Positive,8,2,10
665670,4,Mostly Negative,3,7,10
665780,0,No user reviews,0,0,0
665790,0,3 user reviews,3,0,3
665890,6,Mostly Positive,74,24,98
665900,0,2 user reviews,2,0,2
665920,7,Positive,32,4,36
665930,0,9 user reviews,8,1,9
665950,0,3 user reviews,1,2,3
665960,5,Mixed,15,12,27
665980,0,No user reviews,0,0,0
666040,0,6 user reviews,5,1,6
666050,7,Positive,13,1,14
666060,0,1 user reviews,0,1,1
666090,0,5 user reviews,2,3,5
666100,8,Very Positive,56,3,59
666140,8,Very Positive,4488,342,4830
666160,0,9 user reviews,2,7,9
666220,8,Very Positive,3404,378,3782
666250,5,Mixed,20,10,30
666260,5,Mixed,8,11,19
666270,0,No user reviews,0,0,0
666310,5,Mixed,16,12,28
666330,8,Very Positive,53,10,63
666570,6,Mostly Positive,169,52,221
666590,0,5 user reviews,5,0,5
666600,7,Positive,8,2,10
666610,7,Positive,28,3,31
666630,0,No user reviews,0,0,0
666690,5,Mixed,12,12,24
666810,0,8 user reviews,8,0,8
666820,7,Positive,38,5,43
666860,6,Mostly Positive,355,143,498
666910,0,4 user reviews,3,1,4
666940,6,Mostly Positive,28,11,39
667010,7,Positive,25,2,27
667040,0,No user reviews,0,0,0
667060,0,5 user reviews,3,2,5
667120,4,Mostly Negative,12,24,36
667130,6,Mostly Positive,17,6,23
667160,7,Positive,9,2,11
667210,5,Mixed,13,13,26
667220,7,Positive,14,3,17
667240,0,3 user reviews,3,0,3
667310,0,9 user reviews,3,6,9
667340,0,2 user reviews,1,1,2
667360,4,Mostly Negative,9,17,26
667420,5,Mixed,19,12,31
667600,8,Very Positive,357,18,375
667670,0,4 user reviews,3,1,4
667690,0,No user reviews,0,0,0
667720,0,No user reviews,0,0,0
667760,7,Positive,14,0,14
667780,7,Positive,12,0,12
667790,7,Positive,9,2,11
667800,7,Positive,19,0,19
667810,6,Mostly Positive,65,21,86
667870,8,Very Positive,529,94,623
667890,6,Mostly Positive,1245,504,1749
667920,5,Mixed,23,20,43
667960,6,Mostly Positive,49,18,67
668010,0,9 user reviews,8,1,9
668190,0,2 user reviews,2,0,2
668210,8,Very Positive,302,34,336
668230,7,Positive,27,0,27
668280,7,Positive,14,1,15
668350,7,Positive,25,0,25
668510,0,6 user reviews,6,0,6
668520,0,2 user reviews,2,0,2
668560,0,4 user reviews,3,1,4
668590,8,Very Positive,50,2,52
668620,0,No user reviews,0,0,0
668630,8,Very Positive,8726,812,9538
668670,5,Mixed,8,5,13
668730,0,8 user reviews,6,2,8
668790,0,5 user reviews,5,0,5
668830,5,Mixed,24,23,47
668850,0,2 user reviews,1,1,2
668860,0,No user reviews,0,0,0
669000,0,9 user reviews,7,2,9
669050,8,Very Positive,130,14,144
669280,7,Positive,21,0,21
669320,6,Mostly Positive,171,51,222
669340,0,8 user reviews,7,1,8
669350,0,4 user reviews,2,2,4
669360,0,4 user reviews,2,2,4
669380,7,Positive,26,3,29
669390,7,Positive,26,4,30
669410,0,5 user reviews,5,0,5
669490,0,3 user reviews,3,0,3
669520,0,3 user reviews,1,2,3
669630,6,Mostly Positive,75,19,94
669660,6,Mostly Positive,55,23,78
669690,0,No user reviews,0,0,0
669740,0,2 user reviews,2,0,2
669830,0,7 user reviews,7,0,7
669910,7,Positive,13,0,13
669930,7,Positive,12,3,15
669960,6,Mostly Positive,10,3,13
670060,7,Positive,21,0,21
670090,7,Positive,14,0,14
670100,5,Mixed,11,6,17
670160,8,Very Positive,353,19,372
670230,0,3 user reviews,3,0,3
670240,0,6 user reviews,4,2,6
670280,0,7 user reviews,6,1,7
670330,0,3 user reviews,2,1,3
670350,0,No user reviews,0,0,0
670370,3,Negative,2,15,17
670400,0,No user reviews,0,0,0
670440,6,Mostly Positive,11,4,15
670500,5,Mixed,32,17,49
670610,8,Very Positive,57,0,57
670630,7,Positive,10,0,10
670720,0,No user reviews,0,0,0
670730,0,2 user reviews,2,0,2
670770,5,Mixed,31,39,70
670780,0,6 user reviews,3,3,6
670810,5,Mixed,27,29,56
670850,7,Positive,8,2,10
670900,5,Mixed,136,92,228
670930,0,No user reviews,0,0,0
670940,0,1 user reviews,1,0,1
670950,0,8 user reviews,8,0,8
670970,0,No user reviews,0,0,0
671050,0,3 user reviews,2,1,3
671090,8,Very Positive,62,9,71
671120,0,5 user reviews,5,0,5
671170,8,Very Positive,59,8,67
671180,0,7 user reviews,5,2,7
671200,6,Mostly Positive,23,8,31
671240,6,Mostly Positive,34,10,44
671260,6,Mostly Positive,43,18,61
671270,7,Positive,10,2,12
671330,0,7 user reviews,7,0,7
671390,8,Very Positive,142,30,172
671440,8,Very Positive,360,79,439
671540,0,3 user reviews,2,1,3
671550,7,Positive,23,0,23
671560,0,9 user reviews,9,0,9
671580,0,4 user reviews,2,2,4
671650,7,Positive,29,2,31
671670,5,Mixed,7,6,13
671720,8,Very Positive,246,46,292
671760,5,Mixed,133,69,202
671800,6,Mostly Positive,195,54,249
671810,4,Mostly Negative,5,8,13
671840,0,6 user reviews,4,2,6
671850,0,2 user reviews,0,2,2
671860,0,No user reviews,0,0,0
671920,0,9 user reviews,6,3,9
671940,4,Mostly Negative,17,38,55
672010,0,2 user reviews,2,0,2
672020,7,Positive,27,4,31
672030,0,4 user reviews,4,0,4
672040,0,No user reviews,0,0,0
672080,0,4 user reviews,4,0,4
672100,0,6 user reviews,6,0,6
672130,0,4 user reviews,3,1,4
672230,7,Positive,24,6,30
672250,7,Positive,9,1,10
672290,0,8 user reviews,7,1,8
672380,5,Mixed,4,6,10
672490,0,3 user reviews,2,1,3
672590,7,Positive,44,5,49
672650,7,Positive,33,4,37
672680,5,Mixed,398,413,811
672730,8,Very Positive,244,12,256
672780,0,No user reviews,0,0,0
672860,5,Mixed,46,33,79
672920,7,Positive,11,0,11
672940,0,7 user reviews,0,7,7
673000,8,Very Positive,259,36,295
673010,0,7 user reviews,5,2,7
673040,0,2 user reviews,2,0,2
673050,0,4 user reviews,4,0,4
673060,7,Positive,27,0,27
673130,8,Very Positive,276,2,278
673190,8,Very Positive,50,6,56
673210,6,Mostly Positive,47,20,67
673220,0,4 user reviews,3,1,4
673230,0,6 user reviews,6,0,6
673250,0,1 user reviews,1,0,1
673260,6,Mostly Positive,54,18,72
673280,0,7 user reviews,6,1,7
673300,8,Very Positive,51,3,54
673310,0,9 user reviews,5,4,9
673360,0,1 user reviews,1,0,1
673480,7,Positive,9,1,10
673530,0,1 user reviews,1,0,1
673600,8,Very Positive,47,7,54
673630,0,1 user reviews,0,1,1
673660,5,Mixed,38,20,58
673760,6,Mostly Positive,50,18,68
673770,4,Mostly Negative,12,19,31
673780,5,Mixed,21,24,45
673820,6,Mostly Positive,9,3,12
673850,7,Positive,28,6,34
673870,0,6 user reviews,6,0,6
673920,0,No user reviews,0,0,0
673950,8,Very Positive,1441,157,1598
673980,7,Positive,24,1,25
674010,0,2 user reviews,0,2,2
674020,0,No user reviews,0,0,0
674030,5,Mixed,38,37,75
674040,5,Mixed,77,81,158
674060,5,Mixed,48,30,78
674110,5,Mixed,41,45,86
674210,7,Positive,10,0,10
674220,5,Mixed,13,14,27
674250,7,Positive,20,1,21
674310,7,Positive,31,5,36
674330,7,Positive,22,0,22
674380,0,8 user reviews,4,4,8
674440,7,Positive,24,0,24
674520,8,Very Positive,357,15,372
674750,8,Very Positive,478,116,594
674800,7,Positive,23,0,23
674850,8,Very Positive,61,2,63
674900,0,3 user reviews,2,1,3
674940,8,Very Positive,15215,1442,16657
674960,7,Positive,29,6,35
675010,8,Very Positive,3214,760,3974
675030,7,Positive,28,2,30
675120,0,8 user reviews,7,1,8
675130,5,Mixed,10,5,15
675140,0,6 user reviews,6,0,6
675230,5,Mixed,30,19,49
675260,8,Very Positive,1578,268,1846
675330,0,No user reviews,0,0,0
675360,0,6 user reviews,1,5,6
675450,5,Mixed,57,68,125
675460,5,Mixed,140,87,227
675490,7,Positive,15,1,16
675500,0,5 user reviews,5,0,5
675530,0,9 user reviews,7,2,9
675620,0,No user reviews,0,0,0
675630,5,Mixed,166,149,315
675660,0,6 user reviews,0,6,6
675680,6,Mostly Positive,101,27,128
675720,5,Mixed,16,12,28
675730,7,Positive,21,5,26
675750,0,No user reviews,0,0,0
675830,0,4 user reviews,4,0,4
675870,0,4 user reviews,3,1,4
675910,0,8 user reviews,8,0,8
675940,6,Mostly Positive,47,20,67
675950,4,Mostly Negative,3,7,10
675960,6,Mostly Positive,9,3,12
675990,7,Positive,10,2,12
676000,6,Mostly Positive,23,8,31
676090,8,Very Positive,81,17,98
676130,7,Positive,12,0,12
676180,7,Positive,12,0,12
676240,7,Positive,28,1,29
676320,0,1 user reviews,1,0,1
676410,0,6 user reviews,5,1,6
676420,8,Very Positive,147,9,156
676430,8,Very Positive,201,23,224
676440,7,Positive,20,2,22
676450,6,Mostly Positive,13,5,18
676480,8,Very Positive,54,7,61
676490,4,Mostly Negative,8,29,37
676530,0,No user reviews,0,0,0
676580,0,8 user reviews,8,0,8
676590,5,Mixed,35,17,52
676630,7,Positive,46,3,49
676680,0,4 user reviews,4,0,4
676700,7,Positive,18,3,21
676720,5,Mixed,8,10,18
676760,5,Mixed,30,17,47
676770,8,Very Positive,329,61,390
676820,9,Overwhelmingly Positive,721,29,750
676830,7,Positive,14,1,15
676850,0,5 user reviews,4,1,5
676910,7,Positive,14,3,17
676930,0,No user reviews,0,0,0
677020,8,Very Positive,45,7,52
677030,7,Positive,22,4,26
677040,6,Mostly Positive,15,6,21
677060,7,Positive,23,4,27
677080,0,6 user reviews,6,0,6
677120,8,Very Positive,800,189,989
677160,6,Mostly Positive,726,233,959
677190,0,3 user reviews,3,0,3
677280,7,Positive,44,5,49
677300,7,Positive,17,0,17
677330,7,Positive,20,4,24
677380,7,Positive,21,2,23
677520,7,Positive,12,0,12
677650,6,Mostly Positive,9,3,12
677710,0,2 user reviews,2,0,2
677720,7,Positive,20,4,24
677730,7,Positive,12,3,15
677820,5,Mixed,7,8,15
677850,0,9 user reviews,9,0,9
677870,4,Mostly Negative,2,8,10
677880,4,Mostly Negative,11,21,32
677910,7,Positive,19,2,21
677980,6,Mostly Positive,47,19,66
678190,5,Mixed,45,59,104
678230,6,Mostly Positive,9,3,12
678240,5,Mixed,8,5,13
678290,7,Positive,14,3,17
678310,7,Positive,28,1,29
678520,8,Very Positive,220,13,233
678530,7,Positive,11,0,11
678540,0,5 user reviews,5,0,5
678560,6,Mostly Positive,284,72,356
678670,5,Mixed,11,9,20
678750,0,No user reviews,0,0,0
678800,8,Very Positive,1294,309,1603
678820,7,Positive,21,3,24
678870,7,Positive,21,0,21
678890,4,Mostly Negative,10,24,34
678930,0,1 user reviews,1,0,1
678950,8,Very Positive,6043,1265,7308
678970,7,Positive,36,7,43
679030,0,5 user reviews,5,0,5
679190,6,Mostly Positive,32,11,43
679200,0,No user reviews,0,0,0
679230,7,Positive,11,0,11
679260,5,Mixed,163,100,263
679300,7,Positive,13,0,13
679410,0,4 user reviews,4,0,4
679430,7,Positive,10,1,11
679460,4,Mostly Negative,7,14,21
679470,7,Positive,12,3,15
679480,0,6 user reviews,3,3,6
679500,7,Positive,14,0,14
679530,5,Mixed,5,5,10
679650,5,Mixed,32,16,48
679660,8,Very Positive,59,11,70
679690,0,6 user reviews,3,3,6
679750,7,Positive,46,0,46
679770,7,Positive,17,2,19
679780,0,3 user reviews,0,3,3
679860,5,Mixed,14,9,23
680040,0,2 user reviews,1,1,2
680100,0,9 user reviews,2,7,9
680120,5,Mixed,33,30,63
680190,0,5 user reviews,5,0,5
680270,0,5 user reviews,3,2,5
680310,5,Mixed,55,70,125
680330,5,Mixed,20,9,29
680340,8,Very Positive,60,15,75
680350,7,Positive,10,0,10
680360,8,Very Positive,344,35,379
680390,8,Very Positive,50,4,54
680400,7,Positive,16,0,16
680480,8,Very Positive,64,5,69
680500,0,2 user reviews,1,1,2
680550,6,Mostly Positive,12,4,16
680620,7,Positive,16,3,19
680680,0,4 user reviews,3,1,4
680700,7,Positive,39,1,40
680750,0,No user reviews,0,0,0
680860,8,Very Positive,44,10,54
680890,0,7 user reviews,7,0,7
680930,0,8 user reviews,7,1,8
680980,6,Mostly Positive,182,48,230
681000,0,6 user reviews,5,1,6
681020,0,2 user reviews,1,1,2
681060,7,Positive,29,7,36
681070,4,Mostly Negative,15,35,50
681090,0,5 user reviews,4,1,5
681100,6,Mostly Positive,19,6,25
681110,0,No user reviews,0,0,0
681140,5,Mixed,17,23,40
681160,4,Mostly Negative,12,19,31
681170,5,Mixed,118,61,179
681190,0,7 user reviews,7,0,7
681240,7,Positive,40,1,41
681280,8,Very Positive,396,36,432
681290,0,8 user reviews,8,0,8
681330,8,Very Positive,65,3,68
681340,7,Positive,14,2,16
681390,8,Very Positive,266,23,289
681460,7,Positive,16,1,17
681480,4,Mostly Negative,4,10,14
681490,7,Positive,11,0,11
681500,4,Mostly Negative,38,70,108
681520,5,Mixed,16,11,27
681530,0,7 user reviews,7,0,7
681620,7,Positive,22,2,24
681630,7,Positive,8,2,10
681660,5,Mixed,2721,3491,6212
681740,0,No user reviews,0,0,0
681780,4,Mostly Negative,9,31,40
681800,7,Positive,24,2,26
681810,5,Mixed,132,98,230
681910,7,Positive,44,3,47
681920,0,1 user reviews,0,1,1
682070,7,Positive,11,1,12
682080,7,Positive,27,0,27
682130,8,Very Positive,154,30,184
682150,6,Mostly Positive,22,7,29
682180,0,4 user reviews,4,0,4
682270,0,3 user reviews,2,1,3
682280,0,1 user reviews,1,0,1
682290,0,No user reviews,0,0,0
682340,0,1 user reviews,1,0,1
682470,7,Positive,25,1,26
682480,8,Very Positive,66,11,77
682500,5,Mixed,6,9,15
682510,0,6 user reviews,3,3,6
682570,6,Mostly Positive,106,40,146
682590,7,Positive,13,3,16
682610,7,Positive,21,3,24
682620,5,Mixed,11,11,22
682630,7,Positive,12,2,14
682660,5,Mixed,19,17,36
682670,7,Positive,20,1,21
682740,0,4 user reviews,3,1,4
682780,7,Positive,21,2,23
682810,7,Positive,23,2,25
682820,0,No user reviews,0,0,0
682910,5,Mixed,29,23,52
682920,0,2 user reviews,1,1,2
682960,0,5 user reviews,2,3,5
683130,0,4 user reviews,4,0,4
683240,0,7 user reviews,3,4,7
683280,8,Very Positive,62,13,75
683430,0,4 user reviews,4,0,4
683530,5,Mixed,7,8,15
683570,4,Mostly Negative,5,8,13
683600,4,Mostly Negative,3,8,11
683630,0,2 user reviews,2,0,2
683670,7,Positive,23,2,25
683730,5,Mixed,6,4,10
683760,7,Positive,15,1,16
683790,5,Mixed,8,4,12
683810,0,4 user reviews,1,3,4
683840,0,No user reviews,0,0,0
683890,7,Positive,10,0,10
684050,5,Mixed,23,15,38
684060,7,Positive,9,2,11
684130,3,Negative,1,10,11
684170,0,2 user reviews,2,0,2
684210,6,Mostly Positive,51,17,68
684270,8,Very Positive,129,5,134
684320,7,Positive,16,0,16
684410,8,Very Positive,982,109,1091
684420,0,9 user reviews,3,6,9
684430,7,Positive,14,0,14
684470,0,5 user reviews,2,3,5
684530,7,Positive,28,1,29
684580,5,Mixed,372,207,579
684620,0,No user reviews,0,0,0
684680,7,Positive,46,1,47
684740,0,No user reviews,0,0,0
684750,5,Mixed,17,11,28
684800,0,No user reviews,0,0,0
684820,4,Mostly Negative,7,13,20
684870,7,Positive,13,1,14
684940,6,Mostly Positive,9,3,12
684980,0,7 user reviews,7,0,7
685050,0,9 user reviews,9,0,9
685120,0,No user reviews,0,0,0
685130,0,7 user reviews,6,1,7
685310,6,Mostly Positive,138,43,181
685340,6,Mostly Positive,193,49,242
685390,5,Mixed,17,25,42
685400,8,Very Positive,99,1,100
685420,5,Mixed,63,45,108
685680,8,Very Positive,115,14,129
685690,8,Very Positive,117,12,129
685700,0,No user reviews,0,0,0
685750,5,Mixed,19,20,39
685790,5,Mixed,28,34,62
685870,0,No user reviews,0,0,0
685920,0,3 user reviews,2,1,3
685950,5,Mixed,74,38,112
685990,4,Mostly Negative,20,39,59
686110,7,Positive,39,5,44
686200,8,Very Positive,259,22,281
686300,0,No user reviews,0,0,0
686360,7,Positive,20,5,25
686450,7,Positive,10,0,10
686500,5,Mixed,16,9,25
686510,0,5 user reviews,5,0,5
686520,0,6 user reviews,6,0,6
686550,5,Mixed,10,6,16
686570,6,Mostly Positive,46,19,65
686580,0,2 user reviews,2,0,2
686620,0,7 user reviews,6,1,7
686630,0,No user reviews,0,0,0
686640,0,4 user reviews,4,0,4
686740,5,Mixed,10,9,19
686760,7,Positive,32,5,37
686900,6,Mostly Positive,34,10,44
687260,8,Very Positive,355,30,385
687270,0,7 user reviews,4,3,7
687310,7,Positive,15,3,18
687390,0,2 user reviews,1,1,2
687420,0,No user reviews,0,0,0
687480,5,Mixed,7,6,13
687490,5,Mixed,13,9,22
687540,6,Mostly Positive,23,7,30
687560,6,Mostly Positive,10,3,13
687580,0,No user reviews,0,0,0
687610,0,1 user reviews,1,0,1
687720,0,8 user reviews,6,2,8
687750,5,Mixed,61,46,107
687790,5,Mixed,48,29,77
687830,8,Very Positive,98,3,101
687890,7,Positive,12,2,14
687920,8,Very Positive,333,72,405
687950,0,No user reviews,0,0,0
688000,0,8 user reviews,4,4,8
688110,0,6 user reviews,6,0,6
688140,0,No user reviews,0,0,0
688180,0,1 user reviews,0,1,1
688260,5,Mixed,33,15,48
688330,0,4 user reviews,3,1,4
688360,5,Mixed,37,16,53
688380,7,Positive,18,1,19
688400,7,Positive,14,2,16
688430,6,Mostly Positive,205,80,285
688450,7,Positive,8,2,10
688480,5,Mixed,162,93,255
688550,5,Mixed,65,58,123
688570,5,Mixed,20,10,30
688590,5,Mixed,14,7,21
688600,7,Positive,9,2,11
688620,0,6 user reviews,4,2,6
688630,0,6 user reviews,2,4,6
688680,7,Positive,12,3,15
688690,8,Very Positive,52,8,60
688790,0,2 user reviews,2,0,2
688800,7,Positive,12,3,15
688880,5,Mixed,15,11,26
689000,7,Positive,10,1,11
689030,0,6 user reviews,5,1,6
689040,7,Positive,9,2,11
689050,0,6 user reviews,2,4,6
689070,8,Very Positive,141,11,152
689090,8,Very Positive,581,71,652
689160,6,Mostly Positive,9,3,12
689180,6,Mostly Positive,12,5,17
689340,0,4 user reviews,3,1,4
689350,4,Mostly Negative,17,31,48
689360,4,Mostly Negative,29,59,88
689400,8,Very Positive,72,12,84
689470,0,No user reviews,0,0,0
689520,5,Mixed,15,19,34
689570,7,Positive,33,6,39
689650,5,Mixed,84,70,154
689680,0,6 user reviews,6,0,6
689700,8,Very Positive,85,16,101
689750,6,Mostly Positive,98,39,137
689820,0,No user reviews,0,0,0
689900,8,Very Positive,121,5,126
689910,8,Very Positive,150,8,158
689990,5,Mixed,42,57,99
690060,5,Mixed,106,68,174
690080,0,8 user reviews,7,1,8
690120,8,Very Positive,54,10,64
690130,7,Positive,10,2,12
690140,0,No user reviews,0,0,0
690150,7,Positive,39,4,43
690200,7,Positive,17,0,17
690240,5,Mixed,11,6,17
690260,0,2 user reviews,1,1,2
690310,0,4 user reviews,3,1,4
690350,6,Mostly Positive,35,9,44
690460,5,Mixed,15,9,24
690510,6,Mostly Positive,520,147,667
690560,8,Very Positive,49,6,55
690570,0,7 user reviews,6,1,7
690610,6,Mostly Positive,30,11,41
690620,7,Positive,27,5,32
690630,7,Positive,15,1,16
690710,7,Positive,15,1,16
690740,5,Mixed,36,18,54
690810,5,Mixed,111,60,171
690820,0,5 user reviews,2,3,5
690850,0,9 user reviews,8,1,9
690930,8,Very Positive,340,42,382
691080,5,Mixed,32,20,52
691130,4,Mostly Negative,13,31,44
691160,0,No user reviews,0,0,0
691220,0,1 user reviews,0,1,1
691240,7,Positive,13,3,16
691250,7,Positive,15,1,16
691280,0,No user reviews,0,0,0
691390,8,Very Positive,92,23,115
691450,8,Very Positive,201,4,205
691540,5,Mixed,41,28,69
691580,0,9 user reviews,6,3,9
691590,0,1 user reviews,1,0,1
691600,0,9 user reviews,5,4,9
691620,0,4 user reviews,4,0,4
691630,6,Mostly Positive,71,28,99
691660,5,Mixed,31,35,66
691680,0,3 user reviews,2,1,3
691690,8,Very Positive,680,144,824
691750,0,8 user reviews,6,2,8
691830,8,Very Positive,65,5,70
691850,0,No user reviews,0,0,0
691920,4,Mostly Negative,6,15,21
691980,0,5 user reviews,0,5,5
692030,4,Mostly Negative,55,126,181
692170,0,2 user reviews,0,2,2
692180,8,Very Positive,57,12,69
692200,5,Mixed,12,10,22
692310,0,8 user reviews,7,1,8
692590,5,Mixed,8,9,17
692610,0,1 user reviews,1,0,1
692860,0,1 user reviews,1,0,1
692920,6,Mostly Positive,335,114,449
692930,7,Positive,29,7,36
692950,0,8 user reviews,8,0,8
693020,0,No user reviews,0,0,0
693030,0,7 user reviews,7,0,7
693090,0,6 user reviews,3,3,6
693180,5,Mixed,13,7,20
693250,5,Mixed,9,13,22
693310,0,6 user reviews,4,2,6
693320,0,1 user reviews,1,0,1
693360,0,1 user reviews,0,1,1
693430,0,3 user reviews,2,1,3
693650,0,7 user reviews,6,1,7
693670,5,Mixed,28,17,45
693680,5,Mixed,25,25,50
693700,7,Positive,44,1,45
693710,0,No user reviews,0,0,0
693750,5,Mixed,57,32,89
693830,0,8 user reviews,6,2,8
693870,5,Mixed,38,24,62
693880,5,Mixed,8,7,15
693890,5,Mixed,8,5,13
694070,6,Mostly Positive,7,3,10
694090,8,Very Positive,53,9,62
694130,5,Mixed,46,66,112
694140,0,9 user reviews,8,1,9
694160,0,2 user reviews,1,1,2
694170,4,Mostly Negative,15,52,67
694370,7,Positive,38,4,42
694480,6,Mostly Positive,15,5,20
694490,4,Mostly Negative,13,21,34
694670,0,7 user reviews,7,0,7
694790,7,Positive,13,3,16
694930,7,Positive,10,2,12
694950,7,Positive,20,4,24
694960,0,6 user reviews,5,1,6
694970,5,Mixed,14,10,24
694980,5,Mixed,43,21,64
695020,5,Mixed,36,29,65
695100,8,Very Positive,65,11,76
695110,7,Positive,12,1,13
695350,4,Mostly Negative,10,18,28
695360,5,Mixed,16,16,32
695420,0,6 user reviews,6,0,6
695450,5,Mixed,13,6,19
695460,0,2 user reviews,2,0,2
695560,0,1 user reviews,1,0,1
695590,5,Mixed,10,6,16
695600,6,Mostly Positive,96,27,123
695630,5,Mixed,200,277,477
695650,5,Mixed,64,30,94
695910,0,7 user reviews,6,1,7
695920,8,Very Positive,390,79,469
695970,8,Very Positive,68,4,72
695980,0,No user reviews,0,0,0
696060,7,Positive,14,0,14
696140,8,Very Positive,83,8,91
696170,6,Mostly Positive,1213,513,1726
696180,5,Mixed,72,34,106
696250,5,Mixed,7,6,13
696310,0,4 user reviews,3,1,4
696360,5,Mixed,51,28,79
696400,5,Mixed,9,13,22
696410,0,9 user reviews,8,1,9
696460,8,Very Positive,47,5,52
696480,8,Very Positive,275,61,336
696530,8,Very Positive,81,8,89
696550,5,Mixed,36,28,64
696560,7,Positive,28,7,35
696590,8,Very Positive,113,22,135
696730,5,Mixed,12,11,23
696760,0,No user reviews,0,0,0
696810,0,8 user reviews,6,2,8
696930,5,Mixed,7,9,16
696940,6,Mostly Positive,30,11,41
697010,5,Mixed,74,66,140
697020,4,Mostly Negative,4,9,13
697370,7,Positive,14,2,16
697490,0,2 user reviews,0,2,2
697530,0,9 user reviews,6,3,9
697600,0,2 user reviews,2,0,2
697610,8,Very Positive,116,13,129
697640,5,Mixed,13,8,21
697650,7,Positive,29,1,30
697660,7,Positive,16,0,16
697710,0,8 user reviews,7,1,8
697750,5,Mixed,38,35,73
697850,4,Mostly Negative,6,13,19
697870,5,Mixed,7,5,12
697910,0,7 user reviews,7,0,7
697930,5,Mixed,20,16,36
697940,5,Mixed,16,8,24
698030,0,No user reviews,0,0,0
698040,0,7 user reviews,5,2,7
698050,7,Positive,38,4,42
698110,6,Mostly Positive,15,4,19
698300,8,Very Positive,44,11,55
698320,0,5 user reviews,2,3,5
698330,7,Positive,35,7,42
698370,8,Very Positive,136,33,169
698450,7,Positive,20,1,21
698490,4,Mostly Negative,27,76,103
698540,0,No user reviews,0,0,0
698600,0,2 user reviews,0,2,2
698650,7,Positive,11,0,11
698700,0,No user reviews,0,0,0
698710,5,Mixed,20,9,29
698720,8,Very Positive,207,31,238
698740,5,Mixed,49,22,71
698770,0,8 user reviews,7,1,8
698790,0,7 user reviews,7,0,7
698830,5,Mixed,18,14,32
698920,0,5 user reviews,5,0,5
698980,0,4 user reviews,4,0,4
699010,0,8 user reviews,5,3,8
699080,7,Positive,32,4,36
699100,5,Mixed,7,4,11
699150,7,Positive,30,0,30
699180,7,Positive,40,1,41
699230,0,3 user reviews,3,0,3
699240,7,Positive,17,4,21
699450,5,Mixed,37,27,64
699460,0,6 user reviews,4,2,6
699480,5,Mixed,8,11,19
699550,5,Mixed,12,15,27
699570,0,3 user reviews,0,3,3
699590,5,Mixed,11,7,18
699600,8,Very Positive,52,2,54
699680,0,9 user reviews,4,5,9
699700,8,Very Positive,73,17,90
699750,7,Positive,26,4,30
699780,7,Positive,16,3,19
699820,0,5 user reviews,3,2,5
699860,0,3 user reviews,1,2,3
699940,6,Mostly Positive,19,6,25
699990,0,6 user reviews,3,3,6
700160,0,No user reviews,0,0,0
700170,7,Positive,42,7,49
700270,0,3 user reviews,2,1,3
700330,8,Very Positive,6743,1433,8176
700400,0,5 user reviews,4,1,5
700440,5,Mixed,11,6,17
700460,0,4 user reviews,4,0,4
700480,6,Mostly Positive,75,22,97
700510,7,Positive,9,1,10
700520,7,Positive,17,1,18
700560,0,5 user reviews,3,2,5
700610,0,1 user reviews,0,1,1
700660,6,Mostly Positive,40,17,57
700740,5,Mixed,15,12,27
700770,6,Mostly Positive,27,11,38
700780,5,Mixed,13,11,24
700790,5,Mixed,45,29,74
700830,0,4 user reviews,4,0,4
700920,0,3 user reviews,3,0,3
701040,7,Positive,24,0,24
701280,6,Mostly Positive,8,3,11
701290,7,Positive,9,1,10
701360,0,No user reviews,0,0,0
701440,7,Positive,19,0,19
701470,7,Positive,44,0,44
701540,5,Mixed,14,8,22
701720,6,Mostly Positive,40,17,57
701730,0,9 user reviews,8,1,9
701740,5,Mixed,9,4,13
701760,6,Mostly Positive,21,6,27
701810,7,Positive,10,0,10
701860,7,Positive,25,5,30
701880,0,No user reviews,0,0,0
701890,0,3 user reviews,3,0,3
701910,7,Positive,12,0,12
701930,8,Very Positive,345,1,346
702080,5,Mixed,42,28,70
702110,8,Very Positive,48,10,58
702120,5,Mixed,101,92,193
702150,0,5 user reviews,3,2,5
702180,0,4 user reviews,3,1,4
702190,5,Mixed,27,19,46
702200,5,Mixed,29,32,61
702300,0,5 user reviews,5,0,5
702310,0,1 user reviews,0,1,1
702320,5,Mixed,95,90,185
702600,7,Positive,39,3,42
702620,0,No user reviews,0,0,0
702670,0,No user reviews,0,0,0
702700,5,Mixed,45,50,95
702810,8,Very Positive,633,44,677
702820,0,1 user reviews,1,0,1
702890,6,Mostly Positive,674,222,896
702910,5,Mixed,11,10,21
702930,0,No user reviews,0,0,0
702940,7,Positive,10,1,11
703040,5,Mixed,23,33,56
703050,0,5 user reviews,4,1,5
703060,6,Mostly Positive,13,5,18
703120,6,Mostly Positive,7,3,10
703180,7,Positive,20,4,24
703210,7,Positive,13,3,16
703250,0,5 user reviews,5,0,5
703270,0,4 user reviews,2,2,4
703400,5,Mixed,21,12,33
703500,7,Positive,17,1,18
703530,5,Mixed,6,6,12
703610,5,Mixed,48,59,107
703620,7,Positive,32,3,35
703630,7,Positive,23,3,26
703700,6,Mostly Positive,1321,378,1699
703720,0,9 user reviews,9,0,9
703750,0,6 user reviews,1,5,6
703760,5,Mixed,8,6,14
703840,8,Very Positive,178,18,196
703870,6,Mostly Positive,14,6,20
703920,4,Mostly Negative,9,21,30
703950,6,Mostly Positive,311,112,423
704020,0,No user reviews,0,0,0
704040,5,Mixed,129,80,209
704190,0,8 user reviews,3,5,8
704200,7,Positive,40,3,43
704270,0,No user reviews,0,0,0
704310,0,8 user reviews,7,1,8
704350,0,No user reviews,0,0,0
704360,8,Very Positive,51,5,56
704380,5,Mixed,32,18,50
704440,7,Positive,21,0,21
704460,3,Negative,3,13,16
704470,8,Very Positive,60,0,60
704490,3,Negative,2,10,12
704500,0,5 user reviews,1,4,5
704520,0,No user reviews,0,0,0
704550,8,Very Positive,326,54,380
704640,7,Positive,38,2,40
704660,0,1 user reviews,1,0,1
704670,0,1 user reviews,1,0,1
704680,7,Positive,19,4,23
704690,6,Mostly Positive,73,27,100
704760,0,8 user reviews,8,0,8
704830,5,Mixed,62,48,110
704840,8,Very Positive,97,5,102
704860,7,Positive,17,1,18
704940,0,2 user reviews,0,2,2
704990,0,4 user reviews,3,1,4
705000,0,No user reviews,0,0,0
705020,0,9 user reviews,7,2,9
705050,4,Mostly Negative,6,10,16
705070,5,Mixed,19,21,40
705090,5,Mixed,8,5,13
705120,8,Very Positive,1689,131,1820
705130,0,No user reviews,0,0,0
705210,0,4 user reviews,4,0,4
705240,7,Positive,14,1,15
705250,6,Mostly Positive,11,3,14
705260,5,Mixed,7,6,13
705300,4,Mostly Negative,6,10,16
705380,7,Positive,19,1,20
705400,4,Mostly Negative,6,11,17
705420,5,Mixed,10,6,16
705430,5,Mixed,8,6,14
705450,7,Positive,37,3,40
705500,7,Positive,17,0,17
705530,0,No user reviews,0,0,0
705620,7,Positive,26,4,30
705640,5,Mixed,14,7,21
705670,7,Positive,15,1,16
705710,4,Mostly Negative,13,39,52
705740,0,No user reviews,0,0,0
705750,7,Positive,23,4,27
705770,0,No user reviews,0,0,0
705780,0,6 user reviews,6,0,6
705840,5,Mixed,13,14,27
706020,6,Mostly Positive,230,93,323
706030,0,8 user reviews,6,2,8
706130,8,Very Positive,67,3,70
706210,0,No user reviews,0,0,0
706270,0,2 user reviews,2,0,2
706280,7,Positive,14,2,16
706320,5,Mixed,10,6,16
706330,5,Mixed,9,5,14
706350,0,3 user reviews,3,0,3
706370,0,4 user reviews,3,1,4
706380,0,No user reviews,0,0,0
706390,0,5 user reviews,4,1,5
706440,0,9 user reviews,4,5,9
706480,0,No user reviews,0,0,0
706490,5,Mixed,35,22,57
706520,6,Mostly Positive,34,13,47
706550,0,No user reviews,0,0,0
706710,0,No user reviews,0,0,0
706850,0,No user reviews,0,0,0
706880,0,9 user reviews,8,1,9
706920,7,Positive,24,1,25
706960,6,Mostly Positive,21,7,28
707000,0,6 user reviews,2,4,6
707010,6,Mostly Positive,584,219,803
707060,0,7 user reviews,1,6,7
707230,7,Positive,10,2,12
707300,6,Mostly Positive,188,58,246
707320,0,3 user reviews,2,1,3
707350,0,9 user reviews,7,2,9
707370,4,Mostly Negative,4,7,11
707380,4,Mostly Negative,7,12,19
707470,0,2 user reviews,2,0,2
707590,8,Very Positive,42,9,51
707600,5,Mixed,35,29,64
707720,5,Mixed,6,4,10
707870,6,Mostly Positive,59,22,81
707920,0,8 user reviews,4,4,8
707960,0,5 user reviews,2,3,5
708140,0,2 user reviews,2,0,2
708150,7,Positive,9,1,10
708260,7,Positive,39,4,43
708300,7,Positive,22,3,25
708310,7,Positive,27,5,32
708340,7,Positive,31,5,36
708420,5,Mixed,145,68,213
708430,5,Mixed,12,12,24
708580,8,Very Positive,91,20,111
708640,7,Positive,15,1,16
708680,7,Positive,42,2,44
708760,7,Positive,21,1,22
708780,7,Positive,11,0,11
708820,7,Positive,15,2,17
708850,7,Positive,15,2,17
708920,7,Positive,22,3,25
708930,4,Mostly Negative,5,10,15
708940,6,Mostly Positive,39,10,49
708950,7,Positive,18,3,21
708970,7,Positive,26,3,29
709050,3,Negative,3,19,22
709140,6,Mostly Positive,11,4,15
709190,5,Mixed,11,6,17
709220,5,Mixed,6,9,15
709250,3,Negative,3,18,21
709290,0,1 user reviews,1,0,1
709380,5,Mixed,20,15,35
709390,0,No user reviews,0,0,0
709400,0,2 user reviews,2,0,2
709410,5,Mixed,18,15,33
709430,5,Mixed,6,5,11
709470,0,4 user reviews,4,0,4
709550,0,2 user reviews,2,0,2
709560,5,Mixed,8,5,13
709620,0,7 user reviews,5,2,7
709700,5,Mixed,19,17,36
709720,0,9 user reviews,8,1,9
709750,0,No user reviews,0,0,0
709770,5,Mixed,7,5,12
709780,5,Mixed,24,28,52
709790,0,9 user reviews,6,3,9
709840,5,Mixed,22,32,54
709870,5,Mixed,8,12,20
709880,0,6 user reviews,5,1,6
709890,0,4 user reviews,3,1,4
709970,0,No user reviews,0,0,0
710030,8,Very Positive,171,20,191
710070,7,Positive,12,2,14
710110,6,Mostly Positive,10,4,14
710120,6,Mostly Positive,12,4,16
710130,6,Mostly Positive,232,90,322
710160,0,No user reviews,0,0,0
710190,7,Positive,33,2,35
710270,5,Mixed,34,22,56
710330,5,Mixed,36,29,65
710390,5,Mixed,24,22,46
710440,5,Mixed,5,7,12
710450,7,Positive,21,4,25
710470,8,Very Positive,174,16,190
710480,0,7 user reviews,6,1,7
710520,7,Positive,12,2,14
710550,0,1 user reviews,1,0,1
710610,8,Very Positive,71,13,84
710620,0,No user reviews,0,0,0
710630,0,9 user reviews,9,0,9
710690,0,No user reviews,0,0,0
710760,7,Positive,25,5,30
710780,6,Mostly Positive,48,18,66
710820,0,8 user reviews,8,0,8
710860,5,Mixed,38,23,61
710880,4,Mostly Negative,3,9,12
711050,0,5 user reviews,3,2,5
711070,5,Mixed,18,26,44
711080,5,Mixed,7,8,15
711090,0,8 user reviews,4,4,8
711100,0,5 user reviews,3,2,5
711110,0,2 user reviews,2,0,2
711130,0,8 user reviews,8,0,8
711240,0,9 user reviews,7,2,9
711260,0,1 user reviews,1,0,1
711320,5,Mixed,31,17,48
711330,0,4 user reviews,2,2,4
711350,0,3 user reviews,0,3,3
711430,7,Positive,11,0,11
711450,5,Mixed,8,4,12
711480,0,5 user reviews,4,1,5
711500,0,No user reviews,0,0,0
711550,0,6 user reviews,6,0,6
711560,6,Mostly Positive,24,7,31
711600,0,No user reviews,0,0,0
711640,5,Mixed,12,13,25
711660,8,Very Positive,490,84,574
711690,7,Positive,19,0,19
711700,0,No user reviews,0,0,0
711750,6,Mostly Positive,207,88,295
711870,0,No user reviews,0,0,0
711920,0,No user reviews,0,0,0
711930,4,Mostly Negative,10,17,27
712000,5,Mixed,27,23,50
712010,5,Mixed,13,6,19
712060,7,Positive,31,3,34
712090,5,Mixed,13,8,21
712100,5,Mixed,2258,1570,3828
712150,5,Mixed,8,6,14
712180,0,No user reviews,0,0,0
712190,0,No user reviews,0,0,0
712210,0,6 user reviews,6,0,6
712240,0,9 user reviews,9,0,9
712380,7,Positive,31,3,34
712390,8,Very Positive,44,10,54
712650,7,Positive,8,2,10
712730,8,Very Positive,423,10,433
712770,7,Positive,37,8,45
712790,7,Positive,37,9,46
712870,7,Positive,30,6,36
712890,0,3 user reviews,2,1,3
712970,7,Positive,14,1,15
712980,6,Mostly Positive,12,4,16
713030,0,9 user reviews,9,0,9
713050,8,Very Positive,62,13,75
713080,4,Mostly Negative,3,11,14
713090,7,Positive,13,0,13
713160,7,Positive,27,1,28
713170,0,No user reviews,0,0,0
713180,7,Positive,12,0,12
713220,7,Positive,12,3,15
713260,8,Very Positive,109,3,112
713380,0,4 user reviews,4,0,4
713390,0,1 user reviews,0,1,1
713420,5,Mixed,19,10,29
713430,0,1 user reviews,1,0,1
713450,7,Positive,9,1,10
713520,5,Mixed,35,19,54
713530,8,Very Positive,76,7,83
713610,0,6 user reviews,3,3,6
713650,5,Mixed,215,117,332
713680,5,Mixed,51,38,89
713780,5,Mixed,9,4,13
713840,0,5 user reviews,3,2,5
713980,0,5 user reviews,5,0,5
714010,6,Mostly Positive,92,30,122
714020,6,Mostly Positive,203,61,264
714050,5,Mixed,10,13,23
714240,7,Positive,29,6,35
714250,0,No user reviews,0,0,0
714260,5,Mixed,20,24,44
714280,8,Very Positive,74,2,76
714290,0,6 user reviews,4,2,6
714510,5,Mixed,7,7,14
714640,5,Mixed,18,12,30
714730,5,Mixed,9,7,16
714840,0,2 user reviews,2,0,2
714880,0,5 user reviews,3,2,5
715010,8,Very Positive,203,5,208
715050,6,Mostly Positive,67,22,89
715060,4,Mostly Negative,12,21,33
715210,0,8 user reviews,7,1,8
715290,5,Mixed,9,6,15
715310,5,Mixed,110,75,185
715340,6,Mostly Positive,10,4,14
715430,0,6 user reviews,6,0,6
715440,7,Positive,9,1,10
715470,5,Mixed,9,5,14
715510,6,Mostly Positive,44,14,58
715520,5,Mixed,19,9,28
715570,5,Mixed,28,22,50
715650,8,Very Positive,122,17,139
715660,6,Mostly Positive,22,7,29
715690,5,Mixed,28,16,44
715720,7,Positive,43,1,44
715800,5,Mixed,11,8,19
715840,5,Mixed,21,15,36
715980,5,Mixed,17,25,42
715990,0,8 user reviews,7,1,8
716010,7,Positive,26,1,27
716040,5,Mixed,10,5,15
716060,0,No user reviews,0,0,0
716070,7,Positive,19,1,20
716090,0,4 user reviews,2,2,4
716100,0,6 user reviews,3,3,6
716110,5,Mixed,110,97,207
716130,0,No user reviews,0,0,0
716190,0,6 user reviews,6,0,6
716220,0,No user reviews,0,0,0
716230,0,6 user reviews,3,3,6
716240,0,4 user reviews,3,1,4
716250,0,No user reviews,0,0,0
716260,8,Very Positive,95,10,105
716330,6,Mostly Positive,10,3,13
716340,8,Very Positive,66,1,67
716370,0,4 user reviews,4,0,4
716400,7,Positive,19,3,22
716600,4,Mostly Negative,7,15,22
716630,5,Mixed,45,37,82
716650,8,Very Positive,116,1,117
716680,7,Positive,35,3,38
716750,7,Positive,11,0,11
716760,7,Positive,10,2,12
716770,6,Mostly Positive,19,8,27
716780,0,No user reviews,0,0,0
717020,0,8 user reviews,7,1,8
717060,0,3 user reviews,3,0,3
717070,7,Positive,15,0,15
717120,5,Mixed,13,7,20
717170,0,2 user reviews,2,0,2
717190,6,Mostly Positive,12,4,16
717300,0,No user reviews,0,0,0
717310,7,Positive,23,2,25
717330,7,Positive,8,2,10
717370,3,Negative,1,15,16
717440,0,No user reviews,0,0,0
717450,8,Very Positive,50,3,53
717520,0,No user reviews,0,0,0
717610,7,Positive,42,4,46
717640,8,Very Positive,328,56,384
717690,0,No user reviews,0,0,0
717760,0,7 user reviews,6,1,7
717780,0,No user reviews,0,0,0
717820,6,Mostly Positive,14,4,18
717850,7,Positive,18,1,19
717940,0,1 user reviews,1,0,1
717950,6,Mostly Positive,76,20,96
717960,0,3 user reviews,3,0,3
717980,7,Positive,22,0,22
717990,5,Mixed,52,28,80
718010,7,Positive,35,4,39
718080,0,5 user reviews,5,0,5
718090,8,Very Positive,82,8,90
718120,0,No user reviews,0,0,0
718180,8,Very Positive,76,12,88
718200,7,Positive,46,1,47
718220,5,Mixed,9,9,18
718270,5,Mixed,6,7,13
718320,6,Mostly Positive,45,17,62
718330,8,Very Positive,120,22,142
718370,5,Mixed,77,43,120
718410,0,6 user reviews,6,0,6
718490,0,2 user reviews,1,1,2
718500,6,Mostly Positive,28,9,37
718560,7,Positive,34,5,39
718590,0,No user reviews,0,0,0
718650,8,Very Positive,201,36,237
718660,5,Mixed,10,6,16
718670,6,Mostly Positive,678,182,860
718720,7,Positive,21,1,22
718730,7,Positive,34,0,34
718910,0,3 user reviews,2,1,3
718920,0,4 user reviews,2,2,4
718940,8,Very Positive,99,6,105
718960,7,Positive,12,2,14
718980,0,7 user reviews,6,1,7
719080,7,Positive,36,0,36
719090,0,6 user reviews,6,0,6
719120,4,Mostly Negative,19,41,60
719130,0,2 user reviews,1,1,2
719210,0,1 user reviews,1,0,1
719220,0,No user reviews,0,0,0
719240,0,No user reviews,0,0,0
719280,0,4 user reviews,4,0,4
719370,0,2 user reviews,1,1,2
719410,8,Very Positive,69,3,72
719460,4,Mostly Negative,5,14,19
719470,4,Mostly Negative,4,8,12
719550,0,5 user reviews,5,0,5
719600,0,3 user reviews,1,2,3
719610,5,Mixed,33,33,66
719640,5,Mixed,72,74,146
719660,7,Positive,43,0,43
719730,5,Mixed,22,22,44
719750,0,No user reviews,0,0,0
719800,7,Positive,25,2,27
720020,0,1 user reviews,1,0,1
720150,8,Very Positive,84,14,98
720200,0,9 user reviews,8,1,9
720250,8,Very Positive,409,96,505
720280,8,Very Positive,1765,251,2016
720320,7,Positive,20,4,24
720480,0,7 user reviews,4,3,7
720630,7,Positive,16,3,19
720670,8,Very Positive,48,5,53
720730,7,Positive,11,0,11
720940,7,Positive,15,0,15
721000,0,No user reviews,0,0,0
721350,7,Positive,18,3,21
721380,0,5 user reviews,5,0,5
721390,7,Positive,31,0,31
721430,6,Mostly Positive,24,10,34
721440,5,Mixed,30,19,49
721460,0,No user reviews,0,0,0
721470,0,2 user reviews,2,0,2
721480,0,2 user reviews,2,0,2
721740,0,7 user reviews,7,0,7
721760,7,Positive,13,3,16
721940,5,Mixed,5,7,12
721950,5,Mixed,12,6,18
721970,5,Mixed,25,13,38
722020,0,4 user reviews,1,3,4
722040,6,Mostly Positive,8,3,11
722080,0,4 user reviews,4,0,4
722180,8,Very Positive,109,21,130
722230,5,Mixed,201,91,292
722250,6,Mostly Positive,22,9,31
722330,8,Very Positive,52,1,53
722370,0,3 user reviews,3,0,3
722380,0,No user reviews,0,0,0
722580,0,2 user reviews,2,0,2
722600,0,4 user reviews,3,1,4
722660,7,Positive,24,6,30
722670,6,Mostly Positive,64,22,86
722680,7,Positive,20,5,25
722730,8,Very Positive,414,7,421
722750,5,Mixed,25,18,43
722760,6,Mostly Positive,11,3,14
722810,0,2 user reviews,1,1,2
722870,7,Positive,36,2,38
722890,7,Positive,25,5,30
722910,0,7 user reviews,7,0,7
722920,7,Positive,15,2,17
722960,0,No user reviews,0,0,0
722990,7,Positive,18,1,19
723090,8,Very Positive,391,10,401
723110,0,8 user reviews,8,0,8
723210,0,No user reviews,0,0,0
723270,8,Very Positive,164,14,178
723360,0,No user reviews,0,0,0
723450,0,4 user reviews,2,2,4
723600,0,5 user reviews,5,0,5
723610,7,Positive,35,7,42
723760,5,Mixed,11,9,20
723780,5,Mixed,1115,1129,2244
723820,7,Positive,18,1,19
723890,7,Positive,32,3,35
723930,0,1 user reviews,1,0,1
724110,0,4 user reviews,1,3,4
724130,0,8 user reviews,5,3,8
724170,0,No user reviews,0,0,0
724250,5,Mixed,62,31,93
724280,5,Mixed,18,10,28
724350,6,Mostly Positive,43,13,56
724390,0,No user reviews,0,0,0
724430,4,Mostly Negative,7,11,18
724470,8,Very Positive,50,8,58
724510,0,9 user reviews,7,2,9
724520,0,5 user reviews,1,4,5
724570,8,Very Positive,98,23,121
724600,0,6 user reviews,6,0,6
724640,0,8 user reviews,8,0,8
724710,5,Mixed,11,8,19
724740,8,Very Positive,229,57,286
724760,0,1 user reviews,0,1,1
725080,7,Positive,16,0,16
725140,0,1 user reviews,1,0,1
725170,0,6 user reviews,6,0,6
725340,8,Very Positive,473,60,533
725370,0,No user reviews,0,0,0
725380,0,4 user reviews,4,0,4
725400,5,Mixed,19,21,40
725490,6,Mostly Positive,9,3,12
725540,0,2 user reviews,2,0,2
725660,0,7 user reviews,6,1,7
725870,0,No user reviews,0,0,0
725910,0,5 user reviews,5,0,5
725970,7,Positive,13,3,16
726020,6,Mostly Positive,13,4,17
726030,0,5 user reviews,3,2,5
726070,4,Mostly Negative,9,21,30
726120,6,Mostly Positive,19,8,27
726170,5,Mixed,27,20,47
726200,7,Positive,33,5,38
726210,4,Mostly Negative,5,13,18
726230,7,Positive,14,1,15
726250,8,Very Positive,66,3,69
726260,7,Positive,13,1,14
726300,0,3 user reviews,3,0,3
726320,7,Positive,14,3,17
726330,0,3 user reviews,3,0,3
726340,7,Positive,25,1,26
726390,8,Very Positive,226,38,264
726430,0,7 user reviews,4,3,7
726500,0,1 user reviews,1,0,1
726510,7,Positive,14,1,15
726590,0,No user reviews,0,0,0
726600,5,Mixed,13,15,28
726610,0,3 user reviews,1,2,3
726650,5,Mixed,25,14,39
726760,5,Mixed,29,19,48
726800,5,Mixed,23,18,41
726820,0,2 user reviews,1,1,2
726910,8,Very Positive,156,28,184
726950,5,Mixed,19,23,42
727020,0,6 user reviews,6,0,6
727070,7,Positive,15,0,15
727100,7,Positive,21,2,23
727150,0,5 user reviews,5,0,5
727180,6,Mostly Positive,21,7,28
727190,5,Mixed,8,4,12
727200,0,5 user reviews,5,0,5
727220,5,Mixed,8,4,12
727290,7,Positive,15,1,16
727310,6,Mostly Positive,15,4,19
727340,7,Positive,25,1,26
727460,6,Mostly Positive,22,8,30
727480,7,Positive,27,2,29
727500,5,Mixed,52,28,80
727510,7,Positive,38,1,39
727530,5,Mixed,17,8,25
727540,0,1 user reviews,1,0,1
727550,6,Mostly Positive,15,6,21
727560,5,Mixed,41,18,59
727590,8,Very Positive,50,12,62
727730,7,Positive,28,7,35
727760,7,Positive,20,3,23
727830,7,Positive,23,0,23
727860,0,2 user reviews,2,0,2
727970,0,4 user reviews,3,1,4
728020,0,3 user reviews,3,0,3
728050,5,Mixed,8,7,15
728070,7,Positive,15,3,18
728240,0,No user reviews,0,0,0
728420,5,Mixed,9,4,13
728440,8,Very Positive,72,10,82
728610,0,2 user reviews,2,0,2
728630,6,Mostly Positive,7,3,10
728670,0,5 user reviews,4,1,5
728730,8,Very Positive,481,97,578
728870,7,Positive,27,5,32
728880,0,No user reviews,0,0,0
728890,5,Mixed,45,30,75
728950,0,9 user reviews,9,0,9
728990,5,Mixed,12,15,27
729030,0,No user reviews,0,0,0
729060,6,Mostly Positive,43,11,54
729090,4,Mostly Negative,6,12,18
729270,0,No user reviews,0,0,0
729290,0,No user reviews,0,0,0
729330,5,Mixed,27,26,53
729390,7,Positive,10,0,10
729460,5,Mixed,9,4,13
729530,5,Mixed,43,19,62
729570,7,Positive,19,4,23
729580,5,Mixed,22,13,35
729660,7,Positive,44,0,44
729670,4,Mostly Negative,13,24,37
729720,6,Mostly Positive,38,10,48
729740,0,3 user reviews,2,1,3
729980,7,Positive,12,0,12
729990,0,5 user reviews,5,0,5
730050,8,Very Positive,53,7,60
730220,0,9 user reviews,5,4,9
730240,0,3 user reviews,0,3,3
730290,7,Positive,9,1,10
730300,7,Positive,15,0,15
730310,4,Mostly Negative,1010,3747,4757
730410,5,Mixed,138,79,217
730670,0,2 user reviews,2,0,2
730690,0,2 user reviews,2,0,2
730760,0,5 user reviews,2,3,5
730920,7,Positive,25,1,26
731120,0,2 user reviews,0,2,2
731190,0,1 user reviews,0,1,1
731230,5,Mixed,19,14,33
731410,0,2 user reviews,1,1,2
731420,0,No user reviews,0,0,0
731430,0,2 user reviews,1,1,2
731500,0,6 user reviews,2,4,6
731510,0,9 user reviews,8,1,9
731520,0,7 user reviews,7,0,7
731580,5,Mixed,12,12,24
731600,7,Positive,12,0,12
731670,0,3 user reviews,3,0,3
731790,0,6 user reviews,2,4,6
731820,0,3 user reviews,3,0,3
731860,0,2 user reviews,1,1,2
731870,4,Mostly Negative,11,28,39
731880,5,Mixed,39,23,62
731920,5,Mixed,50,59,109
731930,0,6 user reviews,4,2,6
731940,7,Positive,22,4,26
732000,5,Mixed,12,6,18
732030,0,9 user reviews,8,1,9
732090,4,Mostly Negative,5,8,13
732360,7,Positive,11,0,11
732370,6,Mostly Positive,387,109,496
732430,9,Overwhelmingly Positive,3555,115,3670
732520,6,Mostly Positive,11,4,15
732550,7,Positive,12,3,15
732670,0,1 user reviews,1,0,1
732770,0,7 user reviews,7,0,7
732800,0,2 user reviews,2,0,2
732810,8,Very Positive,205,13,218
732840,5,Mixed,10,5,15
732870,5,Mixed,13,9,22
732900,0,No user reviews,0,0,0
733030,0,1 user reviews,1,0,1
733050,8,Very Positive,90,9,99
733070,8,Very Positive,123,9,132
733180,0,7 user reviews,5,2,7
733250,7,Positive,13,2,15
733290,4,Mostly Negative,11,20,31
733300,7,Positive,45,1,46
733340,8,Very Positive,55,3,58
733430,5,Mixed,9,9,18
733460,8,Very Positive,52,10,62
733500,0,4 user reviews,4,0,4
733510,0,5 user reviews,5,0,5
733520,0,4 user reviews,3,1,4
733530,0,2 user reviews,2,0,2
733540,0,4 user reviews,3,1,4
733570,0,7 user reviews,4,3,7
733650,7,Positive,25,2,27
733740,8,Very Positive,76,5,81
733780,0,9 user reviews,2,7,9
733910,0,4 user reviews,3,1,4
733990,8,Very Positive,811,47,858
734120,6,Mostly Positive,47,20,67
734350,0,2 user reviews,2,0,2
734440,0,No user reviews,0,0,0
734450,0,6 user reviews,5,1,6
734490,0,6 user reviews,5,1,6
734540,5,Mixed,11,5,16
734570,6,Mostly Positive,35,11,46
734590,5,Mixed,40,54,94
734700,7,Positive,17,2,19
734750,6,Mostly Positive,625,172,797
734840,0,1 user reviews,0,1,1
734870,0,3 user reviews,2,1,3
734890,0,3 user reviews,3,0,3
734910,8,Very Positive,361,32,393
734920,8,Very Positive,94,4,98
735060,7,Positive,16,3,19
735260,5,Mixed,10,5,15
735280,6,Mostly Positive,103,42,145
735350,6,Mostly Positive,37,13,50
735410,5,Mixed,6,6,12
735450,6,Mostly Positive,40,16,56
735500,6,Mostly Positive,31,8,39
735540,0,1 user reviews,0,1,1
735550,0,No user reviews,0,0,0
735570,8,Very Positive,544,39,583
735700,0,3 user reviews,3,0,3
735850,5,Mixed,162,86,248
736110,5,Mixed,14,8,22
736200,7,Positive,19,3,22
736240,0,No user reviews,0,0,0
736390,0,8 user reviews,8,0,8
736430,5,Mixed,6,7,13
736480,0,No user reviews,0,0,0
736570,8,Very Positive,73,4,77
736810,6,Mostly Positive,29,12,41
736840,7,Positive,14,0,14
736860,5,Mixed,34,20,54
736930,5,Mixed,14,7,21
737260,5,Mixed,7,9,16
737280,0,5 user reviews,5,0,5
737380,0,3 user reviews,3,0,3
737470,0,No user reviews,0,0,0
737530,5,Mixed,9,12,21
737600,0,7 user reviews,4,3,7
737640,0,No user reviews,0,0,0
737690,6,Mostly Positive,13,4,17
737710,7,Positive,39,2,41
737750,5,Mixed,90,90,180
737800,0,No user reviews,0,0,0
737810,5,Mixed,10,5,15
737830,0,7 user reviews,6,1,7
737870,7,Positive,39,5,44
737890,0,No user reviews,0,0,0
737930,7,Positive,8,2,10
738000,6,Mostly Positive,16,6,22
738020,7,Positive,31,7,38
738130,0,1 user reviews,1,0,1
738210,0,6 user reviews,6,0,6
738480,0,1 user reviews,1,0,1
738500,5,Mixed,73,91,164
738520,0,No user reviews,0,0,0
738560,7,Positive,8,2,10
738600,0,5 user reviews,3,2,5
738610,6,Mostly Positive,78,26,104
738620,0,2 user reviews,2,0,2
738720,0,2 user reviews,2,0,2
738730,0,4 user reviews,3,1,4
738760,6,Mostly Positive,12,5,17
738880,5,Mixed,21,19,40
738920,5,Mixed,14,21,35
739010,0,1 user reviews,1,0,1
739050,8,Very Positive,106,7,113
739180,0,9 user reviews,9,0,9
739190,8,Very Positive,51,3,54
739210,7,Positive,20,2,22
739240,0,4 user reviews,3,1,4
739290,7,Positive,11,0,11
739350,4,Mostly Negative,14,23,37
739410,6,Mostly Positive,8,3,11
739540,0,No user reviews,0,0,0
739690,5,Mixed,14,7,21
739780,0,2 user reviews,2,0,2
739810,0,No user reviews,0,0,0
739850,7,Positive,10,1,11
739890,0,5 user reviews,4,1,5
739950,0,6 user reviews,6,0,6
739980,8,Very Positive,62,3,65
740000,7,Positive,26,2,28
740070,0,8 user reviews,6,2,8
740090,5,Mixed,8,6,14
740120,5,Mixed,31,15,46
740150,0,6 user reviews,3,3,6
740170,0,2 user reviews,2,0,2
740200,8,Very Positive,288,47,335
740230,7,Positive,34,2,36
740240,0,9 user reviews,6,3,9
740260,8,Very Positive,898,86,984
740280,0,8 user reviews,7,1,8
740290,8,Very Positive,120,24,144
740400,7,Positive,11,1,12
740410,7,Positive,19,2,21
740470,6,Mostly Positive,347,115,462
740520,0,No user reviews,0,0,0
740560,0,1 user reviews,0,1,1
740570,7,Positive,42,7,49
740600,5,Mixed,56,28,84
740990,0,No user reviews,0,0,0
741080,0,No user reviews,0,0,0
741100,4,Mostly Negative,5,9,14
741250,7,Positive,21,0,21
741260,6,Mostly Positive,527,215,742
741450,4,Mostly Negative,17,43,60
741500,5,Mixed,87,46,133
741620,0,No user reviews,0,0,0
741630,6,Mostly Positive,18,6,24
741650,0,6 user reviews,2,4,6
741670,8,Very Positive,310,58,368
741990,0,No user reviews,0,0,0
742010,0,9 user reviews,5,4,9
742120,0,No user reviews,0,0,0
742150,7,Positive,21,0,21
742170,8,Very Positive,45,10,55
742230,6,Mostly Positive,21,9,30
742250,8,Very Positive,215,12,227
742340,0,8 user reviews,6,2,8
742380,0,4 user reviews,4,0,4
742460,8,Very Positive,69,7,76
742480,7,Positive,42,5,47
742540,6,Mostly Positive,13,4,17
742630,5,Mixed,22,11,33
743070,0,No user reviews,0,0,0
743090,0,No user reviews,0,0,0
743100,0,1 user reviews,1,0,1
743110,7,Positive,9,2,11
743190,5,Mixed,21,10,31
743230,0,No user reviews,0,0,0
743330,0,5 user reviews,5,0,5
743340,0,5 user reviews,4,1,5
743360,0,3 user reviews,3,0,3
743370,5,Mixed,138,83,221
743410,0,6 user reviews,5,1,6
743420,0,3 user reviews,3,0,3
743450,8,Very Positive,859,97,956
743480,0,2 user reviews,2,0,2
743640,5,Mixed,111,75,186
743660,0,5 user reviews,5,0,5
743860,4,Mostly Negative,223,488,711
743920,0,No user reviews,0,0,0
744040,7,Positive,17,4,21
744050,8,Very Positive,47,4,51
744060,0,No user reviews,0,0,0
744170,0,1 user reviews,1,0,1
744190,9,Overwhelmingly Positive,691,36,727
744240,0,9 user reviews,9,0,9
744420,6,Mostly Positive,61,24,85
744430,8,Very Positive,61,13,74
744570,8,Very Positive,69,11,80
744590,6,Mostly Positive,13,4,17
744940,5,Mixed,14,10,24
745000,7,Positive,41,7,48
745010,0,No user reviews,0,0,0
745030,7,Positive,15,1,16
745090,7,Positive,16,0,16
745130,5,Mixed,6,5,11
745250,7,Positive,14,0,14
745280,0,2 user reviews,0,2,2
745330,8,Very Positive,45,5,50
745370,6,Mostly Positive,17,7,24
745380,5,Mixed,5,5,10
745400,7,Positive,19,1,20
745500,4,Mostly Negative,7,14,21
745510,6,Mostly Positive,29,12,41
745560,0,No user reviews,0,0,0
745650,0,4 user reviews,4,0,4
745670,4,Mostly Negative,9,24,33
745690,6,Mostly Positive,15,6,21
745720,7,Positive,15,0,15
745740,6,Mostly Positive,63,25,88
745810,8,Very Positive,52,9,61
745840,0,5 user reviews,5,0,5
745890,8,Very Positive,90,3,93
745930,6,Mostly Positive,13,4,17
745940,6,Mostly Positive,22,8,30
745950,0,No user reviews,0,0,0
745960,8,Very Positive,124,7,131
746000,0,No user reviews,0,0,0
746010,5,Mixed,6,7,13
746090,0,4 user reviews,1,3,4
746140,6,Mostly Positive,115,48,163
746240,0,6 user reviews,2,4,6
746350,5,Mixed,17,9,26
746400,8,Very Positive,59,2,61
746410,6,Mostly Positive,27,7,34
746500,0,4 user reviews,3,1,4
746570,6,Mostly Positive,20,6,26
746620,7,Positive,42,4,46
746660,7,Positive,9,1,10
746680,0,6 user reviews,4,2,6
746710,8,Very Positive,100,6,106
746840,0,8 user reviews,4,4,8
746930,8,Very Positive,543,108,651
746940,8,Very Positive,61,7,68
747050,7,Positive,15,0,15
747090,0,3 user reviews,2,1,3
747110,0,No user reviews,0,0,0
747190,5,Mixed,11,6,17
747280,0,No user reviews,0,0,0
747310,5,Mixed,19,12,31
747320,7,Positive,25,2,27
747330,6,Mostly Positive,14,4,18
747340,8,Very Positive,200,29,229
747470,7,Positive,42,1,43
747540,0,3 user reviews,3,0,3
747590,5,Mixed,32,17,49
747640,7,Positive,12,1,13
747650,7,Positive,15,0,15
747730,0,3 user reviews,2,1,3
747750,0,3 user reviews,3,0,3
747770,5,Mixed,14,7,21
747810,0,2 user reviews,2,0,2
747850,4,Mostly Negative,9,14,23
747910,5,Mixed,13,11,24
747990,6,Mostly Positive,10,3,13
748010,0,4 user reviews,4,0,4
748050,0,9 user reviews,4,5,9
748110,0,5 user reviews,3,2,5
748150,0,9 user reviews,8,1,9
748300,0,No user reviews,0,0,0
748430,5,Mixed,8,4,12
748480,6,Mostly Positive,19,6,25
748490,9,Overwhelmingly Positive,518,19,537
748610,5,Mixed,15,8,23
748650,0,4 user reviews,4,0,4
748800,0,8 user reviews,6,2,8
748820,0,5 user reviews,2,3,5
748830,0,No user reviews,0,0,0
748880,0,8 user reviews,6,2,8
748890,8,Very Positive,56,2,58
748930,5,Mixed,8,4,12
748990,0,No user reviews,0,0,0
749110,0,6 user reviews,5,1,6
749120,5,Mixed,12,14,26
749200,0,4 user reviews,4,0,4
749220,5,Mixed,13,9,22
749270,5,Mixed,9,8,17
749290,0,4 user reviews,1,3,4
749340,6,Mostly Positive,13,4,17
749370,5,Mixed,13,11,24
749410,7,Positive,19,3,22
749470,0,2 user reviews,2,0,2
749510,6,Mostly Positive,32,11,43
749540,6,Mostly Positive,57,22,79
749560,7,Positive,26,0,26
749570,0,7 user reviews,6,1,7
749670,7,Positive,15,3,18
749700,7,Positive,10,0,10
749710,0,3 user reviews,2,1,3
749730,7,Positive,17,2,19
749800,5,Mixed,37,29,66
749820,0,No user reviews,0,0,0
749830,0,8 user reviews,6,2,8
749840,7,Positive,11,0,11
749850,7,Positive,24,6,30
749860,0,4 user reviews,4,0,4
749880,7,Positive,32,8,40
749890,0,8 user reviews,8,0,8
749920,5,Mixed,16,7,23
749980,0,1 user reviews,1,0,1
749990,7,Positive,12,1,13
750020,0,No user reviews,0,0,0
750070,5,Mixed,11,13,24
750080,0,No user reviews,0,0,0
750200,0,No user reviews,0,0,0
750330,6,Mostly Positive,16,6,22
750420,0,3 user reviews,2,1,3
750450,7,Positive,30,0,30
750460,0,6 user reviews,5,1,6
750620,0,2 user reviews,2,0,2
750660,7,Positive,40,4,44
750740,0,3 user reviews,1,2,3
750770,0,9 user reviews,7,2,9
750780,0,5 user reviews,5,0,5
750790,0,6 user reviews,4,2,6
750900,4,Mostly Negative,2,8,10
750920,0,No user reviews,0,0,0
750930,0,9 user reviews,6,3,9
750960,7,Positive,35,3,38
751100,0,No user reviews,0,0,0
751200,5,Mixed,8,5,13
751230,0,No user reviews,0,0,0
751250,7,Positive,22,4,26
751260,0,3 user reviews,3,0,3
751270,0,No user reviews,0,0,0
751280,7,Positive,45,2,47
751330,5,Mixed,8,4,12
751340,6,Mostly Positive,25,8,33
751500,6,Mostly Positive,97,33,130
751540,0,3 user reviews,2,1,3
751640,0,No user reviews,0,0,0
751670,0,No user reviews,0,0,0
751690,8,Very Positive,345,36,381
751950,0,7 user reviews,7,0,7
751970,7,Positive,14,0,14
752000,0,2 user reviews,0,2,2
752010,0,3 user reviews,3,0,3
752020,5,Mixed,11,7,18
752300,6,Mostly Positive,10,4,14
752310,0,3 user reviews,3,0,3
752370,0,2 user reviews,1,1,2
752380,7,Positive,26,5,31
752430,0,1 user reviews,1,0,1
752500,8,Very Positive,53,11,64
752530,0,No user reviews,0,0,0
752570,6,Mostly Positive,44,13,57
752600,7,Positive,30,2,32
752700,6,Mostly Positive,14,6,20
752710,0,5 user reviews,2,3,5
752770,0,1 user reviews,1,0,1
752790,0,2 user reviews,2,0,2
752810,0,6 user reviews,2,4,6
752830,0,4 user reviews,2,2,4
753060,5,Mixed,15,8,23
753100,0,2 user reviews,1,1,2
753110,5,Mixed,40,45,85
753220,8,Very Positive,101,0,101
753230,6,Mostly Positive,179,75,254
753270,0,No user reviews,0,0,0
753370,0,7 user reviews,6,1,7
753380,5,Mixed,7,5,12
753420,8,Very Positive,1163,159,1322
753440,7,Positive,11,1,12
753560,0,4 user reviews,4,0,4
753610,5,Mixed,39,43,82
753660,7,Positive,40,6,46
753900,6,Mostly Positive,28,9,37
753920,5,Mixed,6,7,13
753960,5,Mixed,7,4,11
753980,0,1 user reviews,1,0,1
754020,6,Mostly Positive,15,5,20
754110,0,7 user reviews,7,0,7
754120,5,Mixed,12,8,20
754190,7,Positive,9,1,10
754230,0,7 user reviews,6,1,7
754270,0,4 user reviews,4,0,4
754330,0,9 user reviews,5,4,9
754340,6,Mostly Positive,7,3,10
754410,0,No user reviews,0,0,0
754510,0,8 user reviews,5,3,8
754520,0,7 user reviews,5,2,7
754540,7,Positive,39,2,41
754800,6,Mostly Positive,14,4,18
754810,8,Very Positive,128,24,152
754910,7,Positive,10,2,12
754930,0,3 user reviews,2,1,3
755140,0,2 user reviews,0,2,2
755250,0,9 user reviews,9,0,9
755350,5,Mixed,9,12,21
755450,0,No user reviews,0,0,0
755490,0,4 user reviews,4,0,4
755560,7,Positive,13,1,14
755570,5,Mixed,22,10,32
755590,0,4 user reviews,4,0,4
755670,0,No user reviews,0,0,0
755820,0,No user reviews,0,0,0
755830,0,9 user reviews,9,0,9
755890,8,Very Positive,44,9,53
755920,0,No user reviews,0,0,0
755950,7,Positive,15,0,15
755970,5,Mixed,14,17,31
755980,8,Very Positive,97,8,105
756050,5,Mixed,24,25,49
756100,0,1 user reviews,1,0,1
756190,4,Mostly Negative,7,11,18
756200,0,2 user reviews,2,0,2
756230,0,3 user reviews,2,1,3
756240,7,Positive,27,3,30
756260,5,Mixed,14,13,27
756320,7,Positive,16,0,16
756340,0,2 user reviews,1,1,2
756380,0,1 user reviews,1,0,1
756440,7,Positive,44,4,48
756450,0,9 user reviews,4,5,9
756490,6,Mostly Positive,17,6,23
756500,5,Mixed,7,6,13
756560,0,7 user reviews,3,4,7
756590,8,Very Positive,204,15,219
756630,0,3 user reviews,3,0,3
756650,0,7 user reviews,5,2,7
756700,7,Positive,30,3,33
756740,0,5 user reviews,5,0,5
756790,0,8 user reviews,8,0,8
756860,0,4 user reviews,2,2,4
756870,7,Positive,22,3,25
756880,5,Mixed,31,26,57
757080,0,8 user reviews,7,1,8
757130,4,Mostly Negative,156,272,428
757180,8,Very Positive,72,0,72
757190,0,2 user reviews,2,0,2
757230,0,2 user reviews,0,2,2
757330,8,Very Positive,74,2,76
757350,7,Positive,30,5,35
757450,7,Positive,14,3,17
757540,0,2 user reviews,1,1,2
757600,0,No user reviews,0,0,0
757700,7,Positive,16,0,16
757720,5,Mixed,26,15,41
757810,5,Mixed,68,73,141
757860,5,Mixed,13,6,19
757870,7,Positive,18,2,20
758020,0,9 user reviews,4,5,9
758050,5,Mixed,9,11,20
758070,0,6 user reviews,6,0,6
758080,0,No user reviews,0,0,0
758100,6,Mostly Positive,39,14,53
758150,6,Mostly Positive,8,3,11
758170,0,7 user reviews,7,0,7
758190,8,Very Positive,701,86,787
758220,0,1 user reviews,1,0,1
758320,6,Mostly Positive,15,5,20
758330,0,No user reviews,0,0,0
758370,8,Very Positive,275,28,303
758400,5,Mixed,6,4,10
758410,5,Mixed,55,27,82
758470,4,Mostly Negative,6,10,16
758500,8,Very Positive,136,5,141
758530,8,Very Positive,443,17,460
758570,7,Positive,25,2,27
758660,0,9 user reviews,9,0,9
758700,5,Mixed,8,5,13
758790,0,4 user reviews,2,2,4
758920,5,Mixed,6,5,11
758980,6,Mostly Positive,39,16,55
759000,7,Positive,30,3,33
759010,5,Mixed,8,9,17
759160,0,No user reviews,0,0,0
759260,0,8 user reviews,7,1,8
759460,5,Mixed,98,54,152
759500,6,Mostly Positive,10,3,13
759540,8,Very Positive,62,5,67
759610,5,Mixed,16,23,39
759640,7,Positive,27,2,29
759650,0,9 user reviews,9,0,9
759700,5,Mixed,41,50,91
759830,0,4 user reviews,4,0,4
759850,0,2 user reviews,2,0,2
759870,4,Mostly Negative,6,21,27
759940,8,Very Positive,276,40,316
759950,0,3 user reviews,2,1,3
759980,0,3 user reviews,3,0,3
760010,0,6 user reviews,4,2,6
760030,7,Positive,17,1,18
760050,7,Positive,26,0,26
760060,0,No user reviews,0,0,0
760080,0,9 user reviews,9,0,9
760100,5,Mixed,34,26,60
760320,7,Positive,10,0,10
760330,8,Very Positive,106,1,107
760350,7,Positive,16,3,19
760360,0,6 user reviews,3,3,6
760440,0,4 user reviews,3,1,4
760450,0,4 user reviews,4,0,4
760460,5,Mixed,27,20,47
760490,5,Mixed,12,11,23
760550,8,Very Positive,65,10,75
760560,5,Mixed,19,18,37
760680,0,9 user reviews,4,5,9
760800,6,Mostly Positive,32,10,42
760820,8,Very Positive,82,17,99
760880,5,Mixed,11,6,17
760890,8,Very Positive,132,2,134
761030,8,Very Positive,73,14,87
761040,0,4 user reviews,4,0,4
761070,8,Very Positive,66,6,72
761100,0,1 user reviews,0,1,1
761110,0,9 user reviews,5,4,9
761130,0,3 user reviews,0,3,3
761150,0,2 user reviews,2,0,2
761160,0,7 user reviews,6,1,7
761170,8,Very Positive,61,13,74
761220,0,8 user reviews,6,2,8
761280,6,Mostly Positive,33,9,42
761330,8,Very Positive,224,19,243
761440,3,Negative,1,9,10
761460,0,No user reviews,0,0,0
761480,7,Positive,13,0,13
761570,0,No user reviews,0,0,0
761630,4,Mostly Negative,5,8,13
761660,4,Mostly Negative,3,9,12
761670,7,Positive,29,0,29
761720,0,No user reviews,0,0,0
761760,6,Mostly Positive,19,7,26
761790,6,Mostly Positive,12,5,17
761880,0,3 user reviews,1,2,3
761890,6,Mostly Positive,402,163,565
762030,0,No user reviews,0,0,0
762150,0,No user reviews,0,0,0
762190,0,No user reviews,0,0,0
762250,0,No user reviews,0,0,0
762360,0,No user reviews,0,0,0
762380,5,Mixed,7,4,11
762460,5,Mixed,16,15,31
762480,6,Mostly Positive,25,10,35
762490,0,No user reviews,0,0,0
762520,5,Mixed,6,6,12
762590,6,Mostly Positive,37,11,48
762620,7,Positive,18,2,20
762630,0,3 user reviews,2,1,3
762650,0,No user reviews,0,0,0
762670,0,2 user reviews,1,1,2
762860,0,No user reviews,0,0,0
763000,0,No user reviews,0,0,0
763010,0,7 user reviews,6,1,7
763050,7,Positive,12,2,14
763070,6,Mostly Positive,15,6,21
763090,5,Mixed,8,9,17
763200,0,7 user reviews,4,3,7
763210,7,Positive,22,2,24
763250,0,No user reviews,0,0,0
763290,0,No user reviews,0,0,0
763300,0,7 user reviews,2,5,7
763340,0,No user reviews,0,0,0
763350,0,7 user reviews,6,1,7
763360,6,Mostly Positive,13,5,18
763400,4,Mostly Negative,10,16,26
763520,7,Positive,12,0,12
763540,5,Mixed,4,6,10
763610,7,Positive,10,2,12
763680,0,1 user reviews,1,0,1
763730,5,Mixed,9,5,14
763740,0,7 user reviews,5,2,7
763750,0,No user reviews,0,0,0
763760,7,Positive,16,4,20
763770,7,Positive,23,4,27
763870,7,Positive,13,2,15
763930,7,Positive,26,1,27
763950,0,5 user reviews,1,4,5
763980,0,6 user reviews,5,1,6
764060,4,Mostly Negative,5,20,25
764080,0,No user reviews,0,0,0
764180,0,2 user reviews,2,0,2
764280,7,Positive,14,0,14
764300,6,Mostly Positive,38,10,48
764370,0,3 user reviews,3,0,3
764410,5,Mixed,26,16,42
764430,6,Mostly Positive,10,4,14
764470,6,Mostly Positive,10,3,13
764490,6,Mostly Positive,11,4,15
764500,6,Mostly Positive,42,18,60
764510,8,Very Positive,60,8,68
764560,0,8 user reviews,5,3,8
764570,8,Very Positive,49,9,58
764580,6,Mostly Positive,10,3,13
764590,6,Mostly Positive,23,7,30
764630,0,No user reviews,0,0,0
764720,0,2 user reviews,2,0,2
764790,0,No user reviews,0,0,0
764830,0,1 user reviews,1,0,1
764870,0,1 user reviews,1,0,1
764970,0,9 user reviews,7,2,9
765060,7,Positive,13,0,13
765140,0,2 user reviews,1,1,2
765170,0,3 user reviews,3,0,3
765200,5,Mixed,10,9,19
765300,0,2 user reviews,2,0,2
765400,0,3 user reviews,2,1,3
765460,5,Mixed,8,4,12
765490,7,Positive,10,0,10
765530,0,4 user reviews,3,1,4
765590,7,Positive,14,1,15
765640,8,Very Positive,165,7,172
765650,6,Mostly Positive,89,35,124
765790,0,3 user reviews,1,2,3
765940,7,Positive,10,0,10
765990,5,Mixed,23,16,39
766000,7,Positive,10,0,10
766010,0,No user reviews,0,0,0
766260,5,Mixed,49,39,88
766280,8,Very Positive,375,11,386
766320,7,Positive,38,7,45
766430,0,No user reviews,0,0,0
766500,0,3 user reviews,2,1,3
766560,7,Positive,33,1,34
766570,5,Mixed,310,170,480
766630,7,Positive,34,5,39
766730,8,Very Positive,67,2,69
766780,0,5 user reviews,4,1,5
766920,8,Very Positive,103,17,120
766940,7,Positive,14,1,15
767020,0,No user reviews,0,0,0
767030,0,7 user reviews,4,3,7
767050,5,Mixed,7,5,12
767170,0,5 user reviews,3,2,5
767200,7,Positive,14,1,15
767340,6,Mostly Positive,8,3,11
767500,6,Mostly Positive,21,6,27
767550,0,No user reviews,0,0,0
767590,0,6 user reviews,6,0,6
767610,5,Mixed,6,7,13
767840,0,3 user reviews,3,0,3
768180,0,No user reviews,0,0,0
768290,0,8 user reviews,8,0,8
768300,5,Mixed,20,10,30
768310,0,5 user reviews,4,1,5
768430,5,Mixed,19,19,38
768590,7,Positive,12,0,12
768640,0,No user reviews,0,0,0
768750,5,Mixed,121,140,261
768840,5,Mixed,21,14,35
769020,0,8 user reviews,8,0,8
769080,5,Mixed,16,7,23
769110,5,Mixed,13,14,27
769160,0,5 user reviews,5,0,5
769200,5,Mixed,11,15,26
769360,6,Mostly Positive,31,11,42
769410,0,3 user reviews,3,0,3
769550,7,Positive,26,2,28
769580,0,4 user reviews,4,0,4
769730,0,7 user reviews,6,1,7
769840,0,No user reviews,0,0,0
769910,7,Positive,10,1,11
769920,7,Positive,26,0,26
769940,5,Mixed,9,5,14
769980,0,7 user reviews,5,2,7
770050,0,5 user reviews,4,1,5
770100,8,Very Positive,79,14,93
770120,0,2 user reviews,2,0,2
770160,0,2 user reviews,1,1,2
770270,5,Mixed,4,6,10
770320,0,2 user reviews,1,1,2
770370,0,4 user reviews,3,1,4
770380,0,1 user reviews,1,0,1
770400,4,Mostly Negative,13,27,40
770440,5,Mixed,43,27,70
770520,0,3 user reviews,3,0,3
770600,7,Positive,19,0,19
770630,7,Positive,13,0,13
770660,0,No user reviews,0,0,0
770690,0,4 user reviews,2,2,4
770810,7,Positive,11,0,11
770820,0,3 user reviews,3,0,3
771010,7,Positive,30,1,31
771060,5,Mixed,230,107,337
771100,0,5 user reviews,3,2,5
771240,8,Very Positive,52,2,54
771320,5,Mixed,8,6,14
771350,5,Mixed,39,31,70
771370,3,Negative,6,34,40
771410,7,Positive,26,4,30
771540,0,1 user reviews,1,0,1
771610,5,Mixed,9,10,19
771680,7,Positive,14,0,14
771690,0,No user reviews,0,0,0
771710,7,Positive,40,4,44
771840,7,Positive,42,4,46
771920,6,Mostly Positive,42,14,56
771950,6,Mostly Positive,11,3,14
772060,0,8 user reviews,5,3,8
772070,6,Mostly Positive,147,60,207
772080,5,Mixed,6,4,10
772090,7,Positive,10,1,11
772200,7,Positive,13,1,14
772320,0,3 user reviews,2,1,3
772440,0,6 user reviews,4,2,6
772450,0,No user reviews,0,0,0
772470,7,Positive,14,1,15
772480,7,Positive,22,3,25
772490,7,Positive,22,0,22
772540,5,Mixed,688,504,1192
772600,6,Mostly Positive,7,3,10
772610,7,Positive,35,1,36
772670,0,7 user reviews,4,3,7
772700,6,Mostly Positive,67,21,88
772740,6,Mostly Positive,15,6,21
772750,0,2 user reviews,2,0,2
772990,5,Mixed,25,11,36
773010,0,5 user reviews,4,1,5
773120,0,No user reviews,0,0,0
773130,7,Positive,18,2,20
773170,5,Mixed,8,12,20
773330,0,5 user reviews,1,4,5
773390,5,Mixed,43,32,75
773430,7,Positive,31,2,33
773540,6,Mostly Positive,18,5,23
773580,8,Very Positive,64,9,73
773620,0,5 user reviews,5,0,5
773640,3,Negative,2,14,16
773650,3,Negative,2,12,14
773670,8,Very Positive,150,3,153
773710,0,7 user reviews,7,0,7
774091,8,Very Positive,186,9,195
774181,0,No user reviews,0,0,0
774191,0,7 user reviews,6,1,7
774221,7,Positive,15,1,16
774261,5,Mixed,29,13,42
774281,0,9 user reviews,7,2,9
774351,6,Mostly Positive,67,27,94
774401,0,9 user reviews,6,3,9
774411,0,7 user reviews,6,1,7
774441,5,Mixed,11,6,17
774451,0,1 user reviews,0,1,1
774531,0,9 user reviews,9,0,9
774561,7,Positive,39,2,41
774781,6,Mostly Positive,9,3,12
774811,5,Mixed,387,216,603
774891,0,4 user reviews,3,1,4
774911,5,Mixed,34,18,52
775200,0,2 user reviews,2,0,2
775320,7,Positive,33,4,37
775460,0,4 user reviews,2,2,4
775490,7,Positive,16,0,16
775520,0,9 user reviews,6,3,9
775530,8,Very Positive,54,3,57
775570,0,No user reviews,0,0,0
775690,0,7 user reviews,7,0,7
775720,0,5 user reviews,4,1,5
775730,0,2 user reviews,1,1,2
775800,6,Mostly Positive,67,24,91
775890,7,Positive,36,8,44
775900,5,Mixed,103,59,162
775910,0,9 user reviews,6,3,9
775920,0,3 user reviews,2,1,3
775960,0,No user reviews,0,0,0
775970,5,Mixed,10,5,15
776000,0,8 user reviews,5,3,8
776020,0,3 user reviews,1,2,3
776100,0,5 user reviews,2,3,5
776160,5,Mixed,9,4,13
776190,6,Mostly Positive,21,9,30
776340,5,Mixed,40,26,66
776360,0,6 user reviews,6,0,6
776370,7,Positive,28,3,31
776490,8,Very Positive,1432,232,1664
776540,7,Positive,15,3,18
776550,5,Mixed,8,11,19
776610,0,3 user reviews,1,2,3
776670,5,Mixed,7,8,15
776720,7,Positive,20,1,21
776740,0,2 user reviews,1,1,2
776780,0,7 user reviews,7,0,7
776790,0,2 user reviews,2,0,2
776820,0,9 user reviews,6,3,9
776890,4,Mostly Negative,12,20,32
776960,5,Mixed,37,23,60
777000,0,4 user reviews,1,3,4
777020,5,Mixed,17,15,32
777050,5,Mixed,25,14,39
777090,0,No user reviews,0,0,0
777160,7,Positive,35,5,40
777200,8,Very Positive,84,2,86
777220,7,Positive,35,1,36
777240,8,Very Positive,114,13,127
777340,0,7 user reviews,5,2,7
777380,0,1 user reviews,0,1,1
777400,6,Mostly Positive,22,7,29
777420,0,8 user reviews,4,4,8
777430,7,Positive,14,3,17
777560,5,Mixed,7,5,12
777580,0,2 user reviews,2,0,2
777640,0,3 user reviews,1,2,3
777660,0,1 user reviews,0,1,1
777730,0,2 user reviews,1,1,2
777760,0,1 user reviews,1,0,1
777770,0,No user reviews,0,0,0
777790,8,Very Positive,57,2,59
777820,7,Positive,8,2,10
777850,0,4 user reviews,4,0,4
777870,0,8 user reviews,8,0,8
778000,0,No user reviews,0,0,0
778050,6,Mostly Positive,38,10,48
778120,0,4 user reviews,1,3,4
778140,0,No user reviews,0,0,0
778150,7,Positive,27,1,28
778230,6,Mostly Positive,10,4,14
778330,8,Very Positive,81,3,84
778340,0,8 user reviews,5,3,8
778410,5,Mixed,11,5,16
778540,0,3 user reviews,1,2,3
778570,7,Positive,18,2,20
778610,8,Very Positive,185,10,195
778640,7,Positive,14,0,14
778700,6,Mostly Positive,1021,289,1310
778760,0,4 user reviews,2,2,4
778770,0,1 user reviews,1,0,1
778840,7,Positive,24,1,25
778860,0,9 user reviews,7,2,9
778930,6,Mostly Positive,28,12,40
779140,0,7 user reviews,6,1,7
779190,5,Mixed,8,7,15
779320,7,Positive,11,1,12
779330,6,Mostly Positive,120,46,166
779360,7,Positive,16,1,17
779390,0,3 user reviews,3,0,3
779420,5,Mixed,34,26,60
779550,0,2 user reviews,1,1,2
779570,5,Mixed,11,5,16
779580,0,5 user reviews,5,0,5
779620,0,8 user reviews,8,0,8
779670,6,Mostly Positive,27,8,35
779700,7,Positive,13,3,16
779730,0,8 user reviews,8,0,8
779760,0,7 user reviews,7,0,7
779770,0,9 user reviews,4,5,9
779780,0,2 user reviews,2,0,2
779790,0,5 user reviews,3,2,5
779800,0,1 user reviews,1,0,1
779870,0,No user reviews,0,0,0
779960,7,Positive,22,0,22
780000,0,4 user reviews,3,1,4
780100,0,No user reviews,0,0,0
780150,0,No user reviews,0,0,0
780210,6,Mostly Positive,56,21,77
780230,0,1 user reviews,1,0,1
780260,0,6 user reviews,4,2,6
780280,8,Very Positive,49,6,55
780320,0,2 user reviews,1,1,2
780350,0,No user reviews,0,0,0
780390,7,Positive,27,4,31
780430,0,No user reviews,0,0,0
780500,7,Positive,24,3,27
780580,5,Mixed,26,16,42
780630,0,3 user reviews,2,1,3
780750,5,Mixed,15,10,25
780760,7,Positive,10,0,10
780800,0,7 user reviews,5,2,7
781000,0,No user reviews,0,0,0
781100,5,Mixed,6,7,13
781110,7,Positive,21,0,21
781120,0,6 user reviews,6,0,6
781440,8,Very Positive,465,19,484
781490,7,Positive,10,0,10
781520,4,Mostly Negative,5,9,14
781560,0,7 user reviews,7,0,7
781600,5,Mixed,12,9,21
781610,0,9 user reviews,5,4,9
781650,0,7 user reviews,5,2,7
781670,0,4 user reviews,3,1,4
781760,0,6 user reviews,4,2,6
781800,0,3 user reviews,2,1,3
781810,7,Positive,22,0,22
781820,7,Positive,23,0,23
781890,0,No user reviews,0,0,0
781930,0,3 user reviews,2,1,3
781950,7,Positive,8,2,10
782100,7,Positive,8,2,10
782120,0,5 user reviews,5,0,5
782190,0,5 user reviews,4,1,5
782280,0,1 user reviews,1,0,1
782410,0,8 user reviews,1,7,8
782460,0,1 user reviews,1,0,1
782570,8,Very Positive,80,20,100
782650,0,2 user reviews,2,0,2
782690,5,Mixed,161,70,231
783050,8,Very Positive,53,7,60
783060,0,7 user reviews,4,3,7
783140,5,Mixed,11,11,22
783180,0,7 user reviews,6,1,7
783200,8,Very Positive,54,7,61
783220,0,9 user reviews,2,7,9
783240,4,Mostly Negative,59,136,195
783250,0,1 user reviews,1,0,1
783270,0,1 user reviews,1,0,1
783420,5,Mixed,6,4,10
783440,7,Positive,18,1,19
783470,0,3 user reviews,2,1,3
783590,0,No user reviews,0,0,0
783600,5,Mixed,9,8,17
783790,0,4 user reviews,4,0,4
783810,8,Very Positive,178,37,215
783890,0,3 user reviews,3,0,3
783940,7,Positive,26,5,31
784100,0,7 user reviews,6,1,7
784180,0,1 user reviews,1,0,1
784940,5,Mixed,49,61,110
785100,0,No user reviews,0,0,0
785110,5,Mixed,23,10,33
785130,8,Very Positive,60,9,69
785260,0,No user reviews,0,0,0
785610,0,2 user reviews,2,0,2
785640,7,Positive,15,3,18
785660,5,Mixed,17,22,39
785670,5,Mixed,9,11,20
785680,3,Negative,0,10,10
785690,0,1 user reviews,0,1,1
785780,6,Mostly Positive,52,14,66
785790,0,No user reviews,0,0,0
785840,8,Very Positive,185,45,230
785870,0,2 user reviews,2,0,2
785880,8,Very Positive,49,9,58
785890,7,Positive,39,1,40
785960,5,Mixed,9,8,17
786170,0,3 user reviews,2,1,3
786180,0,9 user reviews,7,2,9
786290,0,7 user reviews,4,3,7
786330,0,1 user reviews,1,0,1
786340,0,2 user reviews,2,0,2
786410,5,Mixed,56,25,81
786450,0,No user reviews,0,0,0
786470,0,6 user reviews,6,0,6
786490,0,6 user reviews,3,3,6
786510,7,Positive,17,3,20
786560,0,7 user reviews,4,3,7
786580,6,Mostly Positive,125,40,165
786630,7,Positive,33,3,36
786650,7,Positive,18,1,19
786670,4,Mostly Negative,5,15,20
786720,0,4 user reviews,2,2,4
786750,4,Mostly Negative,3,10,13
786800,0,1 user reviews,1,0,1
786820,7,Positive,11,0,11
786840,0,2 user reviews,1,1,2
786910,7,Positive,22,5,27
786940,0,7 user reviews,0,7,7
786990,7,Positive,13,2,15
787040,6,Mostly Positive,16,6,22
787100,0,2 user reviews,0,2,2
787110,6,Mostly Positive,132,39,171
787160,0,No user reviews,0,0,0
787200,0,No user reviews,0,0,0
787220,8,Very Positive,41,9,50
787240,5,Mixed,8,6,14
787390,6,Mostly Positive,21,8,29
787400,8,Very Positive,241,50,291
787420,0,8 user reviews,2,6,8
787440,0,2 user reviews,2,0,2
787450,8,Very Positive,437,43,480
787530,0,3 user reviews,3,0,3
787550,5,Mixed,13,8,21
787570,7,Positive,9,2,11
787650,0,No user reviews,0,0,0
787690,0,8 user reviews,6,2,8
787710,7,Positive,11,1,12
787720,0,3 user reviews,2,1,3
787780,0,7 user reviews,6,1,7
787970,7,Positive,13,3,16
788120,0,3 user reviews,3,0,3
788150,7,Positive,28,3,31
788190,0,9 user reviews,8,1,9
788200,0,5 user reviews,3,2,5
788210,5,Mixed,50,23,73
788270,8,Very Positive,136,27,163
788320,7,Positive,9,2,11
788330,0,No user reviews,0,0,0
788380,7,Positive,18,1,19
788410,7,Positive,26,3,29
788480,7,Positive,20,1,21
788500,0,2 user reviews,1,1,2
788510,4,Mostly Negative,11,32,43
788610,5,Mixed,13,6,19
788690,8,Very Positive,57,4,61
788730,0,1 user reviews,1,0,1
788740,6,Mostly Positive,19,7,26
788760,7,Positive,19,1,20
788850,6,Mostly Positive,106,42,148
788930,7,Positive,30,0,30
788970,5,Mixed,18,10,28
789000,5,Mixed,8,12,20
789100,4,Mostly Negative,35,59,94
789110,5,Mixed,18,10,28
789120,7,Positive,19,4,23
789200,0,8 user reviews,8,0,8
789210,0,No user reviews,0,0,0
789220,0,6 user reviews,3,3,6
789240,0,6 user reviews,6,0,6
789260,7,Positive,23,3,26
789280,0,2 user reviews,2,0,2
789510,0,3 user reviews,1,2,3
789570,7,Positive,14,0,14
789580,0,No user reviews,0,0,0
789600,0,1 user reviews,1,0,1
789710,0,No user reviews,0,0,0
789730,6,Mostly Positive,42,12,54
789880,4,Mostly Negative,5,9,14
789890,0,5 user reviews,1,4,5
789930,5,Mixed,5,5,10
789950,7,Positive,31,7,38
790020,0,No user reviews,0,0,0
790040,5,Mixed,11,14,25
790060,8,Very Positive,59,0,59
790130,0,9 user reviews,8,1,9
790160,4,Mostly Negative,3,7,10
790260,0,6 user reviews,4,2,6
790290,7,Positive,11,2,13
790340,5,Mixed,27,17,44
790390,0,7 user reviews,7,0,7
790400,5,Mixed,19,15,34
790450,7,Positive,25,5,30
790600,5,Mixed,132,65,197
790630,0,7 user reviews,7,0,7
790650,6,Mostly Positive,305,120,425
790810,0,5 user reviews,2,3,5
790820,0,No user reviews,0,0,0
790840,0,3 user reviews,3,0,3
790860,0,8 user reviews,6,2,8
790960,0,4 user reviews,4,0,4
791000,0,4 user reviews,4,0,4
791080,8,Very Positive,43,9,52
791160,7,Positive,12,2,14
791290,0,2 user reviews,2,0,2
791320,0,3 user reviews,1,2,3
791330,8,Very Positive,307,44,351
791370,0,1 user reviews,1,0,1
791390,0,No user reviews,0,0,0
791470,7,Positive,21,0,21
791500,0,8 user reviews,7,1,8
791540,0,5 user reviews,4,1,5
791600,0,1 user reviews,1,0,1
791700,7,Positive,38,3,41
791750,7,Positive,30,4,34
791760,0,5 user reviews,3,2,5
791800,0,No user reviews,0,0,0
791810,5,Mixed,6,9,15
791970,7,Positive,9,2,11
792030,8,Very Positive,108,3,111
792060,0,2 user reviews,1,1,2
792100,0,No user reviews,0,0,0
792160,0,5 user reviews,5,0,5
792350,7,Positive,25,2,27
792410,0,9 user reviews,9,0,9
792560,7,Positive,13,1,14
792640,0,4 user reviews,3,1,4
792650,7,Positive,14,2,16
792720,0,4 user reviews,4,0,4
792760,0,1 user reviews,0,1,1
792800,0,5 user reviews,2,3,5
792880,5,Mixed,9,8,17
792970,7,Positive,9,1,10
793000,0,1 user reviews,1,0,1
793010,0,8 user reviews,8,0,8
793030,0,3 user reviews,3,0,3
793050,4,Mostly Negative,13,26,39
793180,4,Mostly Negative,3,10,13
793200,7,Positive,31,6,37
793220,0,9 user reviews,8,1,9
793230,7,Positive,15,1,16
793240,7,Positive,13,1,14
793350,8,Very Positive,308,9,317
793360,0,No user reviews,0,0,0
793400,0,No user reviews,0,0,0
793450,7,Positive,25,1,26
793480,0,2 user reviews,2,0,2
793600,7,Positive,9,1,10
793630,7,Positive,9,1,10
793640,0,4 user reviews,4,0,4
793680,0,No user reviews,0,0,0
793700,0,3 user reviews,2,1,3
793720,8,Very Positive,268,14,282
793740,8,Very Positive,49,5,54
793760,7,Positive,10,1,11
793940,0,No user reviews,0,0,0
793990,5,Mixed,6,4,10
794050,3,Negative,2,9,11
794190,7,Positive,14,1,15
794240,0,No user reviews,0,0,0
794300,0,8 user reviews,2,6,8
794530,0,5 user reviews,2,3,5
794570,0,6 user reviews,6,0,6
794630,0,1 user reviews,1,0,1
794640,0,1 user reviews,1,0,1
794740,0,2 user reviews,2,0,2
794760,7,Positive,34,4,38
794800,7,Positive,40,9,49
794820,5,Mixed,18,12,30
794860,7,Positive,21,2,23
794940,7,Positive,14,0,14
794950,7,Positive,20,3,23
794990,0,3 user reviews,2,1,3
795030,7,Positive,9,1,10
795040,7,Positive,29,0,29
795050,7,Positive,11,0,11
795100,8,Very Positive,1933,116,2049
795110,0,9 user reviews,9,0,9
795160,0,5 user reviews,3,2,5
795220,0,No user reviews,0,0,0
795230,0,No user reviews,0,0,0
795320,0,2 user reviews,1,1,2
795430,0,2 user reviews,2,0,2
795480,0,3 user reviews,0,3,3
795510,0,No user reviews,0,0,0
795530,0,3 user reviews,2,1,3
795550,0,3 user reviews,2,1,3
795570,7,Positive,22,0,22
795610,0,No user reviews,0,0,0
795680,6,Mostly Positive,13,4,17
795920,0,2 user reviews,1,1,2
796130,0,1 user reviews,0,1,1
796260,0,No user reviews,0,0,0
796360,6,Mostly Positive,10,3,13
796370,0,4 user reviews,4,0,4
796380,7,Positive,11,1,12
796500,0,No user reviews,0,0,0
796510,7,Positive,14,2,16
796580,0,1 user reviews,0,1,1
796600,7,Positive,18,4,22
796640,5,Mixed,19,9,28
796650,7,Positive,13,3,16
796710,0,No user reviews,0,0,0
796770,0,2 user reviews,0,2,2
796780,7,Positive,13,1,14
796790,8,Very Positive,113,4,117
796840,0,8 user reviews,6,2,8
796900,0,5 user reviews,4,1,5
796920,0,No user reviews,0,0,0
796940,7,Positive,25,0,25
796950,0,3 user reviews,0,3,3
797040,4,Mostly Negative,8,13,21
797060,5,Mixed,7,6,13
797090,4,Mostly Negative,3,8,11
797160,4,Mostly Negative,13,20,33
797390,8,Very Positive,119,10,129
797410,0,No user reviews,0,0,0
797420,0,4 user reviews,2,2,4
797530,5,Mixed,24,17,41
797570,0,8 user reviews,8,0,8
797610,0,No user reviews,0,0,0
797620,7,Positive,15,0,15
797640,0,2 user reviews,1,1,2
798140,0,7 user reviews,7,0,7
798190,0,2 user reviews,2,0,2
798200,0,5 user reviews,4,1,5
798240,7,Positive,10,1,11
798260,5,Mixed,9,6,15
798270,0,7 user reviews,5,2,7
798280,8,Very Positive,52,12,64
798330,0,No user reviews,0,0,0
798350,0,3 user reviews,2,1,3
798370,0,5 user reviews,3,2,5
798380,7,Positive,10,1,11
798550,5,Mixed,13,11,24
798560,4,Mostly Negative,5,13,18
798650,7,Positive,13,0,13
798720,0,2 user reviews,2,0,2
798730,0,7 user reviews,6,1,7
798790,0,1 user reviews,1,0,1
798850,0,2 user reviews,2,0,2
798940,6,Mostly Positive,16,6,22
798960,0,6 user reviews,4,2,6
799070,8,Very Positive,433,12,445
799080,0,No user reviews,0,0,0
799110,7,Positive,13,1,14
799180,0,4 user reviews,4,0,4
799240,4,Mostly Negative,40,78,118
799590,0,3 user reviews,3,0,3
799610,0,4 user reviews,4,0,4
799730,6,Mostly Positive,11,3,14
799740,5,Mixed,23,11,34
799800,0,9 user reviews,8,1,9
799810,6,Mostly Positive,14,4,18
799840,6,Mostly Positive,12,4,16
800030,0,7 user reviews,2,5,7
800050,7,Positive,13,2,15
800110,0,6 user reviews,4,2,6
800180,7,Positive,17,1,18
800190,0,8 user reviews,8,0,8
800200,0,No user reviews,0,0,0
800230,0,8 user reviews,7,1,8
800240,0,No user reviews,0,0,0
800270,0,No user reviews,0,0,0
800310,0,6 user reviews,2,4,6
800320,0,3 user reviews,2,1,3
800330,0,3 user reviews,3,0,3
800520,0,5 user reviews,3,2,5
800560,6,Mostly Positive,7,3,10
800580,6,Mostly Positive,7,3,10
800620,8,Very Positive,63,3,66
800640,0,8 user reviews,8,0,8
800660,0,4 user reviews,3,1,4
800720,0,1 user reviews,1,0,1
800860,0,6 user reviews,6,0,6
800910,0,4 user reviews,4,0,4
800930,0,7 user reviews,7,0,7
801020,5,Mixed,21,21,42
801060,3,Negative,2,12,14
801080,0,No user reviews,0,0,0
801160,0,5 user reviews,2,3,5
801200,0,2 user reviews,2,0,2
801250,0,1 user reviews,1,0,1
801270,4,Mostly Negative,14,30,44
801290,7,Positive,22,1,23
801340,0,6 user reviews,1,5,6
801380,0,3 user reviews,2,1,3
801450,0,No user reviews,0,0,0
801490,0,6 user reviews,5,1,6
801500,0,1 user reviews,1,0,1
801510,4,Mostly Negative,8,13,21
801780,0,5 user reviews,0,5,5
801810,8,Very Positive,89,22,111
801870,5,Mixed,12,10,22
801900,0,2 user reviews,1,1,2
802040,7,Positive,18,0,18
802070,0,6 user reviews,6,0,6
802090,0,4 user reviews,2,2,4
802130,0,6 user reviews,6,0,6
802190,7,Positive,8,2,10
802360,0,2 user reviews,0,2,2
802400,7,Positive,11,0,11
802450,0,No user reviews,0,0,0
802490,7,Positive,12,0,12
802550,0,1 user reviews,1,0,1
802560,0,9 user reviews,4,5,9
802650,0,6 user reviews,2,4,6
802660,0,5 user reviews,1,4,5
802730,8,Very Positive,144,23,167
802740,7,Positive,25,0,25
802760,4,Mostly Negative,10,16,26
802810,0,9 user reviews,7,2,9
802880,7,Positive,41,1,42
802890,8,Very Positive,100,2,102
802900,0,9 user reviews,7,2,9
802970,0,2 user reviews,1,1,2
803030,8,Very Positive,60,15,75
803080,5,Mixed,11,7,18
803150,7,Positive,16,2,18
803160,7,Positive,24,3,27
803220,5,Mixed,27,22,49
803260,7,Positive,24,1,25
803590,0,8 user reviews,8,0,8
803600,0,No user reviews,0,0,0
803620,5,Mixed,11,9,20
803680,0,No user reviews,0,0,0
803780,0,3 user reviews,3,0,3
803850,7,Positive,16,1,17
803920,0,8 user reviews,7,1,8
803930,0,No user reviews,0,0,0
804080,7,Positive,9,2,11
804120,7,Positive,13,0,13
804210,4,Mostly Negative,6,10,16
804240,5,Mixed,22,13,35
804290,7,Positive,16,1,17
804300,0,3 user reviews,2,1,3
804350,0,2 user reviews,2,0,2
804430,5,Mixed,28,16,44
804440,0,5 user reviews,5,0,5
804460,5,Mixed,11,5,16
804490,0,No user reviews,0,0,0
804540,0,No user reviews,0,0,0
804550,0,4 user reviews,3,1,4
804600,0,3 user reviews,2,1,3
804680,0,No user reviews,0,0,0
804700,7,Positive,34,0,34
804730,6,Mostly Positive,131,48,179
804830,0,9 user reviews,5,4,9
804900,6,Mostly Positive,22,9,31
804910,0,No user reviews,0,0,0
805070,0,No user reviews,0,0,0
805090,0,1 user reviews,1,0,1
805120,0,5 user reviews,2,3,5
805240,6,Mostly Positive,17,7,24
805280,7,Positive,11,2,13
805320,7,Positive,17,0,17
805340,0,7 user reviews,7,0,7
805350,0,No user reviews,0,0,0
805360,0,4 user reviews,2,2,4
805400,0,4 user reviews,3,1,4
805420,0,7 user reviews,6,1,7
805440,7,Positive,10,1,11
805470,0,No user reviews,0,0,0
805500,5,Mixed,9,9,18
805610,7,Positive,25,4,29
805660,7,Positive,25,4,29
805680,0,3 user reviews,3,0,3
805690,0,No user reviews,0,0,0
805710,6,Mostly Positive,17,6,23
805780,5,Mixed,12,8,20
805790,0,No user reviews,0,0,0
805820,7,Positive,37,1,38
805840,0,6 user reviews,5,1,6
805850,6,Mostly Positive,1041,277,1318
805870,5,Mixed,13,11,24
805880,0,3 user reviews,2,1,3
805920,7,Positive,21,1,22
805940,0,No user reviews,0,0,0
805950,0,1 user reviews,1,0,1
806020,7,Positive,15,0,15
806080,0,2 user reviews,1,1,2
806100,7,Positive,37,5,42
806140,5,Mixed,52,53,105
806160,0,3 user reviews,1,2,3
806230,0,5 user reviews,4,1,5
806240,0,5 user reviews,2,3,5
806480,0,2 user reviews,1,1,2
806610,0,4 user reviews,4,0,4
806720,7,Positive,15,0,15
806770,6,Mostly Positive,14,5,19
806850,0,3 user reviews,2,1,3
806860,5,Mixed,48,21,69
806960,7,Positive,10,2,12
806970,0,7 user reviews,6,1,7
806990,0,4 user reviews,3,1,4
807070,0,5 user reviews,5,0,5
807230,7,Positive,25,6,31
807310,0,No user reviews,0,0,0
807430,0,No user reviews,0,0,0
807770,0,4 user reviews,3,1,4
807780,0,2 user reviews,0,2,2
807790,5,Mixed,6,7,13
807820,0,2 user reviews,0,2,2
807830,0,5 user reviews,2,3,5
807840,0,6 user reviews,4,2,6
807850,0,4 user reviews,2,2,4
807860,0,3 user reviews,1,2,3
807880,0,3 user reviews,1,2,3
807890,0,2 user reviews,1,1,2
807910,0,1 user reviews,1,0,1
807920,5,Mixed,20,18,38
807930,0,No user reviews,0,0,0
807940,0,1 user reviews,0,1,1
807950,0,2 user reviews,1,1,2
807960,0,4 user reviews,4,0,4
808120,0,2 user reviews,1,1,2
808130,0,3 user reviews,3,0,3
808270,0,2 user reviews,1,1,2
808420,0,7 user reviews,3,4,7
808450,0,8 user reviews,6,2,8
808570,5,Mixed,11,15,26
808950,0,6 user reviews,5,1,6
808990,0,5 user reviews,5,0,5
809040,0,3 user reviews,2,1,3
809050,7,Positive,14,3,17
809140,8,Very Positive,273,29,302
809200,0,5 user reviews,3,2,5
809210,5,Mixed,28,14,42
809240,7,Positive,15,0,15
809250,8,Very Positive,76,3,79
809320,7,Positive,13,2,15
809360,0,7 user reviews,6,1,7
809430,0,No user reviews,0,0,0
809440,6,Mostly Positive,82,22,104
809460,0,6 user reviews,6,0,6
809470,0,4 user reviews,3,1,4
809540,7,Positive,21,5,26
809640,0,No user reviews,0,0,0
809680,7,Positive,18,1,19
809700,0,3 user reviews,3,0,3
809850,7,Positive,27,3,30
809890,0,No user reviews,0,0,0
809950,0,8 user reviews,7,1,8
810000,0,6 user reviews,5,1,6
810050,0,1 user reviews,1,0,1
810160,4,Mostly Negative,6,17,23
810230,8,Very Positive,145,6,151
810270,5,Mixed,12,15,27
810330,0,2 user reviews,2,0,2
810360,0,4 user reviews,3,1,4
810460,5,Mixed,21,10,31
810540,0,2 user reviews,1,1,2
810560,7,Positive,31,5,36
810570,0,9 user reviews,5,4,9
810630,6,Mostly Positive,8,3,11
810640,0,No user reviews,0,0,0
810660,7,Positive,24,1,25
810670,6,Mostly Positive,309,80,389
810760,5,Mixed,13,8,21
810780,6,Mostly Positive,35,11,46
811040,0,6 user reviews,6,0,6
811240,7,Positive,13,2,15
811250,0,3 user reviews,2,1,3
811270,0,No user reviews,0,0,0
811290,0,6 user reviews,6,0,6
811360,4,Mostly Negative,12,26,38
811540,0,5 user reviews,3,2,5
811720,7,Positive,23,3,26
811860,0,4 user reviews,1,3,4
811950,0,2 user reviews,0,2,2
812020,6,Mostly Positive,29,8,37
812070,7,Positive,26,5,31
812170,0,6 user reviews,4,2,6
812350,0,4 user reviews,2,2,4
812450,0,4 user reviews,3,1,4
812560,7,Positive,24,4,28
812740,0,No user reviews,0,0,0
812800,7,Positive,16,0,16
812850,0,8 user reviews,3,5,8
812860,0,9 user reviews,5,4,9
812900,0,1 user reviews,1,0,1
812940,0,6 user reviews,4,2,6
813240,0,3 user reviews,2,1,3
813250,0,3 user reviews,2,1,3
813280,0,1 user reviews,0,1,1
813290,6,Mostly Positive,28,9,37
813350,0,No user reviews,0,0,0
813370,0,7 user reviews,7,0,7
813540,8,Very Positive,51,4,55
813590,6,Mostly Positive,13,4,17
813630,8,Very Positive,89,0,89
813650,7,Positive,12,0,12
813660,5,Mixed,11,15,26
813670,7,Positive,32,0,32
813680,7,Positive,16,0,16
813700,8,Very Positive,69,13,82
813920,0,4 user reviews,2,2,4
814010,0,3 user reviews,1,2,3
814030,0,5 user reviews,3,2,5
814190,0,3 user reviews,2,1,3
814200,7,Positive,25,3,28
814540,8,Very Positive,675,53,728
814670,6,Mostly Positive,19,7,26
814900,7,Positive,28,6,34
815000,8,Very Positive,67,2,69
815070,0,5 user reviews,5,0,5
815150,7,Positive,18,1,19
815170,0,No user reviews,0,0,0
815240,0,3 user reviews,2,1,3
815250,0,5 user reviews,3,2,5
815320,0,No user reviews,0,0,0
815390,0,4 user reviews,3,1,4
815450,7,Positive,39,1,40
815730,0,2 user reviews,2,0,2
815800,0,5 user reviews,5,0,5
815830,0,5 user reviews,4,1,5
815840,0,1 user reviews,1,0,1
815950,0,6 user reviews,5,1,6
816060,5,Mixed,5,6,11
816080,7,Positive,26,3,29
816090,5,Mixed,497,257,754
816120,7,Positive,36,1,37
816150,0,No user reviews,0,0,0
816160,0,3 user reviews,0,3,3
816170,0,6 user reviews,6,0,6
816180,7,Positive,24,2,26
816190,7,Positive,14,2,16
816200,0,No user reviews,0,0,0
816210,7,Positive,8,2,10
816250,7,Positive,10,1,11
816260,6,Mostly Positive,13,5,18
816270,7,Positive,15,1,16
816330,5,Mixed,15,9,24
816380,0,1 user reviews,0,1,1
816400,0,1 user reviews,0,1,1
816490,8,Very Positive,63,2,65
816500,7,Positive,10,2,12
816580,0,5 user reviews,2,3,5
816610,0,1 user reviews,1,0,1
816660,0,9 user reviews,2,7,9
816700,5,Mixed,12,6,18
816710,7,Positive,17,0,17
816730,0,2 user reviews,2,0,2
816820,4,Mostly Negative,22,60,82
816830,7,Positive,14,0,14
816840,0,No user reviews,0,0,0
816870,0,7 user reviews,6,1,7
816990,7,Positive,17,3,20
817110,0,1 user reviews,0,1,1
817190,7,Positive,23,0,23
817200,5,Mixed,10,5,15
817250,5,Mixed,17,8,25
817410,0,2 user reviews,2,0,2
817470,7,Positive,8,2,10
817490,0,9 user reviews,9,0,9
817510,5,Mixed,328,157,485
817690,5,Mixed,16,15,31
817710,0,No user reviews,0,0,0
817720,0,No user reviews,0,0,0
817760,6,Mostly Positive,24,8,32
817770,6,Mostly Positive,18,7,25
817810,0,No user reviews,0,0,0
817820,0,1 user reviews,1,0,1
817860,0,7 user reviews,7,0,7
818140,7,Positive,21,0,21
818220,7,Positive,8,2,10
818290,5,Mixed,6,8,14
818320,8,Very Positive,40,10,50
818440,5,Mixed,13,9,22
818450,5,Mixed,23,19,42
818480,0,7 user reviews,5,2,7
818500,0,No user reviews,0,0,0
818530,0,4 user reviews,4,0,4
818570,7,Positive,17,3,20
818610,7,Positive,13,0,13
818620,0,3 user reviews,2,1,3
818730,7,Positive,17,3,20
818760,7,Positive,18,0,18
818780,0,No user reviews,0,0,0
818830,0,2 user reviews,2,0,2
818890,0,2 user reviews,0,2,2
819070,0,No user reviews,0,0,0
819080,0,No user reviews,0,0,0
819130,0,No user reviews,0,0,0
819210,0,6 user reviews,2,4,6
819220,0,No user reviews,0,0,0
819230,8,Very Positive,56,7,63
819330,0,8 user reviews,8,0,8
819480,7,Positive,43,2,45
819550,0,No user reviews,0,0,0
819560,0,1 user reviews,1,0,1
819730,0,No user reviews,0,0,0
819740,0,9 user reviews,9,0,9
819910,0,7 user reviews,4,3,7
819950,0,No user reviews,0,0,0
820030,7,Positive,31,4,35
820050,5,Mixed,8,9,17
820090,5,Mixed,17,9,26
820170,0,6 user reviews,6,0,6
820210,0,8 user reviews,8,0,8
820240,7,Positive,25,5,30
820250,0,5 user reviews,3,2,5
820460,6,Mostly Positive,34,11,45
820510,0,No user reviews,0,0,0
820580,5,Mixed,10,12,22
820600,0,6 user reviews,6,0,6
820610,7,Positive,33,5,38
820710,5,Mixed,8,11,19
820730,7,Positive,22,0,22
820750,4,Mostly Negative,17,29,46
820760,6,Mostly Positive,22,7,29
820770,5,Mixed,263,125,388
820830,0,1 user reviews,1,0,1
820880,0,No user reviews,0,0,0
820900,7,Positive,24,3,27
820910,0,2 user reviews,2,0,2
820920,6,Mostly Positive,14,5,19
820950,7,Positive,22,0,22
821190,0,6 user reviews,4,2,6
821370,0,9 user reviews,6,3,9
821390,0,2 user reviews,1,1,2
821400,0,No user reviews,0,0,0
821500,6,Mostly Positive,50,18,68
821520,0,5 user reviews,3,2,5
821550,6,Mostly Positive,7,3,10
821560,8,Very Positive,67,12,79
821570,0,1 user reviews,1,0,1
821640,8,Very Positive,70,8,78
821670,0,No user reviews,0,0,0
821790,8,Very Positive,99,0,99
822140,0,4 user reviews,4,0,4
822460,0,4 user reviews,3,1,4
822530,7,Positive,32,4,36
822540,0,No user reviews,0,0,0
822550,0,4 user reviews,3,1,4
822680,0,3 user reviews,2,1,3
822700,0,7 user reviews,7,0,7
822720,0,8 user reviews,7,1,8
822750,0,2 user reviews,2,0,2
822810,0,4 user reviews,4,0,4
822900,0,5 user reviews,4,1,5
822910,0,3 user reviews,2,1,3
822930,8,Very Positive,153,7,160
822970,0,1 user reviews,1,0,1
823040,0,3 user reviews,3,0,3
823060,5,Mixed,8,9,17
823100,5,Mixed,9,4,13
823280,0,5 user reviews,3,2,5
823330,0,4 user reviews,2,2,4
823340,0,2 user reviews,1,1,2
823360,6,Mostly Positive,11,3,14
823390,7,Positive,25,1,26
823640,0,1 user reviews,1,0,1
823700,6,Mostly Positive,14,4,18
823710,4,Mostly Negative,5,9,14
823730,0,6 user reviews,2,4,6
823740,0,3 user reviews,1,2,3
823770,0,2 user reviews,1,1,2
823830,8,Very Positive,115,9,124
823920,7,Positive,11,2,13
824190,5,Mixed,20,19,39
824210,7,Positive,28,5,33
824250,0,2 user reviews,2,0,2
824260,0,No user reviews,0,0,0
824420,6,Mostly Positive,19,6,25
824580,5,Mixed,6,8,14
824640,0,No user reviews,0,0,0
824720,8,Very Positive,84,16,100
824760,0,No user reviews,0,0,0
825000,0,9 user reviews,4,5,9
825240,0,9 user reviews,9,0,9
825490,0,5 user reviews,2,3,5
825550,6,Mostly Positive,26,7,33
825610,4,Mostly Negative,12,19,31
825630,9,Overwhelmingly Positive,640,9,649
825930,7,Positive,13,2,15
825970,0,6 user reviews,5,1,6
826000,0,No user reviews,0,0,0
826010,7,Positive,11,0,11
826130,4,Mostly Negative,3,8,11
826160,0,3 user reviews,2,1,3
826170,0,5 user reviews,5,0,5
826420,0,No user reviews,0,0,0
826580,0,1 user reviews,0,1,1
826660,0,3 user reviews,3,0,3
826930,0,5 user reviews,5,0,5
827210,0,No user reviews,0,0,0
827220,6,Mostly Positive,19,8,27
827270,0,3 user reviews,1,2,3
827450,0,No user reviews,0,0,0
827540,0,No user reviews,0,0,0
827590,0,1 user reviews,1,0,1
827640,7,Positive,15,0,15
827660,0,No user reviews,0,0,0
827670,0,5 user reviews,2,3,5
827830,0,3 user reviews,3,0,3
827900,0,4 user reviews,2,2,4
827920,0,5 user reviews,3,2,5
828150,5,Mixed,30,19,49
828170,5,Mixed,20,12,32
828230,5,Mixed,11,12,23
828250,0,1 user reviews,1,0,1
828290,5,Mixed,8,6,14
828350,6,Mostly Positive,11,3,14
828380,6,Mostly Positive,19,7,26
828460,0,3 user reviews,3,0,3
828510,0,8 user reviews,2,6,8
828550,0,7 user reviews,5,2,7
828860,0,2 user reviews,2,0,2
828910,6,Mostly Positive,8,3,11
828950,7,Positive,12,1,13
828960,4,Mostly Negative,12,25,37
828970,0,No user reviews,0,0,0
829040,0,2 user reviews,2,0,2
829050,8,Very Positive,96,13,109
829080,0,6 user reviews,3,3,6
829210,0,6 user reviews,6,0,6
829250,5,Mixed,8,9,17
829260,7,Positive,12,2,14
829300,0,3 user reviews,2,1,3
829370,7,Positive,15,1,16
829390,0,7 user reviews,5,2,7
829420,5,Mixed,13,19,32
829490,0,4 user reviews,4,0,4
829540,0,7 user reviews,7,0,7
829600,7,Positive,19,0,19
829750,0,1 user reviews,1,0,1
829780,0,5 user reviews,3,2,5
830360,0,8 user reviews,7,1,8
830380,0,3 user reviews,1,2,3
830390,0,No user reviews,0,0,0
830470,0,7 user reviews,7,0,7
830490,0,1 user reviews,0,1,1
830510,0,3 user reviews,0,3,3
830520,0,3 user reviews,3,0,3
830710,6,Mostly Positive,8,3,11
831060,0,7 user reviews,6,1,7
831090,7,Positive,20,1,21
831120,7,Positive,10,1,11
831180,0,2 user reviews,2,0,2
831230,7,Positive,25,3,28
831490,0,9 user reviews,7,2,9
831510,0,2 user reviews,2,0,2
831520,0,7 user reviews,2,5,7
831680,0,3 user reviews,2,1,3
831740,0,No user reviews,0,0,0
831770,7,Positive,22,2,24
832020,0,8 user reviews,7,1,8
832030,7,Positive,21,4,25
832490,0,3 user reviews,0,3,3
832650,6,Mostly Positive,11,3,14
832690,0,No user reviews,0,0,0
832790,5,Mixed,6,4,10
833010,6,Mostly Positive,9,3,12
833030,7,Positive,12,2,14
833140,7,Positive,9,1,10
833150,0,4 user reviews,2,2,4
833180,0,2 user reviews,0,2,2
833260,0,3 user reviews,3,0,3
833290,7,Positive,23,0,23
833300,0,4 user reviews,2,2,4
833380,0,9 user reviews,3,6,9
833410,7,Positive,33,3,36
833540,0,2 user reviews,1,1,2
833650,0,No user reviews,0,0,0
833660,0,8 user reviews,5,3,8
833800,0,3 user reviews,3,0,3
833810,0,5 user reviews,3,2,5
833820,0,No user reviews,0,0,0
833890,0,2 user reviews,1,1,2
833910,7,Positive,37,4,41
833990,7,Positive,13,0,13
834180,0,6 user reviews,6,0,6
834330,7,Positive,11,2,13
834340,7,Positive,10,2,12
834380,7,Positive,12,0,12
834390,0,9 user reviews,7,2,9
834420,0,3 user reviews,2,1,3
834740,0,No user reviews,0,0,0
834750,5,Mixed,16,11,27
834890,4,Mostly Negative,4,8,12
835040,7,Positive,13,2,15
835110,0,8 user reviews,7,1,8
835430,0,No user reviews,0,0,0
835450,0,7 user reviews,5,2,7
835530,5,Mixed,13,9,22
835560,0,4 user reviews,3,1,4
835600,0,3 user reviews,2,1,3
835640,0,No user reviews,0,0,0
835680,0,No user reviews,0,0,0
835740,0,2 user reviews,2,0,2
835790,0,No user reviews,0,0,0
836200,0,7 user reviews,3,4,7
836260,0,7 user reviews,7,0,7
836290,0,No user reviews,0,0,0
836420,0,1 user reviews,0,1,1
836480,5,Mixed,225,149,374
836490,8,Very Positive,188,9,197
836540,0,No user reviews,0,0,0
836550,0,1 user reviews,1,0,1
836560,0,1 user reviews,1,0,1
836700,0,2 user reviews,2,0,2
836760,7,Positive,29,7,36
836790,7,Positive,9,1,10
837210,0,2 user reviews,1,1,2
837330,0,4 user reviews,4,0,4
837390,0,4 user reviews,2,2,4
837530,0,6 user reviews,1,5,6
837550,0,3 user reviews,3,0,3
837780,0,No user reviews,0,0,0
837900,0,2 user reviews,0,2,2
837930,0,5 user reviews,4,1,5
838050,4,Mostly Negative,3,9,12
838160,0,2 user reviews,1,1,2
838260,0,9 user reviews,5,4,9
838270,5,Mixed,8,11,19
838310,9,Overwhelmingly Positive,1114,41,1155
838340,0,8 user reviews,8,0,8
838360,0,No user reviews,0,0,0
838390,7,Positive,28,0,28
838420,0,5 user reviews,1,4,5
838430,0,No user reviews,0,0,0
838440,0,9 user reviews,9,0,9
838490,0,4 user reviews,4,0,4
838500,5,Mixed,6,6,12
838510,5,Mixed,33,21,54
838640,0,7 user reviews,5,2,7
838720,0,No user reviews,0,0,0
838900,5,Mixed,83,98,181
839020,0,No user reviews,0,0,0
839030,0,8 user reviews,5,3,8
839170,0,8 user reviews,5,3,8
839220,0,No user reviews,0,0,0
839260,6,Mostly Positive,11,4,15
839300,7,Positive,21,4,25
839340,0,2 user reviews,2,0,2
839430,0,No user reviews,0,0,0
839530,0,1 user reviews,1,0,1
839540,0,6 user reviews,1,5,6
839570,7,Positive,12,2,14
839590,0,No user reviews,0,0,0
839620,0,3 user reviews,2,1,3
839670,0,7 user reviews,7,0,7
839730,0,7 user reviews,1,6,7
839750,0,2 user reviews,2,0,2
839880,6,Mostly Positive,103,27,130
839940,7,Positive,12,0,12
840020,0,No user reviews,0,0,0
840060,7,Positive,27,3,30
840100,7,Positive,16,2,18
840120,0,No user reviews,0,0,0
840230,0,3 user reviews,3,0,3
840240,0,5 user reviews,4,1,5
840250,5,Mixed,6,4,10
840310,7,Positive,21,1,22
840380,0,No user reviews,0,0,0
840500,0,5 user reviews,5,0,5
840580,0,3 user reviews,3,0,3
840700,6,Mostly Positive,10,3,13
840710,0,2 user reviews,2,0,2
840790,0,3 user reviews,2,1,3
840910,7,Positive,13,1,14
840980,0,6 user reviews,6,0,6
841010,0,8 user reviews,8,0,8
841020,0,3 user reviews,2,1,3
841030,7,Positive,16,0,16
841100,0,3 user reviews,2,1,3
841120,7,Positive,12,3,15
841140,0,5 user reviews,3,2,5
841200,0,1 user reviews,0,1,1
841210,8,Very Positive,45,9,54
841260,0,4 user reviews,2,2,4
841320,0,7 user reviews,6,1,7
841350,6,Mostly Positive,19,5,24
841410,0,8 user reviews,4,4,8
841570,0,2 user reviews,1,1,2
841770,8,Very Positive,206,2,208
841840,5,Mixed,6,9,15
841860,5,Mixed,17,11,28
841980,0,1 user reviews,1,0,1
842030,0,3 user reviews,1,2,3
842120,0,No user reviews,0,0,0
842150,5,Mixed,50,29,79
842220,0,3 user reviews,0,3,3
842290,0,5 user reviews,1,4,5
842310,4,Mostly Negative,14,28,42
842440,0,3 user reviews,3,0,3
842470,0,5 user reviews,5,0,5
842510,0,1 user reviews,0,1,1
842640,0,9 user reviews,5,4,9
842760,0,4 user reviews,4,0,4
842870,0,9 user reviews,7,2,9
842990,0,4 user reviews,4,0,4
843010,7,Positive,10,1,11
843040,0,1 user reviews,0,1,1
843120,0,2 user reviews,2,0,2
843130,0,No user reviews,0,0,0
843190,0,1 user reviews,1,0,1
843210,5,Mixed,13,10,23
843250,7,Positive,26,5,31
843270,5,Mixed,6,4,10
843430,7,Positive,38,2,40
843440,7,Positive,35,0,35
843520,0,No user reviews,0,0,0
843530,6,Mostly Positive,14,6,20
843570,0,6 user reviews,4,2,6
843660,6,Mostly Positive,41,11,52
843740,7,Positive,10,1,11
843780,0,1 user reviews,1,0,1
843890,5,Mixed,21,18,39
843980,0,1 user reviews,1,0,1
844130,7,Positive,11,0,11
844140,0,1 user reviews,1,0,1
844160,0,1 user reviews,1,0,1
844180,7,Positive,11,0,11
844210,5,Mixed,16,8,24
844290,0,5 user reviews,1,4,5
844300,0,9 user reviews,3,6,9
844310,0,3 user reviews,1,2,3
844380,8,Very Positive,58,8,66
844490,4,Mostly Negative,5,8,13
844580,0,1 user reviews,0,1,1
844610,0,2 user reviews,0,2,2
844750,0,7 user reviews,2,5,7
844800,0,2 user reviews,0,2,2
844850,0,No user reviews,0,0,0
844930,8,Very Positive,457,13,470
844970,0,9 user reviews,9,0,9
845040,0,No user reviews,0,0,0
845060,5,Mixed,6,5,11
845150,0,3 user reviews,3,0,3
845180,0,5 user reviews,2,3,5
845200,5,Mixed,6,4,10
845270,7,Positive,16,1,17
845290,0,No user reviews,0,0,0
845350,0,1 user reviews,1,0,1
845380,7,Positive,17,1,18
845400,5,Mixed,5,7,12
845420,0,4 user reviews,2,2,4
845480,0,4 user reviews,2,2,4
845490,0,No user reviews,0,0,0
845500,4,Mostly Negative,3,11,14
845510,0,1 user reviews,1,0,1
845530,4,Mostly Negative,5,11,16
845570,0,2 user reviews,0,2,2
845600,0,1 user reviews,1,0,1
845610,7,Positive,19,3,22
845630,7,Positive,13,3,16
845730,7,Positive,9,2,11
845820,0,3 user reviews,2,1,3
845880,0,No user reviews,0,0,0
845940,0,9 user reviews,9,0,9
845970,0,1 user reviews,1,0,1
846000,0,No user reviews,0,0,0
846010,0,7 user reviews,5,2,7
846110,8,Very Positive,140,20,160
846120,0,No user reviews,0,0,0
846200,5,Mixed,27,16,43
846210,0,2 user reviews,2,0,2
846220,0,1 user reviews,1,0,1
846240,5,Mixed,5,7,12
846260,5,Mixed,45,31,76
846430,0,2 user reviews,0,2,2
846440,6,Mostly Positive,14,4,18
846470,8,Very Positive,167,19,186
846700,0,1 user reviews,1,0,1
846710,7,Positive,13,2,15
846790,5,Mixed,12,9,21
846800,0,No user reviews,0,0,0
846820,7,Positive,15,2,17
847100,0,2 user reviews,2,0,2
847260,0,8 user reviews,4,4,8
847290,7,Positive,11,0,11
847310,0,3 user reviews,2,1,3
847390,0,2 user reviews,2,0,2
847450,0,5 user reviews,5,0,5
847580,0,2 user reviews,0,2,2
847630,0,5 user reviews,3,2,5
847800,0,No user reviews,0,0,0
848090,0,1 user reviews,1,0,1
848200,7,Positive,16,1,17
848230,0,2 user reviews,2,0,2
848260,0,3 user reviews,1,2,3
848270,0,4 user reviews,3,1,4
848280,7,Positive,40,0,40
848360,4,Mostly Negative,5,9,14
848400,0,No user reviews,0,0,0
848430,0,No user reviews,0,0,0
848540,0,1 user reviews,0,1,1
848640,0,1 user reviews,1,0,1
848650,5,Mixed,5,6,11
848710,0,1 user reviews,1,0,1
848720,0,3 user reviews,3,0,3
848740,0,2 user reviews,1,1,2
848750,0,1 user reviews,1,0,1
848760,0,No user reviews,0,0,0
848780,0,1 user reviews,1,0,1
849320,0,4 user reviews,2,2,4
849360,0,5 user reviews,5,0,5
849410,0,No user reviews,0,0,0
849520,7,Positive,9,1,10
849550,0,6 user reviews,4,2,6
849560,0,5 user reviews,2,3,5
849600,0,7 user reviews,7,0,7
849620,0,No user reviews,0,0,0
849790,0,3 user reviews,3,0,3
849800,0,1 user reviews,1,0,1
849840,0,1 user reviews,0,1,1
849920,0,No user reviews,0,0,0
849970,0,4 user reviews,3,1,4
850050,5,Mixed,9,7,16
850060,7,Positive,17,2,19
850310,0,3 user reviews,1,2,3
850450,6,Mostly Positive,60,23,83
850630,8,Very Positive,53,4,57
850690,4,Mostly Negative,19,42,61
850710,0,1 user reviews,1,0,1
850720,0,2 user reviews,2,0,2
850810,0,4 user reviews,1,3,4
850840,0,No user reviews,0,0,0
850880,0,No user reviews,0,0,0
850930,0,1 user reviews,1,0,1
850950,0,1 user reviews,0,1,1
850960,0,5 user reviews,0,5,5
851000,0,6 user reviews,6,0,6
851010,0,4 user reviews,3,1,4
851030,0,No user reviews,0,0,0
851050,6,Mostly Positive,21,9,30
851200,0,8 user reviews,5,3,8
851290,0,No user reviews,0,0,0
851520,0,No user reviews,0,0,0
851530,8,Very Positive,223,11,234
851580,0,5 user reviews,5,0,5
851650,5,Mixed,15,9,24
851670,7,Positive,46,1,47
851710,0,No user reviews,0,0,0
851730,7,Positive,14,0,14
851770,0,No user reviews,0,0,0
851810,5,Mixed,18,9,27
851820,7,Positive,36,6,42
851840,0,4 user reviews,4,0,4
851880,0,3 user reviews,1,2,3
851920,0,No user reviews,0,0,0
852110,8,Very Positive,50,0,50
852390,0,7 user reviews,7,0,7
852420,0,No user reviews,0,0,0
852570,0,No user reviews,0,0,0
852660,0,1 user reviews,1,0,1
852750,0,No user reviews,0,0,0
852760,0,1 user reviews,1,0,1
852790,7,Positive,13,0,13
853040,0,6 user reviews,5,1,6
853110,7,Positive,10,0,10
853210,0,5 user reviews,1,4,5
853260,0,4 user reviews,4,0,4
853380,7,Positive,14,2,16
853480,0,8 user reviews,7,1,8
853500,8,Very Positive,131,14,145
853590,0,1 user reviews,1,0,1
853610,0,5 user reviews,5,0,5
853850,0,2 user reviews,2,0,2
853860,0,5 user reviews,5,0,5
854060,0,2 user reviews,0,2,2
854160,0,4 user reviews,1,3,4
854190,0,6 user reviews,3,3,6
854300,0,5 user reviews,4,1,5
854380,7,Positive,47,1,48
854390,0,3 user reviews,2,1,3
854540,0,No user reviews,0,0,0
854560,0,3 user reviews,2,1,3
854650,0,3 user reviews,3,0,3
854670,0,2 user reviews,2,0,2
854770,0,No user reviews,0,0,0
854870,0,No user reviews,0,0,0
855030,0,No user reviews,0,0,0
855100,0,4 user reviews,4,0,4
855160,0,1 user reviews,0,1,1
855370,6,Mostly Positive,11,4,15
855480,0,3 user reviews,0,3,3
855490,0,3 user reviews,1,2,3
855700,0,5 user reviews,4,1,5
855730,0,3 user reviews,3,0,3
855760,0,No user reviews,0,0,0
855850,7,Positive,9,1,10
856040,0,No user reviews,0,0,0
856110,7,Positive,13,0,13
856120,7,Positive,16,0,16
856130,6,Mostly Positive,50,20,70
856260,0,1 user reviews,1,0,1
856380,0,2 user reviews,1,1,2
856400,3,Negative,2,16,18
856410,0,1 user reviews,1,0,1
856430,7,Positive,12,0,12
856440,5,Mixed,7,9,16
856450,0,2 user reviews,2,0,2
856460,7,Positive,32,2,34
856490,0,8 user reviews,5,3,8
856540,0,No user reviews,0,0,0
856550,0,2 user reviews,2,0,2
856760,0,4 user reviews,4,0,4
856880,5,Mixed,24,12,36
856980,0,2 user reviews,2,0,2
856990,0,No user reviews,0,0,0
857010,6,Mostly Positive,10,3,13
857020,0,4 user reviews,4,0,4
857050,0,4 user reviews,4,0,4
857100,6,Mostly Positive,29,9,38
857140,0,9 user reviews,7,2,9
857180,0,No user reviews,0,0,0
857210,0,No user reviews,0,0,0
857300,0,No user reviews,0,0,0
857330,0,2 user reviews,2,0,2
857370,0,No user reviews,0,0,0
857440,8,Very Positive,1720,262,1982
857520,7,Positive,9,2,11
857570,0,9 user reviews,6,3,9
857690,0,No user reviews,0,0,0
857710,7,Positive,8,2,10
857860,0,1 user reviews,1,0,1
857940,8,Very Positive,229,15,244
858060,4,Mostly Negative,27,81,108
858160,0,5 user reviews,4,1,5
858180,0,1 user reviews,0,1,1
858220,0,4 user reviews,1,3,4
858360,0,4 user reviews,4,0,4
858370,0,5 user reviews,4,1,5
858420,0,1 user reviews,0,1,1
858500,0,No user reviews,0,0,0
858730,0,No user reviews,0,0,0
858760,8,Very Positive,138,1,139
858780,6,Mostly Positive,9,3,12
858810,0,No user reviews,0,0,0
858830,0,No user reviews,0,0,0
858840,0,1 user reviews,1,0,1
858870,7,Positive,13,0,13
859030,0,5 user reviews,2,3,5
859120,0,No user reviews,0,0,0
859200,0,No user reviews,0,0,0
859340,0,No user reviews,0,0,0
859410,0,9 user reviews,5,4,9
859420,0,2 user reviews,2,0,2
859440,0,No user reviews,0,0,0
859480,0,4 user reviews,3,1,4
859610,0,2 user reviews,2,0,2
859640,0,6 user reviews,6,0,6
859700,6,Mostly Positive,11,3,14
859820,0,No user reviews,0,0,0
859900,7,Positive,24,5,29
859980,0,8 user reviews,7,1,8
859990,0,5 user reviews,5,0,5
860030,0,No user reviews,0,0,0
860070,0,4 user reviews,4,0,4
860090,0,9 user reviews,7,2,9
860220,0,7 user reviews,6,1,7
860240,0,1 user reviews,1,0,1
860340,0,No user reviews,0,0,0
860350,0,No user reviews,0,0,0
860360,0,1 user reviews,0,1,1
860380,0,7 user reviews,6,1,7
860390,6,Mostly Positive,7,3,10
860400,0,No user reviews,0,0,0
860450,0,5 user reviews,4,1,5
860520,0,7 user reviews,6,1,7
860530,6,Mostly Positive,7,3,10
860570,0,2 user reviews,0,2,2
860580,0,3 user reviews,1,2,3
860650,7,Positive,17,1,18
860660,0,No user reviews,0,0,0
860770,0,6 user reviews,4,2,6
860790,0,5 user reviews,5,0,5
860820,0,3 user reviews,3,0,3
860860,7,Positive,26,6,32
860910,0,8 user reviews,5,3,8
861080,0,6 user reviews,5,1,6
861180,3,Negative,2,13,15
861190,5,Mixed,5,7,12
861210,0,No user reviews,0,0,0
861460,7,Positive,16,0,16
861550,0,No user reviews,0,0,0
861570,0,5 user reviews,3,2,5
861580,0,2 user reviews,2,0,2
861720,0,No user reviews,0,0,0
861740,0,1 user reviews,1,0,1
861770,0,1 user reviews,1,0,1
861790,0,1 user reviews,0,1,1
861840,0,3 user reviews,2,1,3
861960,0,3 user reviews,3,0,3
862110,0,8 user reviews,8,0,8
862120,0,No user reviews,0,0,0
862150,0,6 user reviews,6,0,6
862190,0,No user reviews,0,0,0
862200,0,3 user reviews,3,0,3
862210,0,8 user reviews,7,1,8
862300,0,6 user reviews,4,2,6
862370,0,No user reviews,0,0,0
862570,8,Very Positive,55,0,55
862580,7,Positive,36,7,43
862650,0,8 user reviews,4,4,8
862660,4,Mostly Negative,9,15,24
862690,8,Very Positive,1191,177,1368
862740,0,No user reviews,0,0,0
862770,0,No user reviews,0,0,0
862790,0,3 user reviews,3,0,3
862880,0,3 user reviews,2,1,3
862920,0,9 user reviews,9,0,9
862990,0,8 user reviews,4,4,8
863490,7,Positive,10,1,11
863560,0,No user reviews,0,0,0
863690,0,1 user reviews,1,0,1
863980,0,9 user reviews,7,2,9
864010,0,3 user reviews,3,0,3
864100,0,No user reviews,0,0,0
864200,0,No user reviews,0,0,0
864260,0,4 user reviews,1,3,4
864270,0,1 user reviews,1,0,1
864300,7,Positive,39,1,40
864310,0,No user reviews,0,0,0
864390,0,3 user reviews,3,0,3
864510,7,Positive,16,1,17
864520,0,No user reviews,0,0,0
864570,0,1 user reviews,1,0,1
864740,0,2 user reviews,2,0,2
864860,0,6 user reviews,5,1,6
864940,4,Mostly Negative,13,35,48
864970,0,8 user reviews,7,1,8
865130,0,No user reviews,0,0,0
865180,7,Positive,31,5,36
865240,0,No user reviews,0,0,0
865800,0,No user reviews,0,0,0
865810,0,No user reviews,0,0,0
865870,0,No user reviews,0,0,0
865880,7,Positive,42,0,42
865930,0,No user reviews,0,0,0
866040,0,2 user reviews,1,1,2
866150,3,Negative,6,29,35
866180,0,No user reviews,0,0,0
866260,0,No user reviews,0,0,0
866280,0,5 user reviews,0,5,5
866310,0,1 user reviews,0,1,1
866340,0,1 user reviews,1,0,1
866350,0,1 user reviews,1,0,1
866390,7,Positive,26,5,31
866510,6,Mostly Positive,11,3,14
866520,0,9 user reviews,9,0,9
866800,0,No user reviews,0,0,0
867010,0,6 user reviews,4,2,6
867140,0,5 user reviews,4,1,5
867480,0,8 user reviews,5,3,8
867550,7,Positive,10,0,10
867610,5,Mixed,7,7,14
867620,3,Negative,0,15,15
867640,0,6 user reviews,6,0,6
867700,0,9 user reviews,9,0,9
867730,5,Mixed,9,4,13
867800,0,No user reviews,0,0,0
867850,0,2 user reviews,2,0,2
868040,0,3 user reviews,2,1,3
868130,0,5 user reviews,5,0,5
868190,0,6 user reviews,1,5,6
868230,7,Positive,20,4,24
868240,0,1 user reviews,1,0,1
868370,0,No user reviews,0,0,0
868470,0,4 user reviews,3,1,4
868500,0,No user reviews,0,0,0
868550,0,6 user reviews,2,4,6
868710,0,6 user reviews,2,4,6
868970,0,No user reviews,0,0,0
869030,0,7 user reviews,7,0,7
869110,0,5 user reviews,2,3,5
869250,0,5 user reviews,3,2,5
869440,0,No user reviews,0,0,0
869500,0,No user reviews,0,0,0
869560,0,No user reviews,0,0,0
869570,0,2 user reviews,1,1,2
869580,0,1 user reviews,1,0,1
869590,0,2 user reviews,2,0,2
869630,0,No user reviews,0,0,0
869760,8,Very Positive,744,88,832
869780,0,2 user reviews,2,0,2
869840,8,Very Positive,67,4,71
870000,0,No user reviews,0,0,0
870020,0,No user reviews,0,0,0
870030,0,1 user reviews,1,0,1
870080,0,8 user reviews,8,0,8
870120,0,6 user reviews,5,1,6
870140,0,5 user reviews,5,0,5
870150,0,1 user reviews,0,1,1
870180,0,4 user reviews,4,0,4
870590,0,1 user reviews,1,0,1
870610,0,2 user reviews,2,0,2
870740,0,No user reviews,0,0,0
870750,0,No user reviews,0,0,0
870800,0,7 user reviews,7,0,7
870990,0,7 user reviews,4,3,7
871140,0,No user reviews,0,0,0
871320,0,No user reviews,0,0,0
871510,0,8 user reviews,7,1,8
871870,7,Positive,9,1,10
872090,0,5 user reviews,3,2,5
872330,0,3 user reviews,0,3,3
872580,0,No user reviews,0,0,0
872680,7,Positive,16,4,20
872730,0,4 user reviews,3,1,4
872980,0,3 user reviews,1,2,3
872990,0,No user reviews,0,0,0
873070,7,Positive,23,0,23
873180,0,No user reviews,0,0,0
873190,6,Mostly Positive,114,43,157
873200,7,Positive,40,3,43
873210,0,3 user reviews,3,0,3
873280,0,2 user reviews,2,0,2
873360,0,1 user reviews,0,1,1
873500,0,4 user reviews,4,0,4
873580,0,No user reviews,0,0,0
873590,0,3 user reviews,3,0,3
873610,7,Positive,19,1,20
873620,0,No user reviews,0,0,0
873700,5,Mixed,23,10,33
873730,0,5 user reviews,3,2,5
873930,0,5 user reviews,3,2,5
874010,0,2 user reviews,2,0,2
874100,6,Mostly Positive,86,32,118
874130,7,Positive,11,0,11
874140,0,1 user reviews,1,0,1
874200,0,No user reviews,0,0,0
874330,0,No user reviews,0,0,0
874380,0,8 user reviews,5,3,8
874400,6,Mostly Positive,26,9,35
874650,5,Mixed,84,53,137
874840,0,1 user reviews,1,0,1
874930,0,No user reviews,0,0,0
875240,0,No user reviews,0,0,0
875250,0,3 user reviews,2,1,3
875430,0,4 user reviews,0,4,4
875520,0,No user reviews,0,0,0
875680,0,No user reviews,0,0,0
876140,0,No user reviews,0,0,0
876180,0,1 user reviews,1,0,1
876200,0,4 user reviews,4,0,4
876310,7,Positive,17,3,20
876380,7,Positive,24,0,24
876410,0,No user reviews,0,0,0
876480,0,1 user reviews,1,0,1
876600,0,3 user reviews,0,3,3
876840,0,2 user reviews,2,0,2
876870,0,1 user reviews,0,1,1
876960,0,3 user reviews,2,1,3
877020,0,No user reviews,0,0,0
877060,0,1 user reviews,1,0,1
877180,0,No user reviews,0,0,0
877190,6,Mostly Positive,11,3,14
877260,0,3 user reviews,2,1,3
877360,0,No user reviews,0,0,0
877370,0,5 user reviews,4,1,5
877390,0,No user reviews,0,0,0
877550,0,No user reviews,0,0,0
877780,0,2 user reviews,1,1,2
877820,0,No user reviews,0,0,0
877840,7,Positive,13,2,15
878050,0,2 user reviews,2,0,2
878250,0,No user reviews,0,0,0
878270,0,No user reviews,0,0,0
878330,0,2 user reviews,2,0,2
878480,0,2 user reviews,1,1,2
878490,0,1 user reviews,1,0,1
878500,0,No user reviews,0,0,0
878570,0,No user reviews,0,0,0
878680,0,No user reviews,0,0,0
878780,0,3 user reviews,2,1,3
878820,0,No user reviews,0,0,0
879120,0,No user reviews,0,0,0
879250,0,No user reviews,0,0,0
879280,0,No user reviews,0,0,0
879410,0,No user reviews,0,0,0
879440,0,1 user reviews,0,1,1
879450,0,No user reviews,0,0,0
879530,0,No user reviews,0,0,0
879920,0,No user reviews,0,0,0
880260,0,No user reviews,0,0,0
880370,0,4 user reviews,4,0,4
880510,0,No user reviews,0,0,0
880550,0,4 user reviews,4,0,4
880590,0,No user reviews,0,0,0
880780,0,2 user reviews,0,2,2
880990,0,No user reviews,0,0,0
881520,0,No user reviews,0,0,0
881610,0,No user reviews,0,0,0
881730,0,No user reviews,0,0,0
881920,0,No user reviews,0,0,0
882200,0,No user reviews,0,0,0
882330,0,No user reviews,0,0,0
882510,0,1 user reviews,0,1,1
882520,0,No user reviews,0,0,0
882560,5,Mixed,6,4,10
882640,0,No user reviews,0,0,0
882790,0,No user reviews,0,0,0
882960,0,No user reviews,0,0,0
883190,0,No user reviews,0,0,0
883390,0,No user reviews,0,0,0
884090,0,No user reviews,0,0,0
884150,0,No user reviews,0,0,0
884170,0,No user reviews,0,0,0
884190,0,No user reviews,0,0,0
884500,0,No user reviews,0,0,0
884530,0,No user reviews,0,0,0
884590,0,No user reviews,0,0,0
884770,0,No user reviews,0,0,0
885000,0,No user reviews,0,0,0
885240,0,No user reviews,0,0,0
885620,0,No user reviews,0,0,0
886010,0,No user reviews,0,0,0
886460,0,No user reviews,0,0,0
886470,0,No user reviews,0,0,0
886580,0,No user reviews,0,0,0
886670,0,No user reviews,0,0,0
887160,0,No user reviews,0,0,0
887630,0,No user reviews,0,0,0
887750,0,No user reviews,0,0,0
887880,0,No user reviews,0,0,0
888480,0,No user reviews,0,0,0
888690,0,No user reviews,0,0,0
888800,0,No user reviews,0,0,0
889030,0,No user reviews,0,0,0
889060,0,No user reviews,0,0,0
889680,0,No user reviews,0,0,0
889770,0,No user reviews,0,0,0
892880,0,No user reviews,0,0,0
