id,year,review_score,total_positive,total_negative,total_reviews,Players
227860,2017,5,2341,2106,4447,275014
228360,2017,8,867,54,921,61757
234270,2017,8,634,47,681,58710
235380,2017,5,2155,1572,3727,129872
236110,2017,6,9170,3228,12398,2642504
237850,2017,8,2481,472,2953,186701
240720,2017,6,7782,1956,9738,948332
241300,2017,8,51,7,58,2260
244030,2017,5,769,565,1334,87217
244750,2017,8,75,10,85,4694
246920,2017,8,98,8,106,10974
252090,2017,8,53,10,63,2410
252470,2017,8,1503,362,1865,100689
253230,2017,9,7338,100,7438,187728
256460,2017,8,316,34,350,16200
262810,2017,5,66,53,119,7210
268910,2017,9,29947,1151,31098,1735419
268990,2017,8,305,13,318,17174
272270,2017,5,1835,862,2697,206681
272620,2017,8,186,26,212,11886
274520,2017,8,2844,154,2998,171170
280180,2017,8,902,185,1087,68710
285190,2017,5,5984,7452,13436,680572
285900,2017,5,11034,4775,15809,1689567
286000,2017,6,1601,421,2022,300539
288860,2017,6,68,20,88,4917
290020,2017,8,97,21,118,8844
291690,2017,6,45,14,59,2621
293780,2017,9,3223,117,3340,241677
295670,2017,6,193,49,242,14753
296300,2017,6,4038,1209,5247,166473
296790,2017,6,18,5,23,663
299400,2017,8,87,9,96,3005
299950,2017,8,408,94,502,24477
300380,2017,8,3617,685,4302,214682
304530,2017,5,1394,941,2335,82676
305620,2017,8,34834,3057,37891,1875963
308060,2017,6,432,133,565,45330
308600,2017,8,89,2,91,4312
311290,2017,6,1472,592,2064,133510
312430,2017,5,120,96,216,10104
312520,2017,8,966,168,1134,65076
312650,2017,8,130,31,161,8616
312660,2017,8,6266,888,7154,715583
313390,2017,8,78,17,95,5839
313780,2017,8,524,107,631,27395
314590,2017,8,53,13,66,7385
317370,2017,7,40,9,49,6920
318970,2017,8,365,51,416,22302
322110,2017,8,2075,137,2212,113055
322750,2017,8,173,36,209,8275
326360,2017,5,369,180,549,140653
328590,2017,6,131,36,167,9217
331480,2017,8,405,51,456,20399
331870,2017,8,733,138,871,58771
332270,2017,7,24,5,29,1331
332310,2017,6,7792,2309,10101,752946
332540,2017,8,50,1,51,2613
336300,2017,8,245,42,287,26034
337340,2017,9,4689,84,4773,57511
338810,2017,6,187,59,246,70254
339250,2017,5,10,5,15,683
339590,2017,7,41,8,49,12031
340580,2017,8,241,29,270,19799
341040,2017,6,39,12,51,1364
342150,2017,5,303,222,525,121259
342190,2017,6,91,23,114,7468
343860,2017,8,1495,237,1732,76114
344240,2017,5,338,164,502,24324
344740,2017,8,554,92,646,43874
347290,2017,6,354,146,500,24511
347600,2017,8,199,35,234,7231
348160,2017,7,40,3,43,1136
348800,2017,7,14,1,15,6811
349790,2017,8,101,23,124,10161
350880,2017,7,17,4,21,604
352460,2017,5,2733,1411,4144,331065
352550,2017,4,695,1337,2032,65065
355010,2017,6,50,19,69,5714
355180,2017,8,9177,1994,11171,2044268
355280,2017,7,37,8,45,32754
355370,2017,7,27,3,30,1444
355790,2017,8,1081,264,1345,142380
356190,2017,6,13464,3940,17404,952284
357190,2017,8,1170,172,1342,126699
357310,2017,6,978,259,1237,71974
357650,2017,6,167,60,227,13345
359340,2017,7,10,2,12,2459
359420,2017,7,19,1,20,651
359840,2017,8,178,14,192,23270
359940,2017,6,116,49,165,6625
360830,2017,6,1928,532,2460,156754
361370,2017,3,1,10,11,430
364050,2017,6,870,222,1092,61819
364630,2017,6,104,33,137,8469
364740,2017,7,11,1,12,119196
365160,2017,8,972,154,1126,52920
365360,2017,8,3877,481,4358,139426
365810,2017,6,454,174,628,37128
366090,2017,8,1358,220,1578,130016
366640,2017,6,138,52,190,14015
366870,2017,8,284,66,350,14326
366910,2017,5,729,337,1066,48486
367080,2017,8,127,22,149,10341
367520,2017,9,21467,959,22426,999648
368000,2017,6,41,12,53,5042
368070,2017,5,2354,1915,4269,228348
368180,2017,8,129,23,152,10894
368390,2017,8,412,16,428,10229
370440,2017,5,123,68,191,3131
371520,2017,6,454,164,618,56228
372080,2017,7,29,4,33,1549
372330,2017,5,37,21,58,10696
373930,2017,6,1856,703,2559,117416
374040,2017,8,9296,1936,11232,914016
375580,2017,6,34,13,47,16792
375750,2017,8,205,15,220,18155
377060,2017,6,162,61,223,4562
377320,2017,7,13,3,16,144
378350,2017,7,11,2,13,333
378540,2017,6,2236,703,2939,161690
378860,2017,6,2828,1102,3930,264945
380810,2017,8,75,1,76,1986
380860,2017,7,20,5,25,504
380920,2017,7,37,6,43,967
381020,2017,8,547,41,588,31731
382360,2017,5,139,73,212,11056
383980,2017,8,3705,434,4139,286514
384250,2017,5,83,52,135,25179
384740,2017,6,453,185,638,47217
385410,2017,6,10,4,14,34741
386140,2017,5,34,18,52,12957
386180,2017,5,7380,4013,11393,1727005
386200,2017,7,18,3,21,346
386620,2017,8,1015,130,1145,107391
386710,2017,5,10,11,21,1365
386770,2017,6,72,22,94,6731
386930,2017,5,40,48,88,3085
387100,2017,7,18,2,20,858
388370,2017,6,97,39,136,14297
388550,2017,5,13,9,22,3957
388910,2017,7,25,2,27,599
388960,2017,5,23,16,39,13777
389220,2017,5,114,49,163,18823
389260,2017,8,58,8,66,3477
389730,2017,8,10670,1748,12418,541238
390030,2017,8,229,53,282,12783
390620,2017,7,26,2,28,8911
391640,2017,6,17,7,24,2874
391650,2017,7,13,1,14,4707
392110,2017,8,5945,1350,7295,750761
392280,2017,5,127,62,189,5755
392610,2017,8,55,3,58,634
393080,2017,5,754,877,1631,194722
393220,2017,7,30,1,31,1981
394430,2017,7,37,2,39,1189
394490,2017,4,12,30,42,917
396350,2017,8,253,9,262,7012
396750,2017,8,3078,728,3806,290326
397310,2017,8,248,57,305,17224
397810,2017,4,6,16,22,960
397850,2017,7,10,1,11,349
397900,2017,5,4414,2713,7127,1457596
398140,2017,6,27,11,38,3713
401710,2017,6,395,119,514,45668
401810,2017,8,468,43,511,28341
402130,2017,5,278,241,519,25191
402330,2017,8,1646,142,1788,49786
404530,2017,8,204,28,232,12972
404540,2017,8,973,126,1099,86553
404590,2017,5,1279,991,2270,78646
404680,2017,8,1864,221,2085,90716
405190,2017,4,4,10,14,195
405240,2017,5,13,8,21,1282
405290,2017,8,215,13,228,11887
405340,2017,5,23,14,37,2140
405830,2017,9,817,39,856,41597
407000,2017,4,12,27,39,43004
407110,2017,7,21,3,24,624
407310,2017,9,509,13,522,27742
407530,2017,5,4175,2828,7003,2284297
408410,2017,8,555,35,590,31098
408520,2017,8,421,35,456,9389
409410,2017,5,26,15,41,2606
409850,2017,8,177,41,218,18248
410830,2017,8,59,6,65,2248
410840,2017,6,163,43,206,9572
410900,2017,6,1378,354,1732,483174
411120,2017,8,163,27,190,48850
411300,2017,6,5875,1713,7588,254457
411480,2017,5,79,66,145,58623
411970,2017,8,283,7,290,15235
412620,2017,8,92,8,100,3427
414340,2017,8,14216,1226,15442,422733
414530,2017,5,950,675,1625,404721
414700,2017,8,7802,1202,9004,387821
414740,2017,5,693,637,1330,41266
415090,2017,7,20,2,22,340
415170,2017,8,198,5,203,6229
415300,2017,6,156,46,202,18594
415880,2017,6,681,218,899,226459
416210,2017,6,629,208,837,86444
416360,2017,8,69,2,71,4046
416530,2017,8,49,4,53,3345
417400,2017,7,12,2,14,188
418060,2017,5,52,25,77,5906
418370,2017,8,15768,1384,17152,668829
418460,2017,6,11458,3155,14613,952431
418650,2017,9,1679,66,1745,179033
419020,2017,6,15,4,19,633
419480,2017,6,1497,416,1913,114116
420180,2017,8,57,10,67,3937
420980,2017,8,128,11,139,10595
421020,2017,5,2541,1365,3906,270550
422810,2017,6,1083,354,1437,69036
423490,2017,8,233,47,280,17133
424840,2017,8,4797,587,5384,280612
425240,2017,6,75,24,99,8710
426190,2017,8,79,13,92,8604
426310,2017,6,139,50,189,8498
427240,2017,8,339,36,375,17351
427270,2017,5,3473,1682,5155,1115355
427490,2017,8,221,35,256,8264
427570,2017,5,81,56,137,10484
427700,2017,8,156,4,160,3466
428200,2017,5,153,66,219,5659
428690,2017,6,5461,1978,7439,714623
428860,2017,8,92,14,106,3681
428980,2017,4,4,13,17,749
429660,2017,8,5377,305,5682,284444
429780,2017,6,330,129,459,21045
430210,2017,6,429,151,580,36544
430410,2017,8,63,11,74,4679
430890,2017,7,17,1,18,6493
431120,2017,8,110,17,127,9836
431650,2017,6,284,95,379,24670
431700,2017,8,60,3,63,1771
432420,2017,5,8,7,15,392
432940,2017,8,57,6,63,2000
432950,2017,5,53,23,76,18173
433190,2017,5,56,27,83,3996
433340,2017,9,17305,653,17958,1216760
433530,2017,8,1142,285,1427,72180
433900,2017,5,41,27,68,1192
434160,2017,8,46,6,52,1122
434310,2017,6,23,8,31,1322
434360,2017,5,44,31,75,3716
434460,2017,6,1065,273,1338,270427
434510,2017,8,178,41,219,89730
434600,2017,6,25,9,34,665
435020,2017,6,43,18,61,1667
435100,2017,6,116,38,154,7378
435150,2017,9,28259,1357,29616,1688895
435400,2017,9,2913,58,2971,152554
436070,2017,7,15,2,17,522
436180,2017,5,679,686,1365,207863
436230,2017,8,117,26,143,7813
436290,2017,6,170,64,234,13744
436320,2017,8,1494,240,1734,152832
436520,2017,5,3801,2811,6612,1853533
436670,2017,8,361,22,383,14844
437220,2017,5,9037,6540,15577,843301
437250,2017,8,175,25,200,9203
437390,2017,8,98,24,122,24578
437720,2017,5,47,24,71,5961
438320,2017,8,133,1,134,3290
438740,2017,5,14544,6258,20802,629644
440650,2017,8,1445,165,1610,97394
440730,2017,5,362,267,629,42826
441790,2017,5,727,820,1547,86608
442120,2017,6,472,124,596,66560
442780,2017,6,1029,403,1432,67065
443880,2017,6,95,38,133,16977
444170,2017,7,38,1,39,686
445190,2017,8,1297,258,1555,81722
445870,2017,5,31,15,46,3645
446030,2017,8,62,5,67,3382
446550,2017,8,42,10,52,4154
446610,2017,5,20,14,34,6480
446760,2017,7,29,3,32,4247
446790,2017,6,445,167,612,45719
446810,2017,8,94,13,107,3482
446840,2017,8,463,24,487,33964
447210,2017,7,41,2,43,1376
447290,2017,8,379,90,469,23579
447820,2017,8,11577,2450,14027,1052510
448170,2017,7,37,8,45,3875
448290,2017,8,246,46,292,7884
448320,2017,8,174,35,209,13445
449460,2017,6,30,11,41,1945
449510,2017,8,64,11,75,1816
449640,2017,6,37,14,51,1397
449700,2017,6,9,3,12,186
450170,2017,8,85,9,94,3979
450950,2017,8,85,9,94,3644
451020,2017,8,2181,240,2421,146382
451080,2017,7,18,3,21,2864
452060,2017,8,1124,134,1258,90117
452540,2017,8,199,33,232,5909
452570,2017,8,446,9,455,19817
453220,2017,7,10,2,12,295
453310,2017,8,189,36,225,4832
454330,2017,7,12,2,14,788
454410,2017,8,356,63,419,19138
454770,2017,7,13,1,14,484
455190,2017,6,7,3,10,291
455690,2017,7,39,2,41,4758
455770,2017,7,9,2,11,550
456170,2017,6,61,23,84,1882
456670,2017,8,2055,269,2324,126026
456740,2017,7,13,1,14,136
457370,2017,7,12,2,14,1447
457380,2017,6,56,20,76,4838
457730,2017,6,271,94,365,30350
457760,2017,6,314,123,437,25175
457890,2017,6,124,32,156,14758
458170,2017,7,31,3,34,2100
458540,2017,8,49,7,56,3945
458600,2017,5,58,30,88,232140
458680,2017,6,57,18,75,8510
459220,2017,8,1758,193,1951,197404
459350,2017,7,41,8,49,3290
459610,2017,7,17,1,18,712
459640,2017,5,7,4,11,652
460430,2017,8,381,26,407,11437
460790,2017,8,6225,482,6707,424901
460810,2017,8,1741,195,1936,143289
461170,2017,8,116,18,134,2171
461390,2017,5,13,10,23,29091
461730,2017,5,181,84,265,73275
461950,2017,8,1125,218,1343,126474
462240,2017,8,61,8,69,2560
462250,2017,7,8,2,10,426
462440,2017,5,157,197,354,8104
462640,2017,5,16,10,26,697
462770,2017,8,3359,331,3690,170731
463670,2017,5,20,16,36,23005
463700,2017,8,96,9,105,4327
463880,2017,6,11,4,15,1661
464060,2017,8,3215,336,3551,206216
464100,2017,6,121,35,156,7640
464150,2017,8,185,40,225,12724
464340,2017,5,687,688,1375,80157
464360,2017,8,338,12,350,13861
464850,2017,5,122,93,215,5733
464880,2017,6,267,72,339,18536
465240,2017,8,740,110,850,53382
465650,2017,8,547,42,589,56722
466130,2017,5,381,211,592,13976
466160,2017,7,18,1,19,420
466240,2017,6,10727,3887,14614,2604178
466300,2017,9,774,39,813,109926
466810,2017,8,232,11,243,3690
467270,2017,5,23,10,33,687
467570,2017,5,118,122,240,5529
467660,2017,8,304,67,371,25853
468000,2017,4,83,128,211,5035
468160,2017,5,35,16,51,1692
468250,2017,5,538,278,816,193891
469610,2017,6,563,199,762,84018
469720,2017,8,176,36,212,9411
469790,2017,8,344,4,348,9499
470040,2017,5,47,24,71,6163
470210,2017,6,183,51,234,16030
470780,2017,8,94,3,97,6273
471010,2017,6,267,74,341,18919
471700,2017,8,48,4,52,809
471810,2017,8,54,1,55,4881
473530,2017,8,163,22,185,29754
473610,2017,5,40,52,92,3065
473690,2017,5,4739,2313,7052,228337
474830,2017,5,26,13,39,44378
475090,2017,5,24,31,55,1675
475530,2017,5,11,5,16,1188
476020,2017,8,105,13,118,10101
476420,2017,8,109,25,134,10723
476600,2017,5,8703,6815,15518,891381
477720,2017,5,5,5,10,711
477730,2017,8,753,129,882,15757
477740,2017,8,451,20,471,23847
480430,2017,6,1353,343,1696,382313
480490,2017,8,13570,1450,15020,704179
480640,2017,5,214,99,313,23672
481510,2017,8,5002,300,5302,216979
481600,2017,6,17,7,24,4211
483770,2017,4,74,148,222,14373
484350,2017,6,149,50,199,11632
484830,2017,7,25,6,31,12522
484900,2017,6,516,189,705,41895
484930,2017,7,38,2,40,644
485390,2017,8,87,16,103,179335
485510,2017,8,7030,1568,8598,347803
485610,2017,6,1430,485,1915,434225
485680,2017,7,23,1,24,909
485980,2017,8,1353,183,1536,40758
486380,2017,8,52,1,53,881
486460,2017,5,27,24,51,10204
486690,2017,6,447,138,585,12256
486990,2017,5,8,9,17,2555
487040,2017,7,16,3,19,780
488690,2017,8,57,12,69,1820
488760,2017,8,96,15,111,5155
488790,2017,5,3558,1533,5091,320160
489140,2017,8,678,93,771,60381
489160,2017,7,11,2,13,448
489260,2017,6,50,16,66,4265
489570,2017,6,32,13,45,1765
489930,2017,6,38,15,53,1728
490080,2017,5,19,20,39,1712
490250,2017,7,17,3,20,530
490450,2017,6,226,70,296,18361
490490,2017,8,141,14,155,5880
490690,2017,6,17,7,24,7823
491420,2017,8,232,17,249,4098
491660,2017,6,9,3,12,313
491700,2017,7,16,3,19,1099
491770,2017,4,51,114,165,10824
492290,2017,6,206,63,269,21841
493080,2017,8,104,5,109,3376
493180,2017,8,46,8,54,3745
493200,2017,8,1485,150,1635,54109
493220,2017,6,30,9,39,2276
493480,2017,5,7,10,17,1050
493540,2017,8,163,10,173,4405
493790,2017,5,13,6,19,1827
493820,2017,6,28,8,36,990
493840,2017,5,746,548,1294,53532
493900,2017,8,4668,246,4914,128098
494170,2017,7,27,4,31,1205
494320,2017,5,75,42,117,5427
494580,2017,6,68,26,94,9054
494670,2017,5,127,119,246,12024
494700,2017,7,35,4,39,1120
494960,2017,8,67,8,75,3197
495050,2017,8,252,47,299,28262
495140,2017,5,308,189,497,40326
495280,2017,8,490,47,537,53996
495580,2017,5,79,58,137,6897
495750,2017,7,12,1,13,1112
495820,2017,7,12,2,14,482
496340,2017,6,59,17,76,4572
496460,2017,5,1776,885,2661,196368
496620,2017,8,444,84,528,39590
496660,2017,5,9,8,17,716
496960,2017,5,9,4,13,743
497710,2017,5,9,5,14,611
497730,2017,8,147,23,170,6861
497800,2017,8,67,1,68,2088
498320,2017,4,46,97,143,270525
498500,2017,8,387,76,463,19395
498740,2017,6,29,8,37,2771
498990,2017,6,38,12,50,2682
499210,2017,3,2,10,12,351
499890,2017,8,188,10,198,4643
500170,2017,5,20,20,40,4433
500670,2017,8,240,27,267,18908
500710,2017,5,519,326,845,36893
500790,2017,7,17,1,18,3049
501300,2017,9,6905,310,7215,183856
501320,2017,6,351,142,493,54477
501530,2017,7,16,1,17,754
501590,2017,8,650,144,794,51526
501950,2017,6,44,13,57,2382
502280,2017,6,807,206,1013,43245
502520,2017,8,2027,290,2317,141901
502540,2017,7,9,2,11,194
502700,2017,7,18,1,19,3884
502740,2017,8,192,24,216,9716
502800,2017,9,2128,84,2212,85874
502820,2017,6,530,169,699,39977
503350,2017,8,1370,295,1665,98759
503400,2017,8,169,6,175,5250
503550,2017,7,32,8,40,1781
503560,2017,8,2696,540,3236,218328
503580,2017,8,339,54,393,29723
503620,2017,6,168,68,236,10237
504090,2017,7,23,1,24,461
504450,2017,5,6,8,14,887
504460,2017,8,61,15,76,9739
505080,2017,5,21,10,31,1118
505090,2017,5,27,12,39,2041
505120,2017,5,7,5,12,1098
505630,2017,8,203,29,232,11848
505640,2017,8,267,42,309,26392
505730,2017,5,322,153,475,94447
506090,2017,7,12,2,14,614
506150,2017,7,23,1,24,700
506260,2017,6,27,7,34,3391
506500,2017,6,389,151,540,86233
506510,2017,8,109,4,113,3344
506730,2017,5,182,164,346,26894
506870,2017,8,378,15,393,14636
506900,2017,8,197,44,241,16078
507120,2017,7,35,6,41,5635
508200,2017,6,7,3,10,1522
508300,2017,5,76,40,116,16951
508520,2017,5,9,6,15,1157
508530,2017,6,90,38,128,51844
508940,2017,7,11,2,13,236
508980,2017,8,482,53,535,20050
509250,2017,8,333,26,359,19434
509260,2017,4,10,17,27,494
509620,2017,7,8,2,10,9020
509800,2017,5,142,98,240,24464
509880,2017,5,55,33,88,2050
510240,2017,7,34,5,39,1770
510360,2017,6,14,6,20,635
510510,2017,5,712,485,1197,64883
510520,2017,8,69,6,75,1109
510840,2017,5,21,12,33,8432
510850,2017,5,36,18,54,2708
511250,2017,7,12,2,14,958
511680,2017,8,2180,146,2326,79474
512020,2017,5,57,26,83,75863
512180,2017,8,237,4,241,7175
513300,2017,7,17,1,18,659
513330,2017,5,85,61,146,10410
513480,2017,8,61,8,69,3203
513550,2017,5,37,20,57,99
513890,2017,8,141,12,153,4930
514290,2017,5,43,44,87,9941
514340,2017,8,47,5,52,4025
514580,2017,8,158,21,179,16817
514620,2017,8,158,5,163,20693
514810,2017,7,20,5,25,3320
514900,2017,8,1473,277,1750,66078
514990,2017,5,50,28,78,6921
515220,2017,8,2698,548,3246,386242
515230,2017,5,16,9,25,9651
515260,2017,6,126,37,163,5961
515980,2017,5,22,27,49,3547
516410,2017,6,20,7,27,18387
516480,2017,8,175,2,177,4819
516580,2017,7,35,3,38,621
516600,2017,8,233,7,240,3118
516790,2017,7,13,1,14,764
517110,2017,6,11,3,14,3203
517460,2017,5,19,10,29,2897
517720,2017,6,102,34,136,9461
517780,2017,8,58,10,68,3574
518060,2017,6,97,33,130,9345
518130,2017,7,20,5,25,779
518720,2017,8,154,37,191,6829
518790,2017,8,11458,2821,14279,815169
520380,2017,5,20,19,39,2362
520600,2017,8,90,6,96,4205
520720,2017,6,467,163,630,42951
520750,2017,7,17,1,18,867
521100,2017,5,23,17,40,6824
521350,2017,8,116,28,144,29584
521590,2017,5,15,10,25,4948
521790,2017,6,49,15,64,2524
521890,2017,5,853,450,1303,85382
521920,2017,8,196,25,221,20068
522020,2017,8,94,22,116,6747
522080,2017,5,7,4,11,1100
522130,2017,7,18,2,20,556
522210,2017,8,183,29,212,13449
522220,2017,7,15,3,18,2580
522230,2017,5,108,53,161,48585
522250,2017,5,22,10,32,2745
522470,2017,8,428,42,470,13755
522740,2017,7,9,1,10,1089
522880,2017,7,30,2,32,3630
523210,2017,8,786,88,874,24350
523610,2017,5,17,10,27,938
523740,2017,6,41,12,53,2356
523780,2017,8,2417,156,2573,118976
523870,2017,7,24,1,25,2506
524200,2017,5,9,5,14,1076
524220,2017,8,29155,6972,36127,1175123
524580,2017,8,1304,234,1538,93595
524640,2017,8,408,60,468,21769
525040,2017,8,195,15,210,17013
525070,2017,7,12,2,14,10485
525150,2017,7,43,5,48,34498
525360,2017,6,786,224,1010,18666
525380,2017,5,98,45,143,4657
525480,2017,8,822,92,914,38872
525690,2017,7,34,1,35,1781
525920,2017,5,178,97,275,50124
526140,2017,8,194,25,219,7844
526400,2017,6,39,11,50,3742
526740,2017,5,1077,694,1771,267561
526920,2017,8,94,19,113,24288
527240,2017,5,22,19,41,1560
527270,2017,8,931,117,1048,45345
527280,2017,6,308,132,440,21899
527290,2017,8,347,73,420,18077
527380,2017,7,21,3,24,4357
527720,2017,7,26,1,27,1523
528160,2017,6,179,62,241,9687
528180,2017,5,7,7,14,1529
528260,2017,8,54,9,63,4386
528430,2017,6,51,15,66,22585
528450,2017,5,8,5,13,2524
528610,2017,5,301,166,467,11058
529180,2017,5,3871,3343,7214,295606
529240,2017,5,102,120,222,142178
529360,2017,6,27,7,34,878
529440,2017,8,280,25,305,6810
529490,2017,5,49,23,72,3017
529520,2017,8,281,14,295,9280
529660,2017,8,364,36,400,19474
529760,2017,4,76,170,246,78779
529840,2017,6,484,189,673,210057
529870,2017,7,29,5,34,2998
529920,2017,5,11,5,16,35902
530020,2017,6,150,40,190,25624
530070,2017,5,1192,601,1793,82176
530370,2017,7,21,1,22,486
530510,2017,7,33,4,37,849
530560,2017,5,230,260,490,12026
530820,2017,5,5,5,10,199
530950,2017,6,215,71,286,17991
531270,2017,6,218,88,306,9824
531780,2017,6,11,4,15,340
532120,2017,7,14,1,15,290
532170,2017,7,32,3,35,1797
532190,2017,8,278,26,304,12257
532320,2017,8,64,3,67,3385
532690,2017,6,10,4,14,2600
532840,2017,8,738,172,910,83808
532920,2017,5,13,6,19,6622
533480,2017,6,101,35,136,9218
533580,2017,7,36,3,39,792
534190,2017,7,42,7,49,3313
534220,2017,5,247,127,374,74192
534680,2017,7,10,1,11,916
534780,2017,8,105,8,113,676
535170,2017,5,17,15,32,9025
535410,2017,7,27,4,31,857
535480,2017,6,670,174,844,42547
535490,2017,5,103,68,171,9528
535520,2017,6,282,78,360,45489
535690,2017,6,79,20,99,23122
535850,2017,4,86,276,362,21629
536410,2017,5,27,14,41,165351
536450,2017,6,33,10,43,3964
536560,2017,8,46,6,52,5094
536660,2017,5,41,36,77,3063
536930,2017,5,2116,924,3040,777318
537000,2017,6,39,13,52,1896
537430,2017,5,110,128,238,5391
537740,2017,5,23,14,37,829
537800,2017,8,2739,318,3057,180315
538070,2017,8,259,16,275,14588
538680,2017,9,1551,59,1610,47881
538840,2017,8,72,16,88,7768
539270,2017,7,26,5,31,1928
539300,2017,5,6,9,15,535
539340,2017,8,59,5,64,1967
539450,2017,5,128,55,183,194515
540690,2017,5,23,15,38,1270
540900,2017,5,80,92,172,274316
541200,2017,8,47,4,51,1082
541230,2017,8,285,45,330,20946
541240,2017,7,21,2,23,2438
541300,2017,5,578,535,1113,36279
541450,2017,5,42,20,62,8136
542030,2017,7,32,1,33,1063
542200,2017,8,96,5,101,8343
542290,2017,7,38,1,39,1472
542400,2017,8,96,24,120,13120
542570,2017,7,16,3,19,2152
542660,2017,8,73,12,85,4840
543010,2017,5,120,66,186,2881
543070,2017,7,20,1,21,373
543180,2017,5,70,47,117,3488
543240,2017,8,187,35,222,6777
543260,2017,8,738,70,808,34857
543390,2017,6,112,34,146,7572
543410,2017,6,10,3,13,462
543460,2017,5,1024,1186,2210,149189
543870,2017,8,181,38,219,26981
543930,2017,8,212,16,228,4409
544310,2017,8,50,2,52,31928
544330,2017,8,642,146,788,92489
544550,2017,8,878,172,1050,45840
544580,2017,7,35,6,41,1993
544610,2017,6,475,121,596,45122
544630,2017,4,20,32,52,2201
544680,2017,4,15,23,38,818
544730,2017,5,322,470,792,137191
544970,2017,8,180,6,186,2860
545060,2017,7,17,2,19,1653
545200,2017,5,11,8,19,1357
545270,2017,6,769,314,1083,77159
545410,2017,5,60,27,87,34499
545430,2017,8,58,5,63,1886
545540,2017,8,159,31,190,10798
545650,2017,5,377,460,837,146758
545670,2017,7,32,1,33,2596
545700,2017,4,22,44,66,244539
545830,2017,7,21,5,26,1517
545890,2017,6,9,3,12,313
545980,2017,8,166,6,172,6413
546070,2017,8,49,12,61,21214
546220,2017,8,99,17,116,3266
546350,2017,6,56,24,80,5838
546410,2017,7,37,6,43,4796
546930,2017,5,156,137,293,21498
547680,2017,6,894,379,1273,346627
547820,2017,5,37,24,61,8754
547970,2017,5,12,7,19,589
548130,2017,7,17,1,18,2558
548350,2017,3,1,9,10,197
548370,2017,5,105,119,224,6721
548500,2017,7,27,6,33,1158
548650,2017,6,25,8,33,1212
548680,2017,7,36,6,42,5475
548720,2017,7,10,1,11,355
548840,2017,8,100,8,108,5557
549100,2017,6,38,10,48,4521
549190,2017,7,16,1,17,518
549240,2017,5,46,20,66,13770
549260,2017,8,218,32,250,9501
549950,2017,5,11,5,16,269
550080,2017,8,618,78,696,28801
550340,2017,8,81,15,96,4748
550360,2017,5,30,13,43,1591
550400,2017,7,21,1,22,1999
550440,2017,5,5,6,11,1431
550580,2017,8,62,14,76,42922
550590,2017,8,103,4,107,3783
550990,2017,7,37,2,39,825
551050,2017,6,27,10,37,6869
551450,2017,8,141,25,166,4900
551630,2017,5,11,7,18,1423
551650,2017,6,11,4,15,234
551730,2017,8,712,169,881,44585
551770,2017,8,437,83,520,18320
552030,2017,6,91,29,120,3388
552370,2017,7,14,1,15,252
552390,2017,7,23,3,26,4655
552440,2017,8,232,19,251,26129
552450,2017,8,294,60,354,30378
552460,2017,8,76,11,87,9757
552590,2017,8,1549,97,1646,92659
552700,2017,8,699,157,856,51651
552900,2017,7,21,3,24,20244
552910,2017,4,7,16,23,917
552970,2017,8,120,20,140,8385
552990,2017,6,5075,1801,6876,1015572
553210,2017,5,422,189,611,41196
553260,2017,5,343,212,555,33291
553340,2017,8,104,15,119,23019
553470,2017,6,12,5,17,544
553690,2017,6,8,3,11,429
553760,2017,7,44,1,45,937
553950,2017,7,42,3,45,973
553960,2017,5,176,258,434,30047
554150,2017,7,35,3,38,1884
554220,2017,7,40,8,48,2369
554330,2017,7,21,3,24,3651
554510,2017,5,241,154,395,21405
554600,2017,8,130,10,140,12968
554620,2017,8,16040,1084,17124,467572
554750,2017,5,93,46,139,3690
554770,2017,4,4,12,16,4686
554810,2017,7,30,5,35,1559
554870,2017,7,13,1,14,625
555010,2017,5,37,16,53,1669
555050,2017,8,106,15,121,5545
555150,2017,8,637,157,794,28735
555220,2017,8,5805,339,6144,244747
555260,2017,5,38,32,70,164114
555280,2017,5,19,17,36,4822
555400,2017,8,110,23,133,4651
555450,2017,5,72,108,180,20556
555600,2017,7,21,1,22,427
555830,2017,5,8,8,16,23818
555890,2017,5,15,7,22,4977
555950,2017,8,634,35,669,32270
556250,2017,7,13,3,16,4282
556340,2017,8,92,18,110,8829
556480,2017,5,16,18,34,867
556780,2017,5,33,15,48,1368
556820,2017,6,490,172,662,23348
556840,2017,5,13,19,32,508
557400,2017,8,1220,154,1374,141990
557600,2017,9,2939,80,3019,81431
557830,2017,7,16,2,18,44359
557880,2017,5,81,53,134,6011
557960,2017,4,4,8,12,544
558110,2017,6,82,23,105,6717
558320,2017,7,19,3,22,2731
558340,2017,5,31,26,57,7104
558420,2017,8,1636,197,1833,62348
558450,2017,8,113,15,128,4776
558490,2017,7,25,5,30,3547
558780,2017,6,10,4,14,2378
558790,2017,8,46,5,51,6955
558990,2017,9,1170,22,1192,90685
559130,2017,6,25,10,35,2342
559210,2017,9,1406,38,1444,44680
559310,2017,5,55,35,90,6159
559610,2017,9,616,27,643,19978
559870,2017,6,64,22,86,7092
559910,2017,6,144,58,202,10227
559960,2017,8,71,4,75,4454
560000,2017,8,132,5,137,8177
560250,2017,5,42,21,63,6260
560510,2017,7,12,2,14,313
560720,2017,8,66,3,69,7601
560730,2017,5,23,26,49,5793
560740,2017,6,31,9,40,5929
560750,2017,7,37,9,46,6045
560760,2017,5,22,18,40,5560
560820,2017,5,20,12,32,5558
561010,2017,7,8,2,10,181
561420,2017,5,8,9,17,2827
561450,2017,6,18,6,24,2220
561510,2017,7,13,1,14,403
561590,2017,5,18,11,29,5865
561600,2017,6,248,64,312,20607
561610,2017,5,156,79,235,17029
561740,2017,8,140,24,164,6431
561770,2017,6,146,43,189,6461
562090,2017,5,8,7,15,542
562250,2017,7,32,5,37,1366
562260,2017,7,28,4,32,5217
562280,2017,7,17,1,18,614
562290,2017,5,9,5,14,4655
562310,2017,7,9,1,10,301
562330,2017,7,32,6,38,32267
562340,2017,5,32,37,69,2359
562410,2017,8,537,47,584,24566
562480,2017,8,50,2,52,4157
562490,2017,8,65,12,77,31660
562590,2017,5,980,494,1474,362859
563120,2017,5,56,49,105,267723
563150,2017,7,29,5,34,19248
563190,2017,7,23,4,27,1055
563250,2017,7,9,2,11,3206
563520,2017,7,16,4,20,15816
563550,2017,7,37,4,41,1457
563560,2017,8,6180,400,6580,1788990
563810,2017,7,30,1,31,595
563860,2017,6,8,3,11,187
564070,2017,4,5,9,14,363
564150,2017,8,133,26,159,7580
564160,2017,7,40,1,41,1789
564210,2017,7,10,2,12,38302
564230,2017,8,884,82,966,48027
564470,2017,7,21,5,26,917
564710,2017,8,2918,197,3115,497334
564750,2017,6,19,6,25,8798
564940,2017,7,23,1,24,795
564950,2017,5,11,16,27,662
565390,2017,8,57,3,60,2633
565660,2017,5,20,9,29,6765
565980,2017,5,10,5,15,1007
566160,2017,8,743,48,791,45977
566190,2017,5,21,13,34,1463
566350,2017,6,7,3,10,476
566410,2017,4,3,9,12,960
566430,2017,6,18,5,23,39439
566530,2017,8,125,22,147,12177
566670,2017,8,78,5,83,48105
566750,2017,7,15,2,17,263
566780,2017,7,37,8,45,1955
566880,2017,7,19,2,21,3664
567030,2017,8,136,6,142,3050
567060,2017,6,93,25,118,23372
567200,2017,7,17,4,21,2720
567260,2017,4,16,58,74,2711
567320,2017,5,42,33,75,2470
567370,2017,8,58,2,60,3878
567480,2017,5,11,6,17,292
567640,2017,8,2129,366,2495,73449
567670,2017,8,179,13,192,17842
567680,2017,5,63,60,123,88028
567780,2017,6,18,6,24,5080
567890,2017,7,12,1,13,1550
568130,2017,6,10,3,13,39742
568180,2017,7,11,1,12,102
568320,2017,8,216,14,230,13506
568440,2017,8,98,22,120,7798
568470,2017,6,12,5,17,15960
568750,2017,6,113,40,153,11327
568770,2017,9,1563,52,1615,90875
568780,2017,6,15,6,21,29850
568920,2017,7,19,1,20,191
569210,2017,5,6,5,11,61332
569290,2017,7,37,9,46,790
569340,2017,6,51,15,66,1081
569420,2017,7,11,1,12,408
569430,2017,5,21,10,31,509
569480,2017,8,4597,811,5408,563737
569570,2017,7,38,4,42,2895
569630,2017,6,43,11,54,3252
569770,2017,6,132,43,175,6213
569800,2017,6,48,13,61,4126
569810,2017,7,28,2,30,2662
569860,2017,8,1680,100,1780,98491
569970,2017,5,61,50,111,11393
570050,2017,5,52,35,87,2997
570420,2017,5,87,50,137,10109
570770,2017,6,425,112,537,32019
570780,2017,6,645,212,857,36800
570790,2017,4,7,12,19,1190
570840,2017,8,1829,119,1948,113411
570970,2017,5,60,27,87,2374
570980,2017,8,373,32,405,7725
571260,2017,8,981,211,1192,61260
571310,2017,9,1051,39,1090,64596
571340,2017,5,23,17,40,2654
571350,2017,8,259,59,318,37573
571530,2017,8,503,28,531,24628
571720,2017,5,47,23,70,5527
571740,2017,6,1746,466,2212,537751
571880,2017,9,630,12,642,10988
572020,2017,7,25,1,26,969
572240,2017,7,13,2,15,1797
572300,2017,6,42,15,57,2483
572410,2017,6,2673,937,3610,220307
572520,2017,6,493,204,697,173823
572580,2017,5,6,6,12,322
572660,2017,6,34,10,44,17932
573060,2017,8,98,23,121,4167
573070,2017,7,16,3,19,922
573080,2017,8,61,14,75,1550
573130,2017,8,194,29,223,12818
573170,2017,8,203,4,207,9485
573260,2017,4,3,7,10,1599
573520,2017,7,36,2,38,803
573600,2017,5,39,20,59,6858
573660,2017,5,17,20,37,1175
573680,2017,4,30,69,99,4604
573770,2017,8,189,8,197,13769
573780,2017,6,58,22,80,5335
573800,2017,6,28,9,37,3177
574050,2017,6,350,147,497,39238
574070,2017,5,92,57,149,20864
574260,2017,6,37,11,48,6170
574270,2017,7,38,7,45,6127
574310,2017,8,310,19,329,9891
574440,2017,5,32,17,49,16118
574640,2017,6,91,39,130,261546
574860,2017,5,8,11,19,934
574940,2017,8,61,9,70,3384
575050,2017,8,385,23,408,12604
575330,2017,8,122,16,138,29344
575400,2017,8,54,11,65,2898
575450,2017,7,12,1,13,318
575480,2017,8,62,3,65,1376
575510,2017,6,203,81,284,59076
575550,2017,8,2284,222,2506,161623
575570,2017,6,76,31,107,72689
575580,2017,6,35,9,44,6324
575590,2017,7,29,1,30,1872
575630,2017,5,17,14,31,89681
575640,2017,8,2857,423,3280,148929
575650,2017,8,110,11,121,4081
575670,2017,7,16,3,19,3042
575700,2017,5,86,70,156,80271
575720,2017,5,597,358,955,60107
575830,2017,5,67,44,111,34272
575840,2017,5,47,32,79,190798
575860,2017,5,42,63,105,220222
575880,2017,7,19,4,23,4074
575890,2017,7,9,2,11,46680
575940,2017,8,52,6,58,2846
575950,2017,5,128,72,200,14192
575960,2017,5,32,16,48,1876
575990,2017,7,12,1,13,274
576030,2017,8,151,17,168,8041
576050,2017,5,22,22,44,51164
576130,2017,8,109,20,129,223530
576260,2017,6,74,30,104,7991
576280,2017,7,28,3,31,2016
576310,2017,5,88,82,170,65704
576370,2017,7,10,2,12,549
576380,2017,5,11,6,17,7007
576400,2017,6,56,19,75,4676
576420,2017,7,33,1,34,666
576470,2017,6,342,104,446,161925
576540,2017,5,36,19,55,115251
576620,2017,7,34,4,38,2487
576660,2017,4,9,14,23,74874
576770,2017,8,792,58,850,35746
576810,2017,8,76,18,94,6091
576860,2017,5,150,146,296,32178
576980,2017,6,69,20,89,10318
577180,2017,8,72,18,90,1958
577210,2017,6,18,7,25,1942
577290,2017,7,43,4,47,1871
577460,2017,5,97,82,179,14576
577480,2017,8,97,4,101,10764
577490,2017,7,21,1,22,2291
577580,2017,7,14,2,16,2066
577690,2017,8,224,21,245,12669
577730,2017,6,66,20,86,8408
577740,2017,5,60,31,91,22702
577760,2017,7,14,1,15,51544
577910,2017,7,29,3,32,861
577940,2017,8,990,124,1114,73990
578310,2017,8,5914,1476,7390,860262
578330,2017,6,581,228,809,57413
578470,2017,6,16,6,22,4481
578590,2017,5,10,6,16,615
578720,2017,5,158,99,257,3769
578830,2017,6,25,10,35,3530
578850,2017,8,634,63,697,25163
578870,2017,7,12,2,14,729
578900,2017,8,136,2,138,3182
578920,2017,5,12,8,20,600
578930,2017,8,74,2,76,2172
579020,2017,5,236,108,344,20279
579110,2017,8,82,7,89,4386
579210,2017,5,4,6,10,264
579230,2017,8,79,9,88,105070
579820,2017,5,59,49,108,5896
579950,2017,8,1143,172,1315,69783
580040,2017,6,238,85,323,21064
580200,2017,8,1284,285,1569,89457
580320,2017,5,8,4,12,422
580420,2017,6,39,14,53,36997
580520,2017,6,15,6,21,390
580560,2017,5,15,18,33,4831
580570,2017,5,9,6,15,561
580590,2017,7,38,1,39,4639
580680,2017,5,6,6,12,2450
580710,2017,6,121,33,154,9653
580720,2017,8,220,39,259,15890
580890,2017,5,38,18,56,1943
580950,2017,4,5,8,13,320
581030,2017,4,74,118,192,166434
581060,2017,5,53,24,77,2674
581100,2017,5,21,26,47,74134
581130,2017,6,610,182,792,60536
581220,2017,5,40,48,88,4268
581300,2017,5,90,83,173,5889
581310,2017,5,28,18,46,992
581370,2017,5,50,27,77,10260
581380,2017,5,10,9,19,33336
581520,2017,6,86,33,119,29679
581600,2017,5,10,13,23,44339
581650,2017,8,64,16,80,5964
581670,2017,5,27,24,51,221047
581760,2017,8,116,12,128,7599
581970,2017,6,44,18,62,14417
581980,2017,4,10,22,32,37242
582160,2017,8,24697,4063,28760,1030581
582270,2017,8,1271,236,1507,103451
582370,2017,7,11,2,13,346
582500,2017,8,6664,521,7185,810432
582550,2017,6,1325,343,1668,205391
582560,2017,8,118,4,122,3018
582610,2017,5,6,6,12,179
582620,2017,8,107,25,132,10191
582660,2017,5,7048,3356,10404,1413060
582980,2017,7,21,3,24,1911
582990,2017,6,38,11,49,1673
583040,2017,8,94,22,116,10846
583090,2017,7,25,1,26,1029
583150,2017,6,22,9,31,1576
583270,2017,8,60,3,63,3664
583470,2017,8,1138,77,1215,62739
583490,2017,6,94,29,123,35873
583590,2017,5,29,13,42,1778
583760,2017,8,637,39,676,77971
583890,2017,8,75,7,82,1771
583930,2017,8,77,12,89,13560
584100,2017,6,17,6,23,18237
584220,2017,8,67,15,82,7602
584370,2017,8,90,21,111,6588
584400,2017,8,6322,666,6988,168633
584800,2017,6,35,14,49,20734
584940,2017,5,13,9,22,848
584980,2017,8,2938,310,3248,114798
585080,2017,5,60,78,138,8244
585180,2017,8,141,3,144,7382
585290,2017,5,68,30,98,2972
585550,2017,8,745,158,903,203548
585690,2017,5,163,75,238,54622
585830,2017,5,47,52,99,20784
585840,2017,8,403,100,503,11072
585880,2017,8,86,9,95,6022
585890,2017,8,241,13,254,5216
585900,2017,6,303,94,397,13567
585910,2017,8,104,9,113,6369
585950,2017,8,123,8,131,12729
585970,2017,5,15,7,22,28904
585990,2017,7,28,7,35,1845
586030,2017,6,719,218,937,156784
586060,2017,5,28,17,45,3579
586140,2017,8,1535,183,1718,98966
586150,2017,4,3,8,11,2304
586160,2017,4,3,7,10,24119
586240,2017,8,116,11,127,2830
586310,2017,8,80,17,97,4069
586320,2017,7,15,1,16,590
586340,2017,7,29,2,31,1914
586350,2017,8,97,4,101,8382
586380,2017,6,256,100,356,187583
586390,2017,8,47,3,50,788
586450,2017,7,11,1,12,640
586600,2017,4,4,14,18,15330
586660,2017,7,38,2,40,911
586750,2017,5,109,71,180,5353
586770,2017,6,9,3,12,332
586830,2017,6,14,5,19,1451
586880,2017,8,237,5,242,14552
586960,2017,8,280,37,317,60440
586970,2017,6,91,27,118,47096
587000,2017,8,403,53,456,22912
587100,2017,8,172,14,186,11563
587260,2017,8,226,20,246,10220
587290,2017,5,28,16,44,2523
587400,2017,7,24,5,29,1055
587420,2017,6,231,84,315,15666
587430,2017,8,411,29,440,40604
587450,2017,5,445,207,652,31561
587460,2017,5,55,41,96,15365
587490,2017,5,13,13,26,655
587570,2017,6,37,15,52,4246
587810,2017,4,18,41,59,56426
587860,2017,6,190,61,251,56023
588040,2017,9,2665,120,2785,56625
588080,2017,7,18,3,21,564
588110,2017,6,63,25,88,3641
588180,2017,8,169,25,194,68317
588190,2017,5,118,87,205,12837
588240,2017,8,134,21,155,92533
588340,2017,5,20,16,36,880
588430,2017,8,16096,2741,18837,3371793
588540,2017,6,11,4,15,608
588620,2017,7,22,3,25,1634
588690,2017,8,751,48,799,44119
588710,2017,8,46,4,50,25384
588730,2017,8,228,8,236,7371
588750,2017,5,10,11,21,1140
588880,2017,7,11,1,12,4224
588890,2017,6,32,13,45,2334
588920,2017,5,14,12,26,2747
588950,2017,8,541,62,603,53976
588970,2017,8,916,113,1029,36745
589060,2017,7,13,1,14,358
589150,2017,6,16,6,22,1186
589320,2017,5,136,118,254,19874
589380,2017,7,8,2,10,844
589420,2017,8,127,15,142,52412
589430,2017,4,4,16,20,41351
589460,2017,6,71,22,93,26167
589470,2017,7,19,3,22,1969
589480,2017,7,28,1,29,538
589510,2017,8,73,8,81,6780
589530,2017,8,166,27,193,8472
589590,2017,8,1656,98,1754,152040
589640,2017,6,25,8,33,2862
589690,2017,6,23,8,31,5434
589730,2017,5,16,9,25,4877
589740,2017,5,18,23,41,1198
589860,2017,7,41,1,42,1913
589870,2017,8,1410,203,1613,496965
590270,2017,6,15,4,19,431
590370,2017,6,9,3,12,547
590970,2017,5,73,85,158,3580
591350,2017,6,19,5,24,844
591420,2017,8,1451,207,1658,86040
591560,2017,8,52,9,61,221001
591740,2017,5,515,762,1277,351470
591960,2017,5,842,395,1237,193034
591990,2017,5,9,5,14,223
592030,2017,6,63,16,79,9215
592120,2017,7,8,2,10,419
592130,2017,6,10,3,13,543
592200,2017,7,12,3,15,30291
592240,2017,7,14,2,16,619
592300,2017,8,50,2,52,1673
592340,2017,5,47,32,79,2045
592390,2017,5,64,44,108,3264
592550,2017,5,15,11,26,1176
592620,2017,7,8,2,10,349
592660,2017,5,8,4,12,1035
592730,2017,5,32,14,46,19319
592750,2017,7,21,1,22,791
592780,2017,5,7,8,15,4052
593070,2017,7,8,2,10,2057
593280,2017,9,1788,71,1859,73199
593330,2017,5,62,33,95,7550
593410,2017,6,13,4,17,1271
593490,2017,6,90,32,122,8760
593670,2017,7,21,2,23,34169
593680,2017,7,27,1,28,3261
593700,2017,7,34,5,39,984
593850,2017,7,36,8,44,1064
594300,2017,8,42,9,51,8571
594310,2017,5,13,6,19,2994
594360,2017,7,8,2,10,335
594370,2017,6,36,10,46,4259
594490,2017,8,154,26,180,43126
594570,2017,8,11698,1225,12923,955731
594660,2017,6,33,9,42,2797
594680,2017,8,118,12,130,2520
594750,2017,7,40,3,43,907
595030,2017,4,4,10,14,200
595090,2017,6,52,21,73,3096
595120,2017,6,88,23,111,3771
595140,2017,8,781,51,832,44541
595420,2017,5,80,36,116,8997
595430,2017,8,195,9,204,5012
595440,2017,8,295,59,354,145377
595460,2017,8,131,22,153,79368
595550,2017,5,48,26,74,5438
595660,2017,5,17,8,25,1499
595740,2017,6,132,47,179,5050
595780,2017,5,5,5,10,125192
595920,2017,5,18,11,29,990
595960,2017,7,29,6,35,1137
596080,2017,7,19,2,21,270
596540,2017,5,12,9,21,1802
596590,2017,8,64,5,69,123339
596630,2017,7,27,3,30,1457
596650,2017,5,441,216,657,125288
596890,2017,7,15,2,17,1658
596910,2017,7,36,3,39,2139
596950,2017,5,33,15,48,4044
597150,2017,8,403,42,445,18994
597200,2017,6,14,4,18,527
597220,2017,9,2171,49,2220,162678
597240,2017,5,14,14,28,629
597590,2017,7,19,1,20,564
597700,2017,8,164,10,174,6584
597840,2017,6,125,47,172,26040
597860,2017,7,16,2,18,348
597920,2017,4,8,14,22,765
598070,2017,8,137,13,150,22237
598350,2017,7,25,4,29,513
598440,2017,6,148,55,203,7448
598480,2017,6,51,16,67,4122
598610,2017,6,11,3,14,450
598670,2017,7,18,1,19,675
598690,2017,6,83,34,117,2958
598820,2017,5,40,32,72,13642
598840,2017,7,9,1,10,4200
598940,2017,6,37,12,49,12398
599060,2017,5,15,19,34,11991
599460,2017,8,751,169,920,71843
599510,2017,7,8,2,10,1853
599560,2017,6,44,17,61,5176
599630,2017,5,9,4,13,1962
599750,2017,8,485,97,582,45176
599880,2017,5,15,13,28,8514
599960,2017,6,122,38,160,3741
600210,2017,5,22,12,34,140831
600280,2017,6,32,13,45,4878
600310,2017,6,19,5,24,42250
600370,2017,8,456,8,464,13467
600410,2017,6,17,5,22,2831
600630,2017,5,58,30,88,10808
600740,2017,5,7,6,13,10416
600750,2017,5,195,196,391,72588
601010,2017,6,108,38,146,70809
601020,2017,5,7,7,14,563
601240,2017,5,11,6,17,4934
601430,2017,8,6688,553,7241,227653
601500,2017,5,11,6,17,535
601510,2017,8,4939,1221,6160,1461356
601530,2017,8,222,23,245,16715
601570,2017,7,18,4,22,5092
601640,2017,5,29,26,55,92281
601770,2017,8,161,25,186,8582
601790,2017,7,20,4,24,2631
601810,2017,8,217,20,237,4836
601870,2017,5,9,7,16,3237
601920,2017,7,9,1,10,305
601930,2017,7,20,4,24,23821
602070,2017,7,34,1,35,1161
602120,2017,7,46,1,47,4126
602520,2017,9,6265,154,6419,220127
602590,2017,6,23,9,32,718
602890,2017,5,351,157,508,175952
602930,2017,5,27,19,46,23958
603060,2017,7,11,1,12,39375
603090,2017,6,7,3,10,30707
603100,2017,8,75,16,91,5352
603120,2017,5,20,26,46,2543
603130,2017,5,55,27,82,5231
603140,2017,8,123,20,143,14432
603150,2017,4,16,25,41,87818
603220,2017,7,12,1,13,61829
603250,2017,5,10,10,20,8266
603260,2017,8,395,45,440,22860
603350,2017,8,100,22,122,10311
603360,2017,5,33,32,65,56349
603420,2017,7,19,2,21,1013
603530,2017,8,213,18,231,6894
603550,2017,3,1,9,10,535
603750,2017,4,40,69,109,122213
603800,2017,6,70,26,96,10868
603810,2017,8,46,5,51,1514
603840,2017,6,11,3,14,316
603870,2017,7,14,1,15,340
603940,2017,8,94,22,116,9778
603960,2017,8,354,3,357,10880
604000,2017,7,41,6,47,2919
604010,2017,7,19,3,22,2376
604170,2017,7,28,5,33,2034
604450,2017,8,3589,346,3935,60338
604490,2017,5,615,301,916,22151
604740,2017,6,87,33,120,3345
604780,2017,6,152,53,205,101408
604950,2017,5,9,10,19,2029
604980,2017,7,16,2,18,472
605210,2017,7,12,2,14,18238
605250,2017,7,16,1,17,371
605310,2017,5,28,16,44,1081
605610,2017,8,437,47,484,43349
605990,2017,8,131,5,136,9897
606190,2017,7,16,2,18,750
606330,2017,6,94,25,119,227633
606370,2017,5,58,42,100,3940
606480,2017,8,121,2,123,4818
606510,2017,8,85,8,93,4750
606690,2017,7,38,4,42,10986
606710,2017,8,108,6,114,4498
606730,2017,5,102,48,150,34563
606860,2017,5,95,48,143,4944
606950,2017,5,15,10,25,1616
607040,2017,7,10,2,12,1623
607210,2017,5,10,8,18,336
607400,2017,8,94,7,101,2019
607660,2017,6,28,10,38,2797
607760,2017,7,12,1,13,315
607880,2017,8,424,87,511,23646
607890,2017,8,1995,418,2413,114714
608530,2017,5,81,54,135,1994
608540,2017,5,6,4,10,34379
608660,2017,7,41,2,43,25642
608760,2017,7,36,6,42,21557
608800,2017,6,388,113,501,197414
608990,2017,5,122,117,239,31410
609150,2017,6,390,148,538,42781
609170,2017,5,25,11,36,1436
609410,2017,7,43,5,48,1498
609760,2017,7,20,2,22,1817
609940,2017,6,427,171,598,96484
610080,2017,8,1588,339,1927,486185
610130,2017,8,84,21,105,149881
610180,2017,8,170,32,202,124954
610310,2017,8,91,11,102,3275
610350,2017,5,12,9,21,827
610360,2017,8,986,81,1067,67435
610380,2017,5,76,46,122,10705
610500,2017,6,143,41,184,6559
610610,2017,7,15,3,18,737
610670,2017,5,34,43,77,153968
610680,2017,6,50,15,65,2664
610750,2017,6,106,43,149,41646
610810,2017,5,243,136,379,96091
610840,2017,7,44,1,45,3530
610960,2017,8,569,76,645,24175
611140,2017,5,11,10,21,14925
611320,2017,7,27,1,28,4380
611630,2017,7,21,3,24,366
611660,2017,6,2248,949,3197,133476
611750,2017,5,50,41,91,2993
611800,2017,5,148,91,239,7871
611850,2017,7,21,3,24,697
611980,2017,8,678,56,734,30552
612020,2017,8,816,114,930,168990
612100,2017,8,71,5,76,4039
612110,2017,8,191,34,225,15063
612170,2017,8,70,12,82,2997
612250,2017,4,5,9,14,49524
612310,2017,7,16,1,17,706
612370,2017,8,138,8,146,5116
612510,2017,6,33,13,46,45443
612590,2017,7,30,3,33,9543
612610,2017,4,31,57,88,20678
612620,2017,6,115,31,146,17912
612670,2017,7,33,8,41,1059
612720,2017,6,188,49,237,15787
612740,2017,8,65,10,75,2328
612810,2017,5,8,10,18,764
612880,2017,6,8845,3403,12248,549457
613010,2017,5,52,25,77,45681
613020,2017,7,10,1,11,374
613130,2017,7,25,1,26,3064
613210,2017,7,31,2,33,2127
613270,2017,5,94,84,178,6664
613390,2017,8,97,6,103,3435
613450,2017,8,84,8,92,2174
613470,2017,8,79,7,86,3481
613670,2017,8,143,34,177,3160
613730,2017,6,527,176,703,46193
613790,2017,5,13,6,19,2272
613860,2017,6,15,6,21,432
614030,2017,6,86,25,111,21488
614140,2017,5,11,7,18,356
614570,2017,8,2134,396,2530,167394
614860,2017,6,115,40,155,7635
614890,2017,6,27,9,36,1646
614900,2017,5,19,15,34,4113
614910,2017,8,270,39,309,16640
614960,2017,7,38,3,41,2109
614970,2017,5,24,11,35,2151
615010,2017,8,68,6,74,2220
615090,2017,7,37,7,44,8219
615180,2017,8,47,9,56,2835
615340,2017,5,32,35,67,8367
615350,2017,7,36,8,44,3009
615490,2017,6,9,3,12,2374
615610,2017,9,1473,28,1501,103156
615670,2017,7,35,6,41,2081
615970,2017,5,60,42,102,5393
616000,2017,8,80,4,84,2318
616030,2017,7,22,1,23,45927
616240,2017,5,47,36,83,8106
616740,2017,8,207,21,228,3069
616880,2017,7,18,1,19,3583
617030,2017,5,79,60,139,7571
617060,2017,7,9,2,11,289
617160,2017,8,786,133,919,35043
617420,2017,5,23,16,39,33367
617440,2017,8,131,5,136,4520
617610,2017,7,45,4,49,2987
617630,2017,5,16,8,24,554
617700,2017,8,216,39,255,16792
617710,2017,5,41,34,75,35152
617820,2017,7,37,2,39,773
617830,2017,8,1306,158,1464,158697
618050,2017,5,41,48,89,5926
618310,2017,8,53,12,65,7646
618360,2017,7,19,4,23,2299
618370,2017,7,23,1,24,645
618470,2017,7,16,1,17,600
618490,2017,5,11,11,22,3855
618510,2017,8,197,14,211,15556
618610,2017,6,64,27,91,21739
618630,2017,6,9,3,12,225
618640,2017,7,14,3,17,503
618690,2017,7,39,3,42,2073
618720,2017,8,168,6,174,11663
618950,2017,8,84,3,87,2383
618970,2017,8,224,28,252,10737
619280,2017,8,153,20,173,10062
619340,2017,5,24,11,35,42590
619350,2017,7,13,3,16,699
619400,2017,4,57,108,165,265237
619600,2017,6,22,9,31,5620
619810,2017,7,25,1,26,1377
619870,2017,7,44,3,47,718
619880,2017,6,458,134,592,29556
619890,2017,7,24,2,26,50016
620170,2017,7,31,4,35,1296
620700,2017,5,21,19,40,1204
620710,2017,7,20,3,23,2737
621010,2017,7,15,1,16,752
621050,2017,5,11,15,26,1372
621080,2017,8,48,3,51,4745
621780,2017,5,6,4,10,1051
621810,2017,8,79,16,95,3658
621830,2017,5,534,229,763,37674
621850,2017,7,13,1,14,554
622020,2017,5,14,7,21,657
622060,2017,8,65,14,79,8359
622080,2017,4,6,15,21,2260
622170,2017,5,188,97,285,28254
622370,2017,5,92,43,135,7074
622650,2017,8,6341,815,7156,721168
622880,2017,6,21,9,30,1040
622890,2017,7,21,1,22,306
622920,2017,5,25,29,54,33008
623070,2017,6,34,12,46,2725
623080,2017,9,750,9,759,9520
623090,2017,8,78,18,96,3009
623160,2017,7,15,1,16,830
623170,2017,7,16,1,17,551
623380,2017,7,18,1,19,1827
623550,2017,5,31,25,56,52456
623810,2017,5,46,20,66,1150
623900,2017,5,12,8,20,1129
623940,2017,8,2479,140,2619,106377
624120,2017,5,50,41,91,148748
624270,2017,8,159,20,179,5882
624430,2017,5,9,8,17,566
624680,2017,6,12,5,17,747
624710,2017,7,11,1,12,1306
624830,2017,7,26,2,28,695
625040,2017,5,11,6,17,6069
625120,2017,7,26,4,30,3019
625320,2017,7,11,1,12,457
625370,2017,5,26,19,45,27424
625430,2017,5,282,149,431,94612
625470,2017,8,103,8,111,35120
625700,2017,6,10,3,13,714
625770,2017,7,15,2,17,1208
625910,2017,7,36,1,37,2332
625980,2017,8,136,3,139,3618
625990,2017,7,25,3,28,1809
626010,2017,6,106,43,149,49370
626160,2017,5,10,5,15,2465
626200,2017,4,20,53,73,1458
626250,2017,7,18,4,22,1318
626510,2017,6,62,16,78,12577
626580,2017,7,32,7,39,2785
626600,2017,8,46,9,55,2787
626630,2017,5,10,6,16,1197
627070,2017,7,37,6,43,2840
627270,2017,8,2242,476,2718,121107
627450,2017,5,22,31,53,2326
627460,2017,5,8,5,13,15006
627620,2017,5,45,52,97,15307
627670,2017,7,30,1,31,2876
627820,2017,5,34,15,49,3963
627910,2017,5,48,44,92,1770
628460,2017,7,32,2,34,1037
628530,2017,5,9,4,13,5221
628660,2017,7,44,5,49,2049
628750,2017,8,239,47,286,95040
628800,2017,8,78,2,80,2073
628890,2017,4,89,202,291,31392
628900,2017,5,42,37,79,5291
628920,2017,8,65,8,73,3569
628950,2017,6,73,31,104,3642
629000,2017,8,196,17,213,11300
629030,2017,4,22,73,95,18689
629400,2017,5,6,4,10,178
629430,2017,7,29,1,30,383
629540,2017,7,33,5,38,4641
629650,2017,8,174,6,180,2817
629690,2017,8,261,25,286,13404
629770,2017,8,160,19,179,13382
629840,2017,6,274,70,344,5644
629860,2017,7,16,3,19,1195
629960,2017,6,139,45,184,8478
630020,2017,7,22,3,25,1427
630050,2017,6,19,5,24,496
630060,2017,8,308,9,317,5330
630160,2017,7,16,2,18,1361
630310,2017,8,122,23,145,3767
631490,2017,7,23,2,25,468
631540,2017,5,54,63,117,7336
631660,2017,6,52,18,70,26322
631770,2017,7,21,2,23,2360
631900,2017,8,116,5,121,4761
631920,2017,7,16,4,20,2397
631980,2017,8,81,11,92,4656
631990,2017,6,15,4,19,518
632000,2017,8,198,36,234,15007
632050,2017,5,8,6,14,596
632070,2017,8,286,64,350,8547
632290,2017,7,13,3,16,1731
632800,2017,7,41,6,47,824
632840,2017,7,12,3,15,629
633130,2017,5,211,135,346,37907
633440,2017,7,15,3,18,553
633460,2017,8,1725,292,2017,77223
633580,2017,6,8,3,11,1047
633950,2017,5,101,47,148,4000
634120,2017,5,34,27,61,1468
634160,2017,8,266,8,274,16435
634180,2017,6,23,9,32,1589
634200,2017,7,23,4,27,28387
634700,2017,5,96,69,165,2086
635200,2017,6,636,171,807,61231
635260,2017,8,1857,215,2072,92953
635310,2017,8,103,16,119,9568
635320,2017,8,1185,138,1323,60590
635410,2017,8,40,10,50,4282
635550,2017,7,36,8,44,1059
635670,2017,6,64,25,89,3222
635730,2017,8,3579,498,4077,175982
635940,2017,8,252,2,254,6547
636150,2017,8,181,34,215,40035
636170,2017,5,23,11,34,1977
636330,2017,6,12,4,16,697
636390,2017,7,33,3,36,953
636400,2017,6,25,10,35,33664
636450,2017,8,449,42,491,24921
636570,2017,8,137,34,171,5326
637060,2017,6,32,13,45,3843
637100,2017,5,1524,784,2308,34165
637850,2017,8,2759,166,2925,172944
637880,2017,8,100,5,105,2971
638110,2017,8,224,36,260,37048
638160,2017,6,215,76,291,17271
639130,2017,8,171,13,184,11599
639170,2017,8,839,80,919,44575
639270,2017,8,156,4,160,6452
639300,2017,5,40,19,59,3970
639450,2017,7,25,5,30,3343
639470,2017,8,66,14,80,1829
639650,2017,8,440,23,463,87854
639720,2017,8,48,9,57,2823
639770,2017,7,19,1,20,788
639780,2017,9,1045,49,1094,63624
639790,2017,9,5024,155,5179,219114
639840,2017,6,12,5,17,1195
640050,2017,5,171,145,316,4905
640300,2017,7,25,4,29,1222
640380,2017,8,146,4,150,8556
640590,2017,8,126,25,151,24671
640890,2017,7,17,1,18,261
640970,2017,6,62,16,78,2277
640990,2017,8,67,6,73,2822
641980,2017,7,42,7,49,1286
641990,2017,8,3340,830,4170,489056
642000,2017,7,21,4,25,9801
642090,2017,8,234,17,251,18348
642170,2017,7,21,3,24,1836
642520,2017,5,32,25,57,1955
642560,2017,8,270,17,287,20849
642650,2017,7,29,1,30,655
642730,2017,7,18,1,19,536
643270,2017,9,3506,180,3686,259813
643590,2017,5,14,10,24,1362
643610,2017,7,32,7,39,2066
643700,2017,6,23,9,32,1025
643870,2017,8,209,13,222,5258
643880,2017,8,281,11,292,12328
643900,2017,7,33,4,37,669
643960,2017,8,73,14,87,4084
644080,2017,8,60,13,73,6430
644200,2017,8,93,20,113,3284
644380,2017,5,7,4,11,513
644390,2017,8,159,29,188,20735
644550,2017,8,198,20,218,4526
644760,2017,5,6,7,13,1556
645090,2017,8,1180,104,1284,68054
645260,2017,5,327,170,497,210108
645340,2017,5,20,9,29,2249
645450,2017,7,32,6,38,894
645460,2017,6,26,11,37,1531
645630,2017,6,6637,1995,8632,491057
645690,2017,8,116,9,125,3765
645820,2017,8,59,1,60,1645
645860,2017,6,7,3,10,341
645920,2017,7,38,7,45,1133
646200,2017,8,523,96,619,34702
646280,2017,7,12,1,13,1109
646380,2017,7,9,1,10,260
646470,2017,7,31,5,36,881
646600,2017,6,64,23,87,2090
646960,2017,5,17,17,34,2641
647040,2017,7,40,6,46,1565
647050,2017,5,8,6,14,743
647280,2017,4,6,17,23,903
647830,2017,6,530,153,683,72405
647990,2017,7,14,1,15,715
648070,2017,5,14,10,24,431
648550,2017,6,8,3,11,139
648570,2017,6,11,3,14,768
648630,2017,5,9,13,22,1085
648750,2017,7,25,6,31,2347
648780,2017,6,22,7,29,1378
648810,2017,6,15,6,21,799
649170,2017,7,26,5,31,241
649360,2017,7,19,3,22,320
649510,2017,4,3,7,10,307
649640,2017,6,82,31,113,2895
649670,2017,5,14,10,24,739
649790,2017,6,54,21,75,4947
649810,2017,6,38,11,49,4131
649880,2017,5,19,12,31,66128
649900,2017,5,150,116,266,55135
649990,2017,7,18,2,20,423
650000,2017,5,730,476,1206,34257
650070,2017,7,46,3,49,3036
650110,2017,5,93,67,160,8280
650220,2017,8,107,16,123,32237
650350,2017,5,72,46,118,4603
650440,2017,6,147,47,194,9613
650490,2017,4,25,47,72,3607
650570,2017,8,50,1,51,1072
650680,2017,5,21,11,32,1887
650750,2017,7,40,6,46,1631
650780,2017,8,247,17,264,7494
650860,2017,5,18,11,29,501
651340,2017,7,28,6,34,2023
651470,2017,6,69,21,90,12075
651550,2017,6,10,3,13,397
651660,2017,6,220,59,279,72923
652190,2017,6,53,15,68,5736
652230,2017,4,8,20,28,1220
652340,2017,7,22,1,23,295
652530,2017,7,9,1,10,54
652550,2017,2,20,102,122,4368
652570,2017,7,13,1,14,1159
652980,2017,8,4570,742,5312,412731
653190,2017,7,15,2,17,357
653210,2017,5,16,8,24,2020
653220,2017,8,147,36,183,49886
653760,2017,6,14,6,20,369
653940,2017,8,55,11,66,7456
653950,2017,8,328,17,345,4639
654020,2017,7,15,2,17,599
654050,2017,8,261,37,298,25451
654080,2017,7,11,1,12,245
654260,2017,8,306,51,357,7527
654300,2017,5,16,16,32,3345
654440,2017,8,57,5,62,2079
654610,2017,7,9,2,11,974
654660,2017,5,8,6,14,306
654710,2017,6,27,7,34,795
654750,2017,7,10,2,12,253
654850,2017,5,140,68,208,7125
654880,2017,8,2556,304,2860,306906
654900,2017,8,238,23,261,10235
654970,2017,4,3,8,11,9025
655000,2017,6,20,8,28,955
655020,2017,7,22,2,24,1294
655080,2017,8,73,12,85,2382
655100,2017,8,156,20,176,6427
655170,2017,5,11,12,23,956
655250,2017,5,7,10,17,393
655460,2017,5,15,22,37,1290
655610,2017,5,6,9,15,556
655660,2017,7,8,2,10,5112
655700,2017,3,3,22,25,3848
655730,2017,8,66,9,75,2733
655760,2017,5,11,5,16,406
655770,2017,8,100,3,103,3956
655790,2017,5,58,33,91,16008
655910,2017,7,37,1,38,677
655930,2017,4,8,17,25,1165
656040,2017,7,25,3,28,1092
656140,2017,5,84,71,155,3423
656200,2017,5,607,456,1063,28861
656210,2017,6,55,21,76,2894
656450,2017,6,28,12,40,946
656460,2017,5,38,17,55,2885
656550,2017,8,68,3,71,1673
656570,2017,7,25,1,26,1378
656600,2017,6,114,34,148,5646
656610,2017,4,17,39,56,43888
656680,2017,4,11,40,51,4533
656880,2017,7,24,1,25,746
656970,2017,7,46,2,48,1571
657040,2017,6,26,8,34,4552
657050,2017,8,70,13,83,3237
657120,2017,7,28,5,33,4312
657200,2017,6,4896,1558,6454,1199631
657260,2017,6,26,7,33,1072
657280,2017,7,40,2,42,4227
657290,2017,7,17,4,21,984
657440,2017,6,34,9,43,1710
657470,2017,5,18,15,33,2405
657590,2017,5,19,11,30,39627
657630,2017,6,226,63,289,11409
657690,2017,8,71,5,76,2178
657700,2017,6,10,4,14,11880
658060,2017,7,9,1,10,686
658160,2017,8,196,34,230,15489
658230,2017,7,12,1,13,216
658260,2017,8,258,50,308,7398
658320,2017,6,181,77,258,61133
658430,2017,5,7,4,11,971
658490,2017,5,30,15,45,1716
658530,2017,7,30,1,31,2296
658560,2017,9,545,27,572,35459
658570,2017,6,287,78,365,16740
658610,2017,4,21,50,71,2369
658660,2017,5,15,17,32,564
658790,2017,7,41,4,45,798
658980,2017,5,337,214,551,35163
659040,2017,7,14,1,15,125
659130,2017,5,20,12,32,1449
659190,2017,8,249,54,303,10354
659260,2017,7,10,2,12,5550
659460,2017,4,5,9,14,93855
659480,2017,8,55,12,67,1636
659560,2017,5,8,4,12,275
659950,2017,6,10,3,13,327
660070,2017,7,12,1,13,624
660160,2017,8,171,16,187,9727
660290,2017,7,16,4,20,682
660320,2017,5,8,4,12,697
660340,2017,5,15,18,33,2957
660990,2017,4,27,43,70,1225
661000,2017,6,98,31,129,5170
661040,2017,6,50,19,69,2856
661120,2017,7,20,4,24,7215
661280,2017,6,31,9,40,1591
661430,2017,8,109,9,118,5150
661460,2017,5,4,6,10,260
661480,2017,7,20,2,22,317
661740,2017,6,42,14,56,1671
661830,2017,6,27,7,34,5126
661960,2017,5,49,24,73,13533
661990,2017,8,47,8,55,5712
662190,2017,7,29,3,32,4850
662200,2017,7,20,1,21,466
662210,2017,8,87,3,90,1277
662230,2017,7,19,4,23,827
662320,2017,5,634,644,1278,304620
662470,2017,6,10,3,13,6909
662540,2017,8,53,5,58,2059
662910,2017,6,22,6,28,492
662920,2017,7,20,3,23,1039
663130,2017,7,15,3,18,700
663240,2017,8,74,8,82,1085
663370,2017,7,21,1,22,1397
663380,2017,6,1001,264,1265,38661
663390,2017,5,407,375,782,100170
663540,2017,6,10,4,14,361
663920,2017,5,7,5,12,337
664090,2017,8,202,24,226,11342
664140,2017,7,10,1,11,208
664180,2017,8,485,8,493,14899
664250,2017,7,9,1,10,343
664290,2017,4,7,11,18,933
664320,2017,5,24,11,35,3661
664420,2017,5,6,6,12,315
664430,2017,5,713,753,1466,62152
664610,2017,8,63,9,72,3028
664620,2017,5,20,11,31,989
664650,2017,5,13,6,19,551
665030,2017,7,29,6,35,836
665090,2017,6,1216,316,1532,32165
665120,2017,8,122,25,147,7040
665140,2017,5,8,4,12,459
665270,2017,8,226,7,233,3091
665490,2017,8,857,114,971,84239
665590,2017,6,9,3,12,710
665650,2017,7,8,2,10,3525
665670,2017,4,3,7,10,242
665890,2017,6,74,24,98,28789
665960,2017,5,15,12,27,528
666050,2017,7,13,1,14,859
666220,2017,8,3404,378,3782,780433
666250,2017,5,20,10,30,1015
666260,2017,5,8,11,19,7567
666330,2017,8,53,10,63,2792
666600,2017,7,8,2,10,89
666610,2017,7,28,3,31,2140
666860,2017,6,355,143,498,113414
667010,2017,7,25,2,27,360
667120,2017,4,12,24,36,8755
667130,2017,6,17,6,23,1103
667160,2017,7,9,2,11,503
667220,2017,7,14,3,17,222
667360,2017,4,9,17,26,1160
667420,2017,5,19,12,31,3126
667600,2017,8,357,18,375,13770
667870,2017,8,529,94,623,87665
667920,2017,5,23,20,43,4125
668210,2017,8,302,34,336,12444
668280,2017,7,14,1,15,310
668630,2017,8,8726,812,9538,289264
668670,2017,5,8,5,13,214
668830,2017,5,24,23,47,888
669050,2017,8,130,14,144,16030
669380,2017,7,26,3,29,460
669390,2017,7,26,4,30,408
669630,2017,6,75,19,94,4945
669660,2017,6,55,23,78,1896
669960,2017,6,10,3,13,174
670100,2017,5,11,6,17,415
670160,2017,8,353,19,372,5150
670370,2017,3,2,15,17,516
670440,2017,6,11,4,15,887
670500,2017,5,32,17,49,16143
670850,2017,7,8,2,10,209
670900,2017,5,136,92,228,9069
671090,2017,8,62,9,71,2517
671170,2017,8,59,8,67,2569
671200,2017,6,23,8,31,761
671240,2017,6,34,10,44,1999
671260,2017,6,43,18,61,3740
671270,2017,7,10,2,12,187
671390,2017,8,142,30,172,4982
671650,2017,7,29,2,31,542
671670,2017,5,7,6,13,461
671800,2017,6,195,54,249,22787
671810,2017,4,5,8,13,193
672020,2017,7,27,4,31,2106
672230,2017,7,24,6,30,589
672250,2017,7,9,1,10,202
672380,2017,5,4,6,10,263
672650,2017,7,33,4,37,10586
672680,2017,5,398,413,811,143568
672730,2017,8,244,12,256,43923
672860,2017,5,46,33,79,3500
673000,2017,8,259,36,295,14217
673260,2017,6,54,18,72,3191
673300,2017,8,51,3,54,1199
673600,2017,8,47,7,54,3934
673660,2017,5,38,20,58,1316
673820,2017,6,9,3,12,393
673850,2017,7,28,6,34,407
673980,2017,7,24,1,25,256
674220,2017,5,13,14,27,672
674250,2017,7,20,1,21,319
674310,2017,7,31,5,36,1289
674520,2017,8,357,15,372,9613
674750,2017,8,478,116,594,83678
674850,2017,8,61,2,63,1404
674940,2017,8,15215,1442,16657,2007237
674960,2017,7,29,6,35,1552
675010,2017,8,3214,760,3974,319213
675030,2017,7,28,2,30,543
675130,2017,5,10,5,15,207
675230,2017,5,30,19,49,4652
675260,2017,8,1578,268,1846,80154
675630,2017,5,166,149,315,44304
675720,2017,5,16,12,28,994
675730,2017,7,21,5,26,254
675940,2017,6,47,20,67,3095
675950,2017,4,3,7,10,233
675960,2017,6,9,3,12,248
675990,2017,7,10,2,12,560
676000,2017,6,23,8,31,727
676240,2017,7,28,1,29,662
676420,2017,8,147,9,156,6268
676430,2017,8,201,23,224,10033
676450,2017,6,13,5,18,515
676480,2017,8,54,7,61,1760
676490,2017,4,8,29,37,9503
676630,2017,7,46,3,49,1569
676720,2017,5,8,10,18,858
676770,2017,8,329,61,390,49147
676820,2017,9,721,29,750,17064
676910,2017,7,14,3,17,762
677020,2017,8,45,7,52,6234
677030,2017,7,22,4,26,306
677060,2017,7,23,4,27,1389
677280,2017,7,44,5,49,788
677330,2017,7,20,4,24,369
677650,2017,6,9,3,12,554
677720,2017,7,20,4,24,633
677730,2017,7,12,3,15,2370
677820,2017,5,7,8,15,318
677870,2017,4,2,8,10,253
677880,2017,4,11,21,32,2246
677910,2017,7,19,2,21,548
678190,2017,5,45,59,104,5916
678230,2017,6,9,3,12,1354
678240,2017,5,8,5,13,615
678290,2017,7,14,3,17,356
678310,2017,7,28,1,29,725
678520,2017,8,220,13,233,14148
678560,2017,6,284,72,356,6607
678800,2017,8,1294,309,1603,337896
678820,2017,7,21,3,24,7778
678970,2017,7,36,7,43,2975
679190,2017,6,32,11,43,1056
679430,2017,7,10,1,11,154
679470,2017,7,12,3,15,384
679530,2017,5,5,5,10,859
679660,2017,8,59,11,70,2951
679770,2017,7,17,2,19,1217
679860,2017,5,14,9,23,54287
680310,2017,5,55,70,125,28888
680340,2017,8,60,15,75,1643
680480,2017,8,64,5,69,3623
680550,2017,6,12,4,16,67
680620,2017,7,16,3,19,463
680980,2017,6,182,48,230,8974
681060,2017,7,29,7,36,2607
681100,2017,6,19,6,25,724
681140,2017,5,17,23,40,2093
681160,2017,4,12,19,31,3165
681240,2017,7,40,1,41,892
681340,2017,7,14,2,16,269
681480,2017,4,4,10,14,207
681500,2017,4,38,70,108,22978
681520,2017,5,16,11,27,562
681620,2017,7,22,2,24,546
681630,2017,7,8,2,10,168
681780,2017,4,9,31,40,3268
681800,2017,7,24,2,26,597
682130,2017,8,154,30,184,8557
682590,2017,7,13,3,16,516
682610,2017,7,21,3,24,739
682780,2017,7,21,2,23,379
682810,2017,7,23,2,25,582
682910,2017,5,29,23,52,2316
683280,2017,8,62,13,75,4684
683530,2017,5,7,8,15,730
683600,2017,4,3,8,11,588
683670,2017,7,23,2,25,2653
683730,2017,5,6,4,10,228
683760,2017,7,15,1,16,382
683790,2017,5,8,4,12,417
684060,2017,7,9,2,11,1065
684130,2017,3,1,10,11,231
684270,2017,8,129,5,134,8049
684410,2017,8,982,109,1091,155331
684530,2017,7,28,1,29,3312
684680,2017,7,46,1,47,1912
684820,2017,4,7,13,20,2497
684870,2017,7,13,1,14,278
684940,2017,6,9,3,12,413
685310,2017,6,138,43,181,34903
685420,2017,5,63,45,108,12199
685680,2017,8,115,14,129,9331
685750,2017,5,19,20,39,6304
685790,2017,5,28,34,62,1226
685950,2017,5,74,38,112,1885
685990,2017,4,20,39,59,1285
686110,2017,7,39,5,44,2745
686360,2017,7,20,5,25,752
686500,2017,5,16,9,25,531
686550,2017,5,10,6,16,1211
686570,2017,6,46,19,65,1053
686740,2017,5,10,9,19,681
686760,2017,7,32,5,37,688
686900,2017,6,34,10,44,5666
687260,2017,8,355,30,385,17784
687310,2017,7,15,3,18,168
687480,2017,5,7,6,13,1536
687490,2017,5,13,9,22,1496
687540,2017,6,23,7,30,2833
687560,2017,6,10,3,13,10370
687750,2017,5,61,46,107,4993
687830,2017,8,98,3,101,1803
687890,2017,7,12,2,14,646
688260,2017,5,33,15,48,926
688380,2017,7,18,1,19,488
688400,2017,7,14,2,16,508
688450,2017,7,8,2,10,108
688480,2017,5,162,93,255,15182
688570,2017,5,20,10,30,1183
688680,2017,7,12,3,15,303
688690,2017,8,52,8,60,1346
688880,2017,5,15,11,26,439
689000,2017,7,10,1,11,155
689070,2017,8,141,11,152,4182
689090,2017,8,581,71,652,43986
689160,2017,6,9,3,12,320
689180,2017,6,12,5,17,1548
689350,2017,4,17,31,48,1139
689360,2017,4,29,59,88,3717
689400,2017,8,72,12,84,6866
689650,2017,5,84,70,154,5868
689900,2017,8,121,5,126,3023
689910,2017,8,150,8,158,5443
690060,2017,5,106,68,174,26701
690130,2017,7,10,2,12,240
690240,2017,5,11,6,17,1490
690350,2017,6,35,9,44,569
690460,2017,5,15,9,24,1276
690560,2017,8,49,6,55,1122
690710,2017,7,15,1,16,423
690740,2017,5,36,18,54,1946
690810,2017,5,111,60,171,10157
690930,2017,8,340,42,382,16080
691080,2017,5,32,20,52,518
691240,2017,7,13,3,16,200
691250,2017,7,15,1,16,327
691450,2017,8,201,4,205,8620
691540,2017,5,41,28,69,34393
692200,2017,5,12,10,22,970
692590,2017,5,8,9,17,271
692920,2017,6,335,114,449,62689
692930,2017,7,29,7,36,1127
693180,2017,5,13,7,20,40836
693250,2017,5,9,13,22,883
693670,2017,5,28,17,45,525
693880,2017,5,8,7,15,1296
693890,2017,5,8,5,13,1254
694130,2017,5,46,66,112,48796
694370,2017,7,38,4,42,1308
694490,2017,4,13,21,34,1634
694790,2017,7,13,3,16,429
694950,2017,7,20,4,24,494
694980,2017,5,43,21,64,1835
695110,2017,7,12,1,13,662
695630,2017,5,200,277,477,8808
695650,2017,5,64,30,94,1884
696140,2017,8,83,8,91,5019
696250,2017,5,7,6,13,408
696360,2017,5,51,28,79,7535
696400,2017,5,9,13,22,1807
696460,2017,8,47,5,52,1138
696480,2017,8,275,61,336,16161
696560,2017,7,28,7,35,1040
696590,2017,8,113,22,135,5832
696940,2017,6,30,11,41,1253
697610,2017,8,116,13,129,25787
697850,2017,4,6,13,19,1374
697930,2017,5,20,16,36,2131
698300,2017,8,44,11,55,1813
698330,2017,7,35,7,42,846
698740,2017,5,49,22,71,5957
698830,2017,5,18,14,32,1210
699080,2017,7,32,4,36,933
699100,2017,5,7,4,11,755
699240,2017,7,17,4,21,1842
699480,2017,5,8,11,19,394
699550,2017,5,12,15,27,739
699590,2017,5,11,7,18,11412
699600,2017,8,52,2,54,3256
699750,2017,7,26,4,30,661
699780,2017,7,16,3,19,1351
699940,2017,6,19,6,25,752
700170,2017,7,42,7,49,20390
700330,2017,8,6743,1433,8176,973512
700440,2017,5,11,6,17,431
700480,2017,6,75,22,97,16199
700510,2017,7,9,1,10,136
700660,2017,6,40,17,57,1683
700740,2017,5,15,12,27,1421
701280,2017,6,8,3,11,317
701290,2017,7,9,1,10,313
701540,2017,5,14,8,22,2203
701720,2017,6,40,17,57,1315
701740,2017,5,9,4,13,173
701860,2017,7,25,5,30,1435
701930,2017,8,345,1,346,6680
702110,2017,8,48,10,58,2832
702190,2017,5,27,19,46,857
702200,2017,5,29,32,61,2872
702320,2017,5,95,90,185,59173
702600,2017,7,39,3,42,856
703180,2017,7,20,4,24,867
703210,2017,7,13,3,16,510
703500,2017,7,17,1,18,357
703530,2017,5,6,6,12,2592
703620,2017,7,32,3,35,841
703630,2017,7,23,3,26,400
703700,2017,6,1321,378,1699,65517
703760,2017,5,8,6,14,1788
703870,2017,6,14,6,20,776
703920,2017,4,9,21,30,19662
703950,2017,6,311,112,423,166288
704040,2017,5,129,80,209,57843
704680,2017,7,19,4,23,1151
704690,2017,6,73,27,100,6142
704830,2017,5,62,48,110,5625
704840,2017,8,97,5,102,1762
705070,2017,5,19,21,40,2429
705090,2017,5,8,5,13,1165
705120,2017,8,1689,131,1820,193429
705240,2017,7,14,1,15,515
705250,2017,6,11,3,14,243
705260,2017,5,7,6,13,410
705300,2017,4,6,10,16,549
705450,2017,7,37,3,40,1107
705640,2017,5,14,7,21,412
705710,2017,4,13,39,52,2745
705750,2017,7,23,4,27,836
706130,2017,8,67,3,70,1256
706280,2017,7,14,2,16,370
706320,2017,5,10,6,16,1258
706330,2017,5,9,5,14,1110
706920,2017,7,24,1,25,431
707230,2017,7,10,2,12,250
707590,2017,8,42,9,51,1488
707720,2017,5,6,4,10,216
707870,2017,6,59,22,81,1981
708260,2017,7,39,4,43,868
708300,2017,7,22,3,25,810
708340,2017,7,31,5,36,6467
708430,2017,5,12,12,24,661
708580,2017,8,91,20,111,5489
708640,2017,7,15,1,16,186
708680,2017,7,42,2,44,11816
708850,2017,7,15,2,17,399
708920,2017,7,22,3,25,5718
708930,2017,4,5,10,15,316
708950,2017,7,18,3,21,461
709190,2017,5,11,6,17,583
709380,2017,5,20,15,35,975
709410,2017,5,18,15,33,1777
709560,2017,5,8,5,13,146
709700,2017,5,19,17,36,1229
709780,2017,5,24,28,52,1358
709840,2017,5,22,32,54,1614
710030,2017,8,171,20,191,10347
710070,2017,7,12,2,14,221
710110,2017,6,10,4,14,1179
710120,2017,6,12,4,16,1157
710520,2017,7,12,2,14,191
710760,2017,7,25,5,30,1394
710780,2017,6,48,18,66,4338
710880,2017,4,3,9,12,917
711070,2017,5,18,26,44,1630
711320,2017,5,31,17,48,1600
711450,2017,5,8,4,12,369
711560,2017,6,24,7,31,2390
712000,2017,5,27,23,50,1745
712010,2017,5,13,6,19,590
712090,2017,5,13,8,21,1454
712150,2017,5,8,6,14,369
712380,2017,7,31,3,34,647
712390,2017,8,44,10,54,12608
712650,2017,7,8,2,10,174
712730,2017,8,423,10,433,15552
712770,2017,7,37,8,45,8161
712790,2017,7,37,9,46,3562
712970,2017,7,14,1,15,236
712980,2017,6,12,4,16,260
713050,2017,8,62,13,75,1758
713080,2017,4,3,11,14,352
713160,2017,7,27,1,28,526
713530,2017,8,76,7,83,1735
713650,2017,5,215,117,332,19363
713680,2017,5,51,38,89,2809
714050,2017,5,10,13,23,4154
714240,2017,7,29,6,35,1532
714280,2017,8,74,2,76,1410
714510,2017,5,7,7,14,305
715010,2017,8,203,5,208,15092
715060,2017,4,12,21,33,1602
715290,2017,5,9,6,15,1967
715310,2017,5,110,75,185,39504
715440,2017,7,9,1,10,929
715470,2017,5,9,5,14,640
715510,2017,6,44,14,58,1786
715690,2017,5,28,16,44,2232
715840,2017,5,21,15,36,1065
715980,2017,5,17,25,42,1225
716070,2017,7,19,1,20,310
716260,2017,8,95,10,105,36966
716330,2017,6,10,3,13,403
716340,2017,8,66,1,67,2112
716400,2017,7,19,3,22,476
716600,2017,4,7,15,22,1052
716630,2017,5,45,37,82,4683
716650,2017,8,116,1,117,1214
716680,2017,7,35,3,38,331
717190,2017,6,12,4,16,3374
717640,2017,8,328,56,384,66897
717820,2017,6,14,4,18,373
717950,2017,6,76,20,96,2704
717990,2017,5,52,28,80,11312
718180,2017,8,76,12,88,5027
718200,2017,7,46,1,47,1022
718220,2017,5,9,9,18,1568
718320,2017,6,45,17,62,3678
718330,2017,8,120,22,142,5390
718370,2017,5,77,43,120,4100
718500,2017,6,28,9,37,9224
718660,2017,5,10,6,16,407
718720,2017,7,21,1,22,855
718960,2017,7,12,2,14,114
719120,2017,4,19,41,60,2943
719410,2017,8,69,3,72,593
719470,2017,4,4,8,12,352
719610,2017,5,33,33,66,1566
719640,2017,5,72,74,146,67624
720150,2017,8,84,14,98,2139
720280,2017,8,1765,251,2016,66259
720670,2017,8,48,5,53,1918
721350,2017,7,18,3,21,223
721430,2017,6,24,10,34,1085
721760,2017,7,13,3,16,449
721940,2017,5,5,7,12,673
721950,2017,5,12,6,18,305
722040,2017,6,8,3,11,332
722230,2017,5,201,91,292,17035
722250,2017,6,22,9,31,901
722730,2017,8,414,7,421,12270
722750,2017,5,25,18,43,10604
722760,2017,6,11,3,14,478
722870,2017,7,36,2,38,476
722990,2017,7,18,1,19,515
723090,2017,8,391,10,401,24016
723270,2017,8,164,14,178,3859
723610,2017,7,35,7,42,12468
723760,2017,5,11,9,20,623
723780,2017,5,1115,1129,2244,594344
723820,2017,7,18,1,19,595
723890,2017,7,32,3,35,926
724350,2017,6,43,13,56,4368
724740,2017,8,229,57,286,9051
725340,2017,8,473,60,533,29426
725400,2017,5,19,21,40,751
725970,2017,7,13,3,16,198
726020,2017,6,13,4,17,595
726070,2017,4,9,21,30,840
726120,2017,6,19,8,27,563
726200,2017,7,33,5,38,680
726230,2017,7,14,1,15,1116
726250,2017,8,66,3,69,2127
726260,2017,7,13,1,14,202
726320,2017,7,14,3,17,410
726340,2017,7,25,1,26,612
726390,2017,8,226,38,264,42180
726600,2017,5,13,15,28,835
726760,2017,5,29,19,48,1231
726800,2017,5,23,18,41,820
726910,2017,8,156,28,184,59331
727220,2017,5,8,4,12,249
727290,2017,7,15,1,16,206
727310,2017,6,15,4,19,5440
727340,2017,7,25,1,26,642
727460,2017,6,22,8,30,1521
727480,2017,7,27,2,29,430
727510,2017,7,38,1,39,937
727530,2017,5,17,8,25,5297
727550,2017,6,15,6,21,219
727730,2017,7,28,7,35,883
728070,2017,7,15,3,18,1321
728420,2017,5,9,4,13,300
728440,2017,8,72,10,82,2348
728870,2017,7,27,5,32,286
728990,2017,5,12,15,27,1093
729330,2017,5,27,26,53,2626
729460,2017,5,9,4,13,584
729530,2017,5,43,19,62,2550
729570,2017,7,19,4,23,582
729580,2017,5,22,13,35,6533
729670,2017,4,13,24,37,5032
729720,2017,6,38,10,48,2628
730410,2017,5,138,79,217,8646
730920,2017,7,25,1,26,301
731230,2017,5,19,14,33,1644
731880,2017,5,39,23,62,2418
731920,2017,5,50,59,109,3951
731940,2017,7,22,4,26,791
732090,2017,4,5,8,13,482
732430,2017,9,3555,115,3670,184213
732840,2017,5,10,5,15,822
733050,2017,8,90,9,99,4381
733070,2017,8,123,9,132,6771
733250,2017,7,13,2,15,641
733430,2017,5,9,9,18,552
733990,2017,8,811,47,858,39373
734120,2017,6,47,20,67,1506
734540,2017,5,11,5,16,404
734700,2017,7,17,2,19,250
734750,2017,6,625,172,797,184035
734910,2017,8,361,32,393,60835
735260,2017,5,10,5,15,417
735280,2017,6,103,42,145,19275
735350,2017,6,37,13,50,842
735410,2017,5,6,6,12,336
735450,2017,6,40,16,56,31616
735570,2017,8,544,39,583,60531
736110,2017,5,14,8,22,482
736200,2017,7,19,3,22,425
736430,2017,5,6,7,13,263
736860,2017,5,34,20,54,3030
736930,2017,5,14,7,21,1703
737260,2017,5,7,9,16,416
737690,2017,6,13,4,17,456
737810,2017,5,10,5,15,584
737870,2017,7,39,5,44,2319
738000,2017,6,16,6,22,764
738020,2017,7,31,7,38,1933
738500,2017,5,73,91,164,39676
738560,2017,7,8,2,10,217
738610,2017,6,78,26,104,8193
738760,2017,6,12,5,17,255
739210,2017,7,20,2,22,773
739410,2017,6,8,3,11,6952
739690,2017,5,14,7,21,492
739850,2017,7,10,1,11,310
739980,2017,8,62,3,65,2257
740000,2017,7,26,2,28,237
740090,2017,5,8,6,14,1081
740260,2017,8,898,86,984,18594
740290,2017,8,120,24,144,2646
740400,2017,7,11,1,12,435
740410,2017,7,19,2,21,682
740470,2017,6,347,115,462,49221
740570,2017,7,42,7,49,1449
740600,2017,5,56,28,84,1886
741100,2017,4,5,9,14,258
741450,2017,4,17,43,60,2609
741500,2017,5,87,46,133,4697
741670,2017,8,310,58,368,11292
742230,2017,6,21,9,30,542
742540,2017,6,13,4,17,420
742630,2017,5,22,11,33,7636
743110,2017,7,9,2,11,310
743370,2017,5,138,83,221,71139
743640,2017,5,111,75,186,5470
744420,2017,6,61,24,85,1326
744430,2017,8,61,13,74,1620
744570,2017,8,69,11,80,7448
744590,2017,6,13,4,17,210
744940,2017,5,14,10,24,498
745030,2017,7,15,1,16,434
745130,2017,5,6,5,11,1003
745370,2017,6,17,7,24,854
745380,2017,5,5,5,10,311
745500,2017,4,7,14,21,803
745510,2017,6,29,12,41,1440
745670,2017,4,9,24,33,1856
745740,2017,6,63,25,88,4761
745930,2017,6,13,4,17,333
745960,2017,8,124,7,131,3249
746350,2017,5,17,9,26,915
746410,2017,6,27,7,34,605
746570,2017,6,20,6,26,358
746620,2017,7,42,4,46,2126
747190,2017,5,11,6,17,547
747310,2017,5,19,12,31,2079
747330,2017,6,14,4,18,353
747340,2017,8,200,29,229,8727
747590,2017,5,32,17,49,2462
747770,2017,5,14,7,21,1382
747910,2017,5,13,11,24,2533
747990,2017,6,10,3,13,208
748430,2017,5,8,4,12,654
748480,2017,6,19,6,25,2110
748610,2017,5,15,8,23,3022
748890,2017,8,56,2,58,3472
748930,2017,5,8,4,12,163
749270,2017,5,9,8,17,862
749340,2017,6,13,4,17,643
749670,2017,7,15,3,18,622
749880,2017,7,32,8,40,1047
749990,2017,7,12,1,13,964
750330,2017,6,16,6,22,435
750660,2017,7,40,4,44,469
750900,2017,4,2,8,10,264
750960,2017,7,35,3,38,551
751200,2017,5,8,5,13,215
751280,2017,7,45,2,47,541
751500,2017,6,97,33,130,6476
751690,2017,8,345,36,381,125741
752300,2017,6,10,4,14,168051
752500,2017,8,53,11,64,1209
752700,2017,6,14,6,20,596
753060,2017,5,15,8,23,4578
753380,2017,5,7,5,12,709
753440,2017,7,11,1,12,121
753920,2017,5,6,7,13,585
753960,2017,5,7,4,11,73
754120,2017,5,12,8,20,2503
754540,2017,7,39,2,41,1151
754800,2017,6,14,4,18,886
754810,2017,8,128,24,152,14378
755350,2017,5,9,12,21,399
755560,2017,7,13,1,14,530
755890,2017,8,44,9,53,1455
756190,2017,4,7,11,18,641
756260,2017,5,14,13,27,784
756440,2017,7,44,4,48,3659
756700,2017,7,30,3,33,511
756880,2017,5,31,26,57,2453
757330,2017,8,74,2,76,3876
757450,2017,7,14,3,17,1160
757860,2017,5,13,6,19,512
757870,2017,7,18,2,20,198
758400,2017,5,6,4,10,276
758470,2017,4,6,10,16,435
758500,2017,8,136,5,141,4557
758920,2017,5,6,5,11,835
759500,2017,6,10,3,13,584
759610,2017,5,16,23,39,834
759870,2017,4,6,21,27,414
759940,2017,8,276,40,316,6322
760350,2017,7,16,3,19,1339
760490,2017,5,12,11,23,154
760560,2017,5,19,18,37,879
761280,2017,6,33,9,42,8139
761440,2017,3,1,9,10,387
761630,2017,4,5,8,13,299
761660,2017,4,3,9,12,560
763050,2017,7,12,2,14,513
763070,2017,6,15,6,21,584
763090,2017,5,8,9,17,8173
763210,2017,7,22,2,24,318
763360,2017,6,13,5,18,697
763400,2017,4,10,16,26,758
763760,2017,7,16,4,20,676
763870,2017,7,13,2,15,478
763930,2017,7,26,1,27,1530
764430,2017,6,10,4,14,949
764470,2017,6,10,3,13,221
764500,2017,6,42,18,60,1298
765640,2017,8,165,7,172,2313
767050,2017,5,7,5,12,252
767500,2017,6,21,6,27,238
768300,2017,5,20,10,30,989
768840,2017,5,21,14,35,9126
769080,2017,5,16,7,23,271
769550,2017,7,26,2,28,684
770400,2017,4,13,27,40,657
