id,year,review_score,total_positive,total_negative,total_reviews,Players
220,2004,9,54855,1761,56616,8877286
240,2004,9,65877,2798,68675,15001876
240,2004,9,65877,2798,68675,15001876
300,2010,8,9014,937,9951,4419447
380,2006,8,6168,352,6520,3917529
400,2007,9,43124,794,43918,9971481
420,2007,9,11237,495,11732,3281382
440,2007,8,446494,28380,474874,50191347
440,2007,8,446494,28380,474874,50191347
500,2008,9,14637,731,15368,4604963
550,2009,9,210383,6339,216722,23143723
550,2009,9,210383,6339,216722,23143723
620,2011,9,113776,1338,115114,13062700
630,2010,9,16119,777,16896,6667813
730,2012,8,2160849,277888,2438737,46305966
730,2012,8,2160849,277888,2438737,46305966
1200,2006,8,1335,176,1511,849053
1250,2009,9,49902,2286,52188,7395545
1520,2006,8,1875,304,2179,708655
1530,2008,8,337,65,402,180479
1840,2012,8,11458,738,12196,1852569
2450,2010,6,598,179,777,118504
2820,2008,8,1523,239,1762,482728
2870,2013,5,2632,3838,6470,343046
3540,2008,8,315,20,335,181811
3590,2009,9,11809,297,12106,1647028
3620,2009,8,367,20,387,75495
3830,2006,9,7378,376,7754,1207186
4000,2006,9,297556,12631,310187,18576379
4000,2006,9,297556,12631,310187,18576379
4920,2012,8,7798,1337,9135,1993899
6120,2010,8,1551,186,1737,312665
6600,2007,5,36,32,68,41006
7520,2011,5,2754,1849,4603,703263
8190,2010,8,29030,2534,31564,4161156
8850,2010,8,7815,831,8646,1558279
8870,2013,9,69661,3237,72898,4563627
8930,2010,9,115676,4236,119912,12701498
8970,2010,6,31,12,43,8860
9500,2007,5,153,91,244,176440
9880,2011,6,1883,701,2584,1691316
9940,2014,8,696,133,829,65542
9970,2011,3,5,24,29,5660
10180,2009,8,26250,2398,28648,5267226
10220,2012,4,525,919,1444,84486
10500,2009,8,13232,1263,14495,3491439
10680,2010,8,8114,981,9095,1231126
11240,2008,5,287,295,582,68979
11280,2008,8,811,113,924,88249
11330,2009,8,548,120,668,65629
11340,2009,6,493,149,642,57562
12900,2008,9,8586,351,8937,1561882
13000,2008,8,48,4,52,19566
13140,2009,5,1457,679,2136,3014457
13210,2009,8,2179,229,2408,902895
15400,2009,8,85,20,105,34113
15500,2008,6,393,135,528,90431
15520,2009,8,551,98,649,148747
15560,2011,6,714,228,942,156626
15620,2009,8,5238,654,5892,2492053
15740,2010,6,376,131,507,108580
15750,2010,8,682,117,799,153101
16500,2008,7,10,1,11,3261
16600,2008,8,165,33,198,118998
17100,2008,8,161,31,192,48123
17120,2008,8,47,10,57,25293
17140,2008,6,109,36,145,29581
17180,2008,6,15,6,21,5953
17500,2008,8,4607,715,5322,2573292
17570,2010,8,3306,471,3777,1077057
17580,2009,8,680,131,811,410346
17710,2011,6,1575,404,1979,640448
17740,2008,8,586,89,675,174440
18000,2008,8,385,40,425,161617
18020,2008,8,116,20,136,64438
18040,2010,8,504,29,533,91932
18050,2010,8,120,18,138,30765
18070,2011,8,145,36,181,52893
18500,2008,9,3268,104,3372,558114
18600,2009,5,12,10,22,4016
18700,2009,5,727,313,1040,324236
18820,2010,8,612,149,761,795021
19020,2010,5,15,7,22,7589
19030,2010,6,64,18,82,9999
19200,2008,5,214,177,391,39071
19320,2012,5,6,7,13,2751
19500,2008,4,12,46,58,6247
20200,2008,4,6,10,16,5171
20500,2009,8,5896,620,6516,1010775
20570,2010,8,1537,137,1674,1285276
20700,2008,6,48,15,63,14750
20710,2008,8,55,11,66,31070
20820,2010,8,962,61,1023,255073
20920,2012,8,31185,3823,35008,4585616
21100,2011,6,4782,1800,6582,1096875
21300,2008,6,16,5,21,14840
21400,2008,5,9,5,14,7785
21640,2009,6,108,33,141,29726
21690,2009,8,7310,1211,8521,1005089
22000,2008,8,3180,204,3384,986510
22200,2009,8,1876,328,2204,320458
22230,2011,8,2419,210,2629,636120
22310,2009,5,368,209,577,44059
22350,2011,5,3049,2033,5082,1700604
22380,2010,9,55309,2336,57645,5222533
22500,2009,8,125,16,141,20588
22600,2010,8,2278,384,2662,1289109
22610,2010,6,687,272,959,199888
22650,2010,5,432,204,636,157346
22670,2010,6,207,75,282,57440
23150,2010,6,12,5,17,3440
23530,2011,8,702,69,771,87316
24200,2011,8,8966,2239,11205,2863993
24240,2011,8,31919,2223,34142,4944712
24420,2008,8,975,121,1096,163102
24480,2012,5,172,156,328,98328
25700,2009,8,183,39,222,281079
26000,2009,8,153,33,186,42072
26300,2009,4,11,29,40,7562
26500,2009,8,646,81,727,377806
26800,2009,8,6137,354,6491,1012406
27330,2010,4,123,193,316,60463
27600,2009,7,21,2,23,1938
27920,2010,5,87,91,178,227125
27940,2011,4,196,398,594,99822
28000,2010,5,2271,1480,3751,448371
29180,2009,8,820,98,918,413551
31280,2010,8,5506,833,6339,952378
31700,2008,8,304,51,355,74779
31980,2009,5,12,8,20,8543
32150,2009,8,299,6,305,19656
32160,2009,8,215,38,253,33774
32200,2009,5,76,44,120,34954
32410,2009,6,37,15,52,19433
32460,2010,9,1082,49,1131,288297
33390,2011,6,24,7,31,6783
33650,2010,8,284,38,322,35897
33660,2010,6,21,8,29,4418
33670,2010,5,161,123,284,86037
33680,2010,8,904,81,985,52081
33930,2010,8,16375,1305,17680,4514397
33980,2010,5,74,44,118,13367
34030,2010,8,7309,621,7930,2178916
34270,2010,8,1267,305,1572,1514485
34500,2009,7,31,7,38,10161
34830,2010,5,1759,1374,3133,934745
34870,2013,6,5362,2096,7458,1089080
34900,2009,6,9475,2723,12198,476787
34920,2010,4,47,149,196,23507
35130,2010,8,2309,194,2503,550882
35140,2010,9,17684,659,18343,2240464
35320,2012,8,292,58,350,28646
35450,2011,8,24118,1958,26076,3501161
35460,2010,6,578,192,770,186933
35480,2011,6,569,156,725,202488
35600,2009,5,43,35,78,16686
35700,2009,9,8516,351,8867,1604101
35720,2013,9,14968,588,15556,2791654
36000,2009,5,176,103,279,72409
37500,2009,6,32,9,41,10680
37800,2009,5,25,12,37,35950
38230,2010,5,54,77,131,36667
38600,2010,8,2071,192,2263,214039
38700,2010,8,1562,210,1772,352195
38720,2010,8,996,111,1107,248133
39110,2010,6,145,39,184,24628
39140,2013,8,10623,755,11378,1136100
39150,2013,8,4876,559,5435,581505
39160,2011,5,992,634,1626,638566
39800,2009,8,1944,247,2191,877968
40100,2010,8,4738,781,5519,1048307
40390,2012,6,2681,785,3466,713807
40400,2009,8,956,168,1124,371287
40420,2010,5,126,63,189,60328
40700,2009,9,4544,211,4755,609675
40800,2010,9,21448,1041,22489,2970487
40930,2010,8,319,38,357,127810
40980,2016,6,320,92,412,248308
41000,2009,8,3374,220,3594,1025064
41070,2011,8,13693,1671,15364,2029621
41300,2009,8,1436,106,1542,1321782
41740,2011,6,252,64,316,37887
41900,2009,6,586,168,754,158667
42000,2011,5,8,5,13,3829
42120,2010,6,1293,470,1763,1107457
42140,2011,5,167,79,246,61329
42170,2012,5,412,309,721,179546
42500,2010,5,229,141,370,176883
42700,2010,8,12481,1532,14013,3759377
42910,2011,8,19454,1409,20863,4976290
42990,2012,5,323,425,748,108612
43000,2010,5,432,290,722,134789
43190,2011,8,464,69,533,69196
43600,2010,7,36,4,40,13164
44100,2010,8,73,9,82,35059
45000,2010,8,286,29,315,405082
45100,2010,8,1273,248,1521,145021
45300,2010,5,299,131,430,156274
45400,2010,8,764,66,830,87234
45410,2011,5,142,107,249,36605
45420,2016,7,10,1,11,314
45450,2011,8,442,42,484,71018
45730,2010,5,123,127,250,23630
45740,2010,6,2294,783,3077,627795
45760,2014,8,7602,1015,8617,1306698
45770,2011,6,1142,315,1457,263656
46000,2010,6,71,29,100,50047
46450,2010,5,202,127,329,93777
46520,2011,5,158,117,275,32134
46570,2011,5,96,79,175,33667
46600,2010,6,39,12,51,21596
46770,2010,6,185,55,240,34741
47000,2010,8,524,85,609,38574
47540,2010,8,250,49,299,73522
48000,2011,8,27176,1657,28833,3207480
48700,2010,9,64072,1698,65770,4219791
48720,2011,8,5157,796,5953,1231509
48950,2010,8,392,61,453,167621
49300,2010,5,57,66,123,56215
49320,2010,5,29,25,54,16197
49330,2011,5,75,43,118,43817
49470,2011,8,720,93,813,377401
49520,2012,9,119815,4536,124351,11218936
49600,2010,9,6028,292,6320,601573
49810,2011,8,105,23,128,16752
49900,2010,5,178,78,256,149111
50000,2010,8,180,10,190,39982
50130,2011,8,26419,1541,27960,2312872
50510,2010,5,57,85,142,58147
50620,2010,8,8038,906,8944,1683431
51060,2011,8,73,11,84,10000
55020,2010,5,39,28,67,11879
55040,2011,8,1385,164,1549,316352
55100,2011,5,4496,3003,7499,1182312
55110,2011,6,2451,886,3337,785298
55140,2010,8,1427,316,1743,307610
55150,2011,8,7279,574,7853,1099682
55230,2011,9,38409,1416,39825,5143189
57000,2010,8,83,9,92,24562
57200,2010,8,395,37,432,77794
57300,2010,8,17767,958,18725,2609222
57680,2011,6,421,177,598,56157
57690,2011,8,8081,724,8805,2000449
57700,2011,6,97,39,136,20891
57800,2010,5,73,86,159,62506
57900,2011,5,4097,2017,6114,886514
58200,2010,8,247,30,277,49520
58230,2012,8,79,15,94,26568
58400,2010,4,42,80,122,33305
58550,2011,4,192,399,591,168535
58610,2012,6,1766,510,2276,621393
60350,2011,8,67,9,76,14082
60600,2010,5,27,21,48,16997
60700,2010,4,9,25,34,6871
61100,2011,6,163,51,214,46438
61600,2010,8,415,58,473,114745
61700,2011,8,1191,108,1299,309591
61730,2012,8,245,13,258,32972
62000,2010,8,407,33,440,108722
62100,2010,8,581,38,619,106325
63000,2011,8,648,159,807,239813
63200,2011,6,709,192,901,708500
63700,2010,8,600,140,740,267116
63710,2011,8,2921,457,3378,647721
63940,2011,5,347,211,558,131229
64000,2011,8,2609,351,2960,409681
65300,2012,8,1519,197,1716,2490746
65400,2010,8,85,17,102,13158
65710,2010,8,253,48,301,17001
65800,2011,8,10202,847,11049,2483252
65980,2014,5,8945,7767,16712,2606575
67000,2010,6,334,106,440,154963
67370,2012,8,9732,1009,10741,1145131
70000,2011,8,11018,2113,13131,2364083
70120,2011,4,157,282,439,118551
70300,2010,9,6175,233,6408,763558
70500,2010,6,31,12,43,14906
70600,2011,8,1760,235,1995,486841
70620,2011,8,360,79,439,132903
71230,2011,8,860,215,1075,148830
71240,2011,8,260,50,310,58500
71250,2011,8,2210,440,2650,291205
71260,2011,8,495,71,566,51418
71340,2011,8,5887,434,6321,647871
72000,2012,8,649,94,743,192454
72200,2011,8,2203,489,2692,752402
72400,2010,6,219,66,285,97328
72500,2010,5,35,38,73,8589
72850,2011,8,216040,13281,229321,13235488
72900,2010,5,132,73,205,39498
73010,2011,6,576,161,737,237970
73060,2012,4,32,64,96,24228
78000,2010,9,2373,99,2472,295211
80000,2011,4,44,109,153,45758
80200,2011,6,258,65,323,81723
80310,2011,8,1141,114,1255,130615
80330,2012,8,789,96,885,79474
80340,2012,8,322,21,343,52347
80350,2012,8,258,14,272,49385
80360,2012,8,282,10,292,46844
90200,2010,8,312,54,366,99303
90500,2010,5,61,89,150,43341
91100,2011,8,725,87,812,120532
91200,2011,8,3132,420,3552,567765
91600,2011,8,2469,271,2740,2088528
91700,2011,8,4113,795,4908,768052
91800,2011,8,68,8,76,11099
91810,2011,6,19,7,26,7392
92000,2011,5,1241,776,2017,186396
92100,2011,5,1034,611,1645,341194
92200,2011,8,117,7,124,28454
92210,2011,8,130,25,155,26273
92220,2011,8,113,21,134,31444
92300,2011,6,561,236,797,107351
92600,2011,6,123,39,162,36670
92800,2011,8,3525,300,3825,682706
93200,2011,8,807,143,950,340794
94200,2011,9,1935,100,2035,413206
94400,2014,8,4966,681,5647,787983
95000,2013,6,114,34,148,54626
95300,2011,6,682,195,877,246235
95400,2014,8,2678,155,2833,446523
95900,2011,5,153,99,252,48356
96100,2016,8,7045,1108,8153,754043
96800,2012,5,165,95,260,404730
96900,2013,5,21,16,37,17482
97000,2011,8,1484,150,1634,339780
97330,2012,8,906,114,1020,452484
98200,2011,8,1952,399,2351,1065406
98300,2012,8,968,101,1069,213463
98400,2012,8,2970,548,3518,335265
98600,2011,8,196,49,245,88003
98800,2011,8,3799,218,4017,554550
98900,2011,5,126,75,201,15773
99100,2011,4,96,269,365,114696
99120,2011,5,30,18,48,3388
99200,2011,8,97,10,107,16240
99300,2011,8,1628,261,1889,297463
99400,2011,5,146,158,304,28250
99700,2011,8,713,93,806,223790
99900,2011,8,13847,2717,16564,5226655
99910,2011,8,922,212,1134,469196
102200,2011,6,251,76,327,72893
102400,2011,5,20,9,29,14275
102600,2011,9,5168,154,5322,1105153
102810,2011,8,81,18,99,24340
104000,2011,6,142,45,187,56863
104020,2012,6,87,35,122,18474
104900,2013,6,20385,6841,27226,4419554
105000,2012,6,898,291,1189,108523
105300,2011,6,282,73,355,67693
105420,2013,6,154,42,196,25827
105600,2011,9,207331,5325,212656,13132545
105700,2011,5,70,47,117,31754
105800,2012,8,536,127,663,154398
107100,2011,9,25848,899,26747,2577876
107200,2011,8,2296,178,2474,753148
107410,2013,8,89908,9762,99670,6404450
107800,2011,8,1416,124,1540,211829
108200,2012,8,1262,227,1489,295151
108210,2011,5,169,100,269,163923
108500,2012,8,515,66,581,150153
108700,2012,6,357,147,504,370163
108710,2012,8,19943,1754,21697,1804210
109700,2011,5,53,30,83,11021
110500,2011,5,51,24,75,11517
110600,2011,5,27,26,53,10550
110610,2011,6,47,17,64,9532
110630,2012,5,23,15,38,6409
110800,2011,8,12349,1856,14205,1596369
111100,2012,8,340,75,415,89897
111300,2011,6,21,8,29,5726
111400,2011,5,181,199,380,160728
111600,2011,8,476,77,553,138384
111800,2011,6,536,148,684,210782
111900,2013,4,271,991,1262,205359
112100,2011,8,321,70,391,120153
113020,2013,8,6583,653,7236,2153213
113200,2011,9,40199,1673,41872,7172818
113400,2011,5,17657,10053,27710,5874946
113420,2012,5,3637,2788,6425,2139999
115100,2011,8,2459,177,2636,341308
115110,2012,8,1187,135,1322,248039
115120,2012,8,510,108,618,109286
115800,2016,8,3002,415,3417,251798
116100,2014,5,185,114,299,32496
116120,2011,6,106,28,134,23805
200010,2012,8,1107,196,1303,215834
200020,2011,5,116,169,285,19246
200130,2011,6,145,45,190,22225
200150,2015,5,90,105,195,9354
200170,2012,8,3428,597,4025,1730275
200190,2011,5,65,39,104,24241
200210,2012,8,20195,3857,24052,3757613
200260,2012,9,22372,994,23366,2467996
200370,2012,5,266,154,420,81571
200410,2012,5,45,45,90,28307
200550,2011,4,60,102,162,74874
200710,2012,8,27172,1507,28679,4963949
200900,2011,9,4698,217,4915,590104
200910,2011,8,1095,165,1260,150501
200940,2012,8,1918,197,2115,241011
201420,2013,8,620,119,739,147483
201510,2011,1,236,1662,1898,126375
201570,2012,6,1366,430,1796,355611
201810,2014,8,23454,2554,26008,1819928
202070,2012,8,178,37,215,32935
202130,2013,5,171,199,370,83551
202310,2012,5,476,400,876,133909
202370,2012,5,31,20,51,8726
202410,2012,8,103,20,123,28405
202530,2012,5,530,609,1139,144813
202730,2012,8,334,54,388,63976
202750,2012,6,3171,1257,4428,521355
202970,2012,8,22831,3964,26795,2998561
203140,2012,8,19955,2076,22031,2805822
203160,2013,9,77826,3230,81056,5495033
203210,2012,8,759,72,831,98665
203290,2013,6,5651,1655,7306,1823295
203350,2012,8,653,138,791,163165
203560,2012,8,197,44,241,29542
203650,2012,6,558,165,723,83454
203750,2012,8,3971,637,4608,306463
203770,2012,8,24221,3111,27332,3170312
203830,2012,8,1123,172,1295,188342
203990,2011,8,196,22,218,32140
204060,2012,6,1705,444,2149,439828
204100,2012,8,19080,3783,22863,1740909
204220,2012,6,155,63,218,108508
204240,2013,8,2636,331,2967,320817
204360,2012,9,42208,1596,43804,5555066
204440,2012,8,110,24,134,15198
204530,2014,8,1788,108,1896,189415
204580,2012,7,21,4,25,4536
204630,2014,8,1822,214,2036,280667
204760,2012,4,50,137,187,7091
204840,2012,5,47,48,95,21722
204860,2012,5,164,84,248,62294
204880,2012,8,7007,480,7487,1092043
205060,2012,5,63,47,110,32433
205070,2012,6,49,18,67,27186
205080,2013,5,62,39,101,28966
205090,2014,5,64,59,123,15670
205100,2012,9,36528,1046,37574,3700352
205230,2012,8,2490,385,2875,415904
205530,2012,5,46,35,81,40835
205610,2012,5,422,186,608,203151
205650,2012,8,1399,249,1648,188089
205690,2012,6,220,60,280,22579
205730,2012,8,520,70,590,112625
205810,2012,5,103,69,172,53980
205830,2012,8,169,14,183,15944
205910,2012,8,3255,273,3528,360126
205950,2012,8,2892,517,3409,533153
205990,2014,5,521,261,782,86204
206190,2013,9,9542,233,9775,702654
206210,2012,8,8363,1511,9874,2982059
206230,2012,5,24,15,39,2259
206370,2012,8,506,52,558,78881
206420,2013,8,47037,3961,50998,5275914
206440,2012,9,37990,1214,39204,1086773
206500,2018,8,6783,1214,7997,1823483
206690,2012,8,402,80,482,102379
207000,2013,5,78,50,128,13444
207020,2012,6,293,75,368,37217
207040,2012,8,724,156,880,137200
207080,2012,8,1455,115,1570,184842
207140,2016,8,18253,1196,19449,2753552
207170,2012,8,4305,239,4544,762137
207190,2012,5,64,64,128,15159
207230,2014,6,5281,1897,7178,1886025
207250,2012,6,326,120,446,145843
207420,2012,6,512,214,726,148590
207430,2012,5,326,318,644,125071
207610,2012,9,40968,1341,42309,2846244
207670,2012,5,27,34,61,11525
207690,2012,9,3241,110,3351,330330
207710,2012,5,24,15,39,4400
207730,2012,4,123,246,369,36181
207750,2012,8,1104,193,1297,149580
207930,2013,5,592,255,847,160193
208090,2014,8,32752,5111,37863,5224448
208140,2012,8,5361,1269,6630,1549005
208200,2012,8,3448,680,4128,604250
208400,2012,8,617,48,665,76233
208460,2012,4,11,35,46,12183
208520,2013,5,956,581,1537,275454
208580,2012,8,7015,800,7815,1529038
208600,2012,8,452,87,539,97537
208620,2012,5,52,27,79,13565
208630,2012,6,51,14,65,11789
208640,2012,7,44,5,49,11140
208650,2015,6,27501,11489,38990,1396715
208670,2012,8,1213,283,1496,151143
208710,2012,5,23,10,33,6328
208730,2012,6,1339,544,1883,272599
208750,2015,8,1986,198,2184,172935
209000,2013,8,17958,2944,20902,1851868
209060,2014,8,489,90,579,55790
209080,2012,8,11778,1031,12809,2424726
209160,2014,5,13833,10061,23894,1424741
209230,2012,8,184,37,221,18909
209330,2012,5,258,167,425,130087
209360,2012,6,39,12,51,14751
209370,2012,8,1795,116,1911,111483
209390,2012,4,15,50,65,17225
209610,2012,5,58,46,104,15167
209630,2013,8,239,42,281,21062
209650,2014,5,12415,7868,20283,1123642
209670,2012,5,2479,1149,3628,841552
209690,2012,5,119,76,195,54947
209730,2012,5,265,290,555,122753
209790,2012,8,456,56,512,123113
209850,2013,5,31,18,49,9382
209870,2012,6,11300,3699,14999,4268464
209950,2012,8,546,50,596,58044
210170,2012,6,137,54,191,81780
210490,2012,3,1,47,48,5183
210770,2013,8,10689,1112,11801,2602292
210870,2013,8,159,15,174,24244
210950,2012,8,487,35,522,45117
210970,2016,8,5493,1046,6539,494237
211160,2012,5,755,907,1662,300593
211180,2012,8,355,26,381,41357
211260,2012,8,1828,286,2114,215520
211280,2013,5,165,117,282,39209
211340,2012,8,749,86,835,65990
211360,2012,8,430,89,519,147698
211400,2012,8,8581,2134,10715,795749
211420,2012,8,59608,5624,65232,3289250
211440,2012,8,907,142,1049,102718
211580,2012,5,239,221,460,178229
211800,2012,6,88,29,117,23741
211820,2016,8,64838,6605,71443,4309358
212010,2012,6,965,336,1301,144458
212030,2012,6,761,195,956,87591
212050,2012,8,335,28,363,37904
212070,2013,6,7738,2335,10073,1960641
212110,2012,6,134,47,181,33044
212480,2013,9,9416,493,9909,1232451
212700,2012,5,92,86,178,46642
212780,2012,5,183,101,284,24499
213610,2012,8,3814,658,4472,416375
213650,2012,8,1229,202,1431,720104
213670,2014,9,32620,801,33421,2533584
213850,2013,8,3492,746,4238,945492
214100,2012,5,27,25,52,13942
214130,2012,5,82,45,127,14219
214190,2014,5,2406,1563,3969,242221
214340,2012,8,6368,709,7077,743347
214360,2012,6,1138,409,1547,393962
214420,2015,6,5571,1928,7499,1922501
214510,2012,8,3107,320,3427,582228
214550,2014,8,443,106,549,223070
214570,2012,6,175,51,226,42020
214590,2012,8,838,131,969,99774
214630,2012,5,123,90,213,39096
214730,2013,9,2903,141,3044,168841
214770,2013,8,4607,299,4906,538061
214790,2012,8,736,128,864,246622
214830,2012,8,1083,157,1240,309617
214870,2012,6,1997,602,2599,625428
214910,2012,5,159,189,348,61698
214950,2013,6,27397,7235,34632,3350407
214970,2012,8,893,173,1066,175830
215080,2014,6,3686,1118,4804,1036289
215390,2012,5,6,6,12,3445
215470,2012,6,4027,1167,5194,731052
215510,2012,6,1912,503,2415,286849
215530,2013,8,4786,966,5752,726646
215630,2013,5,442,214,656,86817
215670,2012,5,1013,480,1493,183321
215690,2013,6,719,231,950,146186
215710,2013,8,259,53,312,51792
215770,2012,5,50,42,92,17947
215870,2013,5,143,212,355,229648
216090,2013,8,326,18,344,27792
216110,2012,8,644,152,796,81320
216130,2012,4,28,97,125,28943
216260,2014,8,416,34,450,23321
216290,2012,8,165,13,178,20286
216890,2012,8,1074,255,1329,253538
216910,2012,6,791,304,1095,128256
217100,2013,5,391,446,837,50745
217140,2013,5,1351,617,1968,272986
217270,2012,6,120,47,167,14384
217290,2012,8,123,21,144,19651
217690,2013,5,836,445,1281,163293
217790,2012,6,348,138,486,68917
218060,2013,8,2447,203,2650,358624
218410,2012,9,2571,85,2656,179979
218510,2012,6,381,163,544,325744
218620,2013,8,265676,48200,313876,18643807
218620,2013,8,265676,48200,313876,18643807
218640,2012,8,4934,1180,6114,596725
218660,2012,6,107,27,134,20457
218680,2012,8,5742,460,6202,1296525
218740,2012,8,1894,333,2227,278689
218820,2014,6,1415,577,1992,307315
219150,2012,9,39104,959,40063,2584720
219190,2013,8,512,54,566,66302
219200,2013,8,253,49,302,61886
219340,2013,6,553,182,735,346032
219640,2012,8,46448,9497,55945,8260157
219700,2014,5,435,242,677,225215
219830,2013,8,2743,547,3290,348064
219910,2012,8,1456,135,1591,219442
219950,2012,8,465,65,530,63403
219990,2016,8,21546,1725,23271,1464229
220260,2013,8,3769,342,4111,590518
220440,2013,8,12340,704,13044,987543
220460,2012,8,601,132,733,102678
220740,2012,8,1228,106,1334,249600
220780,2012,8,7140,390,7530,581719
220820,2012,8,1883,340,2223,228360
220900,2013,5,203,121,324,58672
221040,2013,8,12281,3024,15305,1317100
221180,2014,8,316,34,350,57425
221380,2013,8,45226,2622,47848,5824316
221540,2014,8,1477,333,1810,206227
221640,2012,9,18102,542,18644,1045138
221810,2013,8,1528,231,1759,271663
221830,2012,8,244,46,290,40059
222140,2012,6,303,113,416,99411
222180,2015,6,18,7,25,7251
222420,2014,8,753,147,900,95954
222440,2015,8,763,59,822,109446
222480,2013,8,4238,771,5009,503330
222640,2013,6,445,131,576,50924
222660,2013,8,277,44,321,49592
222730,2013,8,3340,808,4148,897320
222880,2014,8,74283,7029,81312,6007744
222940,2013,8,3772,468,4240,456361
223000,2012,8,139,23,162,13944
223100,2016,5,5434,4415,9849,600976
223220,2012,6,1192,301,1493,335909
223330,2012,6,824,236,1060,41558
223410,2014,6,439,182,621,27840
223430,2012,4,104,200,304,58437
223450,2013,6,162,46,208,24535
223470,2012,9,29051,1427,30478,1911217
223510,2012,6,695,195,890,92256
223730,2012,8,365,57,422,75324
223810,2013,8,964,119,1083,140737
224040,2014,6,186,52,238,8596
224260,2013,8,42230,4850,47080,7144320
224460,2013,8,3661,374,4035,182422
224480,2014,8,5606,412,6018,581181
224760,2013,8,9685,816,10501,1276275
224820,2013,9,1184,43,1227,126909
224860,2013,4,222,463,685,112755
224900,2012,5,293,212,505,241819
225080,2013,9,29593,1509,31102,1056557
225160,2013,8,1601,126,1727,278226
225260,2013,8,11241,748,11989,1235714
225280,2014,8,915,151,1066,198642
225360,2013,5,410,445,855,79909
225420,2013,5,1040,793,1833,451407
225540,2015,6,26990,10656,37646,2345094
225600,2014,6,2636,1043,3679,610347
226100,2015,6,455,164,619,66298
226560,2014,5,465,328,793,46439
226580,2014,6,982,289,1271,168191
226620,2013,8,993,92,1085,122321
226720,2013,5,1441,909,2350,279675
226780,2013,5,35,41,76,9808
226820,2013,8,53,4,57,10960
226840,2014,8,4040,934,4974,764290
226860,2015,6,5533,1669,7202,476035
227000,2012,9,1643,38,1681,83704
227020,2013,5,177,133,310,66332
227060,2014,5,216,137,353,54697
227080,2013,8,2296,147,2443,127734
227100,2013,8,2962,391,3353,577105
227180,2013,5,1556,759,2315,359640
227200,2012,8,877,104,981,84676
227220,2013,8,1413,188,1601,193849
227300,2012,9,133355,3620,136975,5982548
227380,2013,6,288,75,363,50466
227400,2013,5,313,302,615,219519
227480,2013,6,1576,669,2245,322132
227560,2014,5,313,158,471,60247
227580,2013,8,1481,172,1653,132502
227600,2013,8,1136,109,1245,123527
227780,2019,8,1160,122,1282,167773
227800,2013,6,114,39,153,100395
227860,2017,5,2341,2106,4447,275014
228280,2013,8,3652,593,4245,745407
228300,2013,8,8042,1523,9565,587213
228320,2013,5,88,91,179,56578
228360,2017,8,867,54,921,61757
228400,2013,5,2482,1772,4254,527228
228440,2013,6,131,53,184,60640
228960,2013,8,448,54,502,121166
229480,2013,8,694,160,854,169249
229520,2013,5,306,173,479,77010
229580,2015,5,505,351,856,76847
229810,2015,5,269,123,392,71209
229890,2013,8,61,12,73,22281
230050,2013,8,5099,665,5764,425947
230070,2015,8,1488,311,1799,96114
230150,2013,6,219,86,305,64688
230190,2015,8,3527,631,4158,363113
230230,2014,8,10129,902,11031,1208170
230270,2016,9,1389,62,1451,118689
230310,2014,4,104,192,296,32717
230410,2013,8,161067,15293,176360,16332217
230410,2013,8,161067,15293,176360,16332217
230650,2013,5,112,130,242,41411
230700,2013,8,1349,285,1634,193073
230840,2014,5,723,739,1462,77822
230860,2014,8,542,50,592,66022
231020,2013,6,62,25,87,13973
231160,2013,9,5330,210,5540,484015
231310,2013,5,259,165,424,58523
231330,2013,6,1309,497,1806,252514
231430,2013,6,27036,8955,35991,4654955
231720,2013,4,118,232,350,46803
231740,2013,8,2148,395,2543,342008
231910,2013,8,312,78,390,56138
232050,2013,5,1187,582,1769,595663
232090,2016,8,47871,6839,54710,3980635
232430,2013,6,11281,3367,14648,538219
232450,2016,5,748,381,1129,237212
232750,2013,6,1299,470,1769,191401
232770,1997,8,1965,436,2401,258861
232790,2014,8,5048,1004,6052,419666
232890,2014,5,3458,2359,5817,828019
232950,2013,5,309,323,632,110174
232970,2013,8,355,57,412,46979
233110,2013,4,58,90,148,19264
233130,2013,8,16645,1170,17815,1648323
233150,2014,8,2917,283,3200,314885
233190,2013,8,678,123,801,131849
233210,2013,4,54,157,211,20857
233230,2013,6,1055,357,1412,107362
233290,2014,8,7053,1366,8419,514458
233310,2013,8,101,17,118,19579
233450,2015,8,27015,1874,28889,2856218
233470,2013,8,4184,822,5006,431669
233510,2009,5,101,53,154,30085
233550,2013,8,1083,209,1292,89421
233610,2018,8,3103,185,3288,169523
233700,2013,8,1003,149,1152,192814
233720,2013,8,10068,2097,12165,1879150
233740,2013,8,2031,258,2289,359935
233840,2013,6,1519,498,2017,840770
233980,2014,8,5384,389,5773,446738
234080,2013,8,3425,805,4230,379043
234140,2015,8,29985,3026,33011,1775140
234160,2013,8,425,70,495,133318
234270,2017,8,634,47,681,58710
234290,2013,5,239,129,368,46491
234390,2013,8,2015,329,2344,453247
234490,2013,5,515,325,840,120088
234630,2015,6,7952,2427,10379,974136
234670,2013,8,7542,769,8311,671888
234710,2013,8,4157,735,4892,671540
234820,2013,6,169,70,239,9892
234900,2013,8,799,148,947,117410
234920,2015,6,316,83,399,40365
234940,2013,6,899,279,1178,162206
235070,2013,5,128,102,230,12329
235210,2014,8,1965,361,2326,292888
235250,2013,8,1214,155,1369,154250
235320,2014,8,802,56,858,55911
235360,2013,6,634,190,824,94101
235380,2017,5,2155,1572,3727,129872
235460,2014,8,12041,973,13014,691324
235540,2015,8,13067,3206,16273,1843514
235720,2013,6,311,96,407,53469
235800,2015,8,3338,600,3938,324405
235820,2013,8,476,94,570,66045
235980,2013,8,350,10,360,32924
236010,2016,5,16,13,29,4923
236090,2013,9,14207,554,14761,943681
236110,2017,6,9170,3228,12398,2642504
236130,2014,5,237,165,402,53052
236150,2014,6,2495,1017,3512,586707
236290,2013,6,19,5,24,2893
236370,2013,5,4198,2715,6913,1140120
236390,2013,8,67266,16297,83563,9536732
236430,2014,8,27777,3421,31198,1266678
236450,2013,9,5481,262,5743,1102937
236470,2014,5,109,70,179,14207
236490,2013,5,16,12,28,5199
236690,2015,6,2395,903,3298,294476
236730,2013,8,445,99,544,147089
236790,2013,4,136,464,600,49982
236850,2013,8,31870,6296,38166,1983657
236870,2016,6,17138,4724,21862,1534824
236930,2014,8,450,9,459,20146
237350,2015,6,178,64,242,33213
237370,2013,6,252,106,358,14572
237430,2013,8,835,188,1023,130612
237470,2013,5,148,73,221,36396
237550,2013,5,157,130,287,34258
237630,2013,8,2897,462,3359,255766
237740,2013,8,2231,271,2502,137144
237760,2013,8,330,25,355,29074
237850,2017,8,2481,472,2953,186701
237870,2016,5,3587,1598,5185,369351
237890,2014,6,1134,408,1542,193030
237930,2014,9,19980,1002,20982,1329184
237970,2014,6,48,18,66,8162
237990,2014,8,8984,993,9977,747734
238010,2013,8,10996,981,11977,1358070
238090,2014,6,10800,2725,13525,1810081
238240,2015,4,906,1471,2377,217625
238260,2013,6,2046,728,2774,555716
238280,2013,6,1028,359,1387,208032
238320,2013,9,38528,1565,40093,2813619
238370,2015,6,3623,1103,4726,857543
238430,2013,6,8427,3205,11632,1616994
238460,2014,9,40829,1010,41839,3605148
238530,2013,8,340,31,371,37103
238630,2013,6,174,58,232,31943
238870,2013,2,59,341,400,36837
238890,2013,5,119,154,273,73154
238910,2013,6,623,203,826,215330
238960,2013,8,53700,4554,58254,7634137
239030,2013,9,21692,888,22580,2306775
239070,2013,8,4750,512,5262,957659
239090,2013,8,318,20,338,23969
239120,2014,8,897,216,1113,159583
239140,2015,8,57374,4146,61520,3467531
239160,2014,6,8852,3761,12613,1313521
239200,2013,5,3561,1832,5393,554955
239250,2014,8,2068,397,2465,170731
239350,2013,8,7501,704,8205,906689
239430,2014,8,1050,191,1241,120472
239660,2013,6,1543,393,1936,552866
239700,2013,8,425,65,490,38130
239720,2013,8,111,25,136,10365
239800,2013,8,1517,109,1626,118588
239820,2013,9,23837,1125,24962,1696896
239840,2014,6,1319,477,1796,112025
240340,2013,8,72,7,79,6999
240360,2013,7,40,9,49,5436
240440,2016,8,392,42,434,26507
240600,2013,6,359,136,495,46800
240620,2015,5,122,76,198,26372
240660,2013,5,100,43,143,7998
240720,2017,6,7782,1956,9738,948332
240760,2014,8,5928,1224,7152,626811
240970,2014,8,387,29,416,60456
241240,2014,8,856,76,932,227376
241260,2014,8,1709,138,1847,142209
241300,2017,8,51,7,58,2260
241320,2013,8,885,60,945,84014
241410,2013,8,1066,120,1186,169190
241540,2013,8,14475,2620,17095,1083514
241600,2013,8,12925,803,13728,1479581
241720,2013,5,554,572,1126,119191
241760,2016,6,107,34,141,10282
241910,2013,8,1161,144,1305,168319
241930,2014,8,46639,3936,50575,4468234
242110,2013,5,192,139,331,138895
242130,2015,5,288,255,543,25982
242530,2013,5,187,103,290,54172
242640,2014,8,3949,820,4769,485922
242680,2015,9,8218,314,8532,492848
242700,2013,8,7907,1259,9166,1279176
242720,2014,5,6363,3148,9511,1895812
242760,2018,8,85507,6544,92051,5552274
242780,2013,8,468,86,554,54814
242820,2013,8,3040,203,3243,136754
242840,2015,8,967,217,1184,75190
242860,2015,8,19702,3714,23416,1149077
242920,2014,8,22678,2383,25061,2147445
243120,2014,8,2317,501,2818,217097
243160,2015,8,394,80,474,69255
243200,2013,8,1165,117,1282,186812
243220,2014,8,433,65,498,31614
243280,2013,6,145,39,184,26669
243450,2013,8,1094,251,1345,144452
243780,2013,6,583,173,756,142088
243800,2013,8,2232,342,2574,225513
243930,2014,5,1683,860,2543,169288
243950,2013,6,1174,368,1542,265816
243970,2015,8,3210,227,3437,393703
244030,2017,5,769,565,1334,87217
244050,2013,5,644,547,1191,202778
244070,2013,5,371,164,535,159001
244090,2013,5,195,109,304,126366
244160,2015,8,4919,747,5666,728091
244210,2014,8,12522,1689,14211,826288
244430,2014,8,458,92,550,98490
244450,2014,8,9125,1557,10682,1019383
244590,2014,5,738,376,1114,332826
244690,2013,5,148,67,215,41186
244730,2013,8,1328,241,1569,201978
244750,2017,8,75,10,85,4694
244810,2013,8,454,98,552,84629
244850,2019,8,52959,7421,60380,4204751
244870,2013,8,2824,273,3097,192896
244890,2013,6,129,37,166,33398
244930,2020,5,6205,3010,9215,1487372
244950,2014,6,118,30,148,12995
245050,2014,5,81,96,177,47719
245170,2013,8,12074,735,12809,1621794
245280,2013,8,3304,582,3886,242618
245300,2014,5,78,54,132,14521
245370,2015,4,297,488,785,231517
245470,2013,6,4074,1377,5451,688243
245620,2014,6,6759,1923,8682,1718552
246110,2015,6,1017,408,1425,161770
246300,2013,5,266,145,411,32036
246420,2014,9,4550,155,4705,299922
246580,2013,8,2175,318,2493,244364
246620,2016,8,16793,1096,17889,2002770
246680,2014,5,252,147,399,43521
246720,2014,4,27,48,75,3813
246760,2015,6,940,267,1207,112235
246800,2014,4,30,46,76,14550
246840,2013,8,755,68,823,82615
246900,2015,8,5635,431,6066,701439
246920,2017,8,98,8,106,10974
246940,2014,2,70,283,353,19077
246960,2013,8,245,47,292,66040
247000,2014,6,2623,842,3465,601352
247020,2013,8,3916,208,4124,384598
247080,2015,9,12283,403,12686,1122748
247140,2013,8,526,50,576,51526
247240,2013,8,1588,356,1944,203278
247310,2013,5,34,49,83,18258
247370,2013,6,292,99,391,47605
247660,2013,5,1823,812,2635,149712
247870,2013,5,147,208,355,28391
247910,2013,8,2832,493,3325,485909
247950,2014,4,874,2710,3584,183744
248190,2013,8,259,38,297,47072
248290,2013,5,211,93,304,27168
248310,2014,9,3226,138,3364,169651
248330,2015,8,485,43,528,41994
248390,2014,8,6193,822,7015,509631
248410,2013,4,74,187,261,22483
248450,2013,5,133,75,208,21683
248470,2013,5,334,171,505,60783
248530,2014,6,596,204,800,106361
248550,2013,8,792,88,880,72851
248570,2014,8,9510,1280,10790,2371160
248610,2014,8,4841,263,5104,549148
248630,2013,5,455,559,1014,55436
248650,2013,6,719,227,946,132320
248710,2013,4,179,433,612,39151
248730,2013,8,285,63,348,17686
248800,2013,6,585,173,758,30160
248820,2013,8,20449,1261,21710,1825993
248970,2013,8,484,79,563,36519
249050,2014,8,6596,806,7402,1080885
249130,2013,8,7658,548,8206,991243
249190,2014,5,129,158,287,40240
249230,2014,6,2441,997,3438,342772
249330,2013,8,1061,121,1182,142244
249360,2013,5,268,121,389,39750
249590,2013,8,1294,187,1481,136458
249610,2014,5,38,34,72,28560
249630,2018,8,1651,218,1869,126220
249650,2014,5,1528,943,2471,305941
249680,2013,8,1608,131,1739,68424
249870,2013,8,1107,220,1327,226289
249950,2015,8,398,73,471,53741
249990,2013,6,1726,569,2295,603718
250050,2014,9,913,29,942,80425
250070,2015,7,12,2,14,958
250110,2015,9,1183,60,1243,73905
250180,2014,8,4728,500,5228,651482
250260,2014,8,3677,350,4027,239119
250320,2013,9,19561,472,20033,1011210
250340,2013,6,3083,1219,4302,226915
250380,2013,8,825,124,949,70847
250400,2014,8,11872,2400,14272,1514177
250420,2015,5,2534,1737,4271,934749
250460,2013,6,763,249,1012,247455
250520,2015,8,1244,188,1432,84245
250560,2014,6,923,233,1156,149949
250580,2014,5,894,405,1299,151964
250600,2014,8,18125,1534,19659,115204
250620,2014,8,3457,531,3988,194268
250640,2014,8,253,56,309,27093
250660,2013,5,198,96,294,23337
250700,2014,8,627,66,693,96030
250760,2014,9,8276,257,8533,583872
250900,2014,9,62009,1337,63346,2756509
251110,2016,8,527,68,595,16562
251130,2015,8,2361,165,2526,217211
251150,2014,8,3068,269,3337,254152
251170,2014,6,2351,894,3245,337285
251210,2014,8,165,18,183,25610
251230,2016,6,260,78,338,28088
251270,2016,8,364,26,390,24226
251290,2015,9,966,21,987,37625
251390,2014,5,118,55,173,15776
251410,2013,5,73,103,176,17359
251430,2013,8,510,35,545,56620
251450,2016,4,66,104,170,36062
251470,2014,8,1712,106,1818,213889
251490,2015,8,251,7,258,13862
251510,2014,8,43,7,50,5747
251530,2013,6,388,100,488,95497
251570,2013,8,51025,10923,61948,4184553
251630,2014,8,821,137,958,76220
251690,2013,5,323,177,500,78056
251730,2014,8,1904,187,2091,260443
251810,2014,6,196,65,261,20418
251830,2013,9,517,26,543,26673
251850,2013,6,449,129,578,45793
251870,2014,8,2116,296,2412,131504
251890,2014,5,306,224,530,31530
251910,2013,6,200,61,261,74075
251990,2013,8,5307,281,5588,369384
252010,2014,8,524,103,627,73922
252030,2013,8,1828,300,2128,163754
252090,2017,8,53,10,63,2410
252110,2015,9,1506,79,1585,223795
252130,2015,8,601,46,647,61729
252170,2013,8,227,53,280,65310
252230,2014,5,217,100,317,22219
252270,2013,5,150,85,235,40491
252290,2014,5,162,80,242,32916
252310,2013,8,514,88,602,72227
252330,2013,8,3705,470,4175,354224
252370,2013,8,428,94,522,38128
252410,2013,8,3741,273,4014,367286
252430,2014,5,60,89,149,24801
252450,2015,5,953,691,1644,79276
252470,2017,8,1503,362,1865,100689
252490,2018,8,180850,40762,221612,9147240
252550,2014,8,467,57,524,32452
252570,2014,5,242,127,369,28516
252630,2013,8,1407,189,1596,186765
252710,2013,8,158,30,188,20296
252750,2014,8,180,22,202,27622
252830,2014,5,196,85,281,29691
252850,2016,6,1405,518,1923,249845
252890,2013,8,91,18,109,10460
252950,2015,8,181782,17822,199604,10110342
252970,2014,6,96,29,125,12753
253030,2013,8,4800,305,5105,615654
253050,2015,6,273,107,380,152
253110,2013,8,3109,219,3328,116526
253150,2014,6,389,106,495,39748
253190,2016,5,582,306,888,64602
253230,2017,9,7338,100,7438,187728
253290,2014,8,530,64,594,54843
253310,2013,6,76,20,96,6098
253330,2014,6,1342,464,1806,82996
253350,2013,8,163,27,190,18091
253370,2013,5,223,115,338,55809
253390,2015,5,108,52,160,26399
253430,2014,6,3734,1519,5253,451422
253510,2014,5,442,549,991,118265
253610,2014,6,328,125,453,34325
253630,2014,5,158,141,299,75100
253650,2013,6,1288,483,1771,228198
253690,2013,6,304,85,389,60734
253710,2014,5,10194,13312,23506,3979429
253750,2014,9,1245,61,1306,128543
253790,2014,8,160,34,194,16121
253840,2016,8,1501,136,1637,73427
254200,2015,6,1555,525,2080,146448
254300,2016,6,124,48,172,36236
254440,2013,8,2193,230,2423,255171
254460,2014,8,545,36,581,47510
254480,2014,6,209,54,263,20179
254700,2014,8,8843,1590,10433,704953
255070,2014,5,1275,760,2035,308646
255220,2014,6,4500,1416,5916,583602
255260,2014,5,152,76,228,32096
255280,2014,6,608,225,833,86051
255300,2013,8,903,117,1020,91947
255320,2013,8,623,138,761,137882
255340,2014,8,291,6,297,25763
255370,2014,5,459,236,695,73927
255390,2014,8,901,48,949,38925
255420,2014,5,1719,2161,3880,303768
255520,2013,8,2091,500,2591,2418851
255710,2015,8,53369,4186,57555,6132366
255870,2013,8,409,39,448,91301
256010,2014,5,307,363,670,33082
256030,2014,5,216,120,336,31114
256070,2013,6,120,45,165,10853
256190,2014,5,1807,1069,2876,179268
256330,2013,5,526,294,820,61200
256370,2014,6,599,157,756,55960
256390,2014,5,190,194,384,24034
256460,2017,8,316,34,350,16200
257050,2013,5,391,368,759,81026
257120,2013,6,401,101,502,99729
257170,2015,8,830,142,972,112346
257260,2014,8,50,4,54,2859
257350,2013,8,2185,358,2543,420031
257510,2014,9,14880,637,15517,927932
257630,2014,5,127,145,272,12462
257690,2014,8,569,87,656,27939
257750,2013,8,2117,389,2506,380476
257770,2013,5,45,29,74,8132
257790,2014,8,324,43,367,29142
257830,2013,5,417,241,658,113871
257850,2016,8,9406,565,9971,595090
257970,2014,8,350,85,435,51479
257990,2013,8,524,87,611,56336
258050,2015,5,493,249,742,123764
258090,2013,5,200,144,344,47240
258180,2014,4,895,1924,2819,181210
258220,2013,5,369,250,619,46327
258520,2014,8,6430,768,7198,379237
258590,2014,6,281,97,378,27585
258890,2013,6,1069,269,1338,90983
258910,2015,6,219,63,282,58460
258950,2013,5,230,155,385,35112
258970,2014,6,4568,1311,5879,999905
259080,2013,8,10771,946,11717,2625503
259410,2014,8,225,28,253,13382
259430,2013,6,167,57,224,26688
259470,2014,5,50,23,73,19157
259510,2013,8,399,70,469,118220
259530,2013,8,2292,157,2449,139558
259550,2013,8,2633,212,2845,128807
259600,2013,8,668,137,805,66126
259640,2014,4,57,127,184,11174
259660,2015,5,193,103,296,34279
259680,2013,9,2450,108,2558,176493
259700,2013,4,79,137,216,18918
259720,2014,5,126,64,190,17685
259740,2014,8,1006,75,1081,95731
259810,2014,8,92,5,97,6056
259830,2013,5,59,45,104,16273
259870,2014,8,257,62,319,22710
260130,2014,6,228,70,298,52410
260160,2014,8,438,98,536,46923
260250,2013,5,339,220,559,49146
260330,2014,6,110,36,146,27700
260380,2014,5,23,12,35,3240
260410,2014,6,1031,367,1398,173460
260430,2015,5,1957,843,2800,256424
260530,2014,8,75,6,81,4265
260790,2014,8,410,94,504,48483
261030,2013,9,19248,846,20094,1054661
261110,2014,6,4216,1311,5527,546981
261180,2014,8,4392,277,4669,714007
261470,2014,6,808,223,1031,72321
261490,2015,6,495,163,658,57145
261530,2014,6,1986,580,2566,90290
261570,2015,9,24272,869,25141,997767
261600,2014,3,9,39,48,2261
261640,2014,8,13673,3145,16818,2176285
261680,2014,6,248,69,317,13539
261700,2013,8,1021,143,1164,50275
261720,2014,5,67,50,117,12619
261740,2014,5,32,17,49,4625
261760,2014,5,1314,922,2236,233763
261920,2014,5,43,58,101,7036
261940,2013,6,55,20,75,7379
261960,2014,5,73,43,116,8805
262000,2014,8,496,50,546,42031
262060,2016,8,32758,5145,37903,2214527
262080,2014,2,9,44,53,5254
262120,2016,6,454,152,606,70300
262190,2015,6,118,31,149,5463
262210,2014,8,154,31,185,23313
262240,2014,8,112,15,127,22275
262260,2014,8,858,117,975,69256
262280,2015,6,2702,700,3402,584679
262300,2012,5,30,18,48,9740
262390,2014,8,662,105,767,75165
262410,2014,8,8946,1908,10854,2367076
262450,2014,8,295,47,342,18734
262470,2014,8,404,45,449,48769
262510,2016,6,28,11,39,1371
262550,2014,8,571,73,644,32375
262590,2014,8,134,21,155,15739
262610,2014,5,16,12,28,1987
262630,2016,7,12,2,14,501
262690,2014,8,651,134,785,103355
262750,2014,5,203,89,292,29487
262770,2014,8,322,23,345,21370
262790,2014,8,520,115,635,25868
262810,2017,5,66,53,119,7210
262900,2014,6,181,66,247,29269
262920,2014,5,14,12,26,11849
262940,2013,8,1359,185,1544,152508
262960,2015,6,761,191,952,50619
262980,2014,4,22,73,95,4411
263020,2014,8,523,55,578,90046
263040,2014,5,60,26,86,2156
263060,2015,8,4662,1069,5731,499027
263080,2014,5,142,70,212,30406
263200,2014,6,434,112,546,44486
263320,2014,8,361,85,446,91804
263380,2014,8,184,22,206,15123
263400,2014,8,394,56,450,41661
263420,2014,5,166,191,357,41709
263460,2014,6,141,55,196,38944
263480,2014,5,68,74,142,9100
263500,2014,6,2207,643,2850,870310
263520,2014,5,81,35,116,13069
263560,2014,8,408,90,498,59586
263620,2014,8,2247,478,2725,154061
263640,2015,5,33,49,82,6098
263680,2014,5,392,346,738,20590
263700,2014,6,272,78,350,23116
263720,2018,6,236,94,330,20480
263740,2014,8,755,139,894,99828
263760,2014,8,3269,293,3562,402549
263820,2014,8,504,63,567,41675
263860,2014,6,207,80,287,68038
263880,2014,8,340,46,386,31529
263920,2015,6,193,75,268,16341
263980,2016,8,5641,397,6038,521927
264000,2015,5,120,70,190,15950
264020,2014,5,11,5,16,2193
264060,2014,8,147,26,173,28965
264140,2014,5,4069,2139,6208,618061
264160,2014,8,396,57,453,29198
264200,2014,9,12815,201,13016,673342
264220,2014,8,182,28,210,18023
264240,2014,6,972,362,1334,216703
264260,2014,6,42,16,58,13785
264280,2014,5,318,193,511,59295
264300,2014,6,621,254,875,99031
264340,2014,8,211,40,251,25909
264380,2015,8,2545,156,2701,194502
264440,2014,3,3,14,17,645
264460,2014,5,19,26,45,9025
264520,2014,6,145,53,198,17520
264540,2014,5,180,91,271,49953
264560,2014,8,108,19,127,28702
264710,2018,8,64938,4013,68951,2866791
264730,2014,6,1030,342,1372,113135
265000,2016,8,434,63,497,38487
265170,2014,8,160,30,190,25999
265210,2013,8,3086,317,3403,555426
265240,2014,4,6,14,20,5946
265300,2014,5,6286,4082,10368,742534
265380,2014,5,148,71,219,77223
265470,2016,8,95,14,109,2148
265590,2015,6,1302,454,1756,668962
265610,2014,9,1839,72,1911,122369
265630,2014,8,19862,1879,21741,2973385
265670,2014,4,136,282,418,29873
265750,2015,6,926,354,1280,126146
265770,2014,4,123,379,502,156479
265790,2014,5,52,28,80,14577
265810,2015,5,287,182,469,30215
265830,2014,6,388,138,526,24339
265890,2014,9,3172,116,3288,163322
265930,2014,8,40659,4943,45602,4065978
265950,2014,6,263,87,350,32549
265970,2015,5,213,230,443,22318
265990,2014,5,197,90,287,13569
266010,2014,9,6236,231,6467,298463
266050,2014,5,87,106,193,31094
266090,2014,4,71,113,184,49162
266110,2014,8,741,153,894,137156
266130,2014,8,1473,298,1771,183440
266150,2014,5,372,240,612,134507
266210,2014,8,3176,181,3357,315869
266230,2014,8,342,63,405,35043
266250,2014,8,96,12,108,13126
266310,2015,6,705,243,948,61054
266330,2014,5,127,78,205,42224
266370,2014,5,44,53,97,47462
266390,2014,8,405,91,496,40805
266430,2014,5,1354,612,1966,355332
266470,2014,5,32,18,50,2623
266490,2014,8,746,107,853,47147
266510,2015,8,7536,681,8217,624982
266840,2014,8,7984,1324,9308,1369504
267060,2013,5,250,156,406,58483
267340,2014,6,165,70,235,33135
267490,2014,4,508,783,1291,155024
267530,2014,8,1554,311,1865,336631
267730,2014,5,15,20,35,7942
267750,2015,5,728,384,1112,99330
268050,2014,8,8983,1983,10966,740543
268200,2014,5,143,118,261,33861
268220,2014,8,598,100,698,53407
268240,2014,8,617,94,711,122647
268260,2014,5,60,62,122,4626
268320,2015,8,232,22,254,25053
268340,2015,7,14,3,17,3483
268360,2016,5,149,68,217,14600
268400,2014,8,914,67,981,105467
268500,2016,8,23517,5428,28945,2222475
268520,2014,5,29,31,60,4807
268540,2014,6,653,226,879,161751
268650,2020,8,3298,397,3695,98801
268770,2018,8,89,5,94,2262
268810,2014,6,189,58,247,27319
268850,2014,6,1389,454,1843,730012
268870,2015,5,2134,941,3075,592993
268910,2017,9,29947,1151,31098,1735419
268930,2019,6,50,20,70,2422
268970,2015,4,8,13,21,1257
268990,2017,8,305,13,318,17174
269010,2014,6,85,34,119,10254
269050,2014,8,1381,127,1508,73734
269110,2014,6,294,96,390,56845
269170,2016,8,596,51,647,63858
269210,2014,6,12832,3310,16142,1502327
269270,2014,8,860,86,946,49625
269310,2016,5,406,194,600,48803
269370,2014,5,236,116,352,33974
269430,2014,3,4,32,36,12500
269490,2014,8,1174,141,1315,96970
269530,2014,5,32,47,79,3711
269630,2015,5,19,19,38,1771
269650,2015,8,1270,192,1462,78398
269670,2015,8,928,170,1098,116937
269710,2016,6,506,132,638,161430
269730,2014,5,623,350,973,53284
269770,2015,8,3070,208,3278,208388
269790,2014,6,2072,639,2711,157469
269810,2014,6,248,95,343,10521
269890,2014,5,233,163,396,50730
269990,2015,5,59,27,86,13264
270010,2014,8,250,33,283,17855
270050,2014,6,425,127,552,61865
270070,2016,5,30,14,44,1343
270110,2015,5,226,135,361,16101
270130,2016,8,1108,163,1271,92049
270150,2015,8,4507,592,5099,468632
270190,2014,5,101,61,162,7469
270210,2016,8,3748,255,4003,156009
270230,2015,8,60,9,69,1831
270270,2016,5,320,145,465,25521
270330,2014,4,23,60,83,16462
270410,2016,5,22,26,48,3830
270430,2014,4,4,16,20,563
270450,2015,8,2821,213,3034,396373
270490,2014,8,172,43,215,30697
270510,2014,6,34,11,45,2383
270550,2014,8,8697,1293,9990,1208380
270570,2014,6,1078,319,1397,132300
270590,2014,5,39,37,76,2925
270630,2014,8,780,157,937,67923
270810,2015,5,100,53,153,26195
270950,2014,6,181,59,240,31203
271240,2016,6,2512,801,3313,499550
271360,2015,8,324,80,404,58172
271370,2014,5,106,113,219,28617
271550,2014,8,195,37,232,76339
271570,2014,6,1111,381,1492,285436
271590,2015,6,254544,108090,362634,12604123
271640,2014,4,134,285,419,158376
271670,2014,8,539,84,623,51934
271730,2014,5,181,129,310,21281
271820,2014,8,713,77,790,72496
271900,2014,8,1165,71,1236,97398
271920,2016,8,255,38,293,106888
271970,2016,8,134,13,147,8280
271990,2015,7,34,3,37,5669
272010,2014,5,55,35,90,14478
272270,2017,5,1835,862,2697,206681
272330,2015,8,208,29,237,21381
272470,2014,5,1154,572,1726,254601
272510,2014,8,3602,893,4495,363459
272600,2014,8,1037,59,1096,35753
272620,2017,8,186,26,212,11886
272890,2015,5,547,381,928,136011
272990,2014,5,137,61,198,9281
273030,2014,4,31,119,150,12988
273070,2014,6,288,95,383,83090
273110,2014,5,18693,10018,28711,5222958
273240,2014,6,129,52,181,18641
273350,2015,5,26801,13422,40223,4826928
273500,2015,8,750,135,885,93823
273730,2014,4,35,124,159,9399
273740,2014,2,6,53,59,2964
273800,2016,5,37,53,90,11336
273830,2014,2,11,50,61,7806
273890,2016,3,4,25,29,1360
273960,2015,5,51,70,121,8049
274010,2014,5,44,42,86,30211
274130,2014,5,242,201,443,14359
274170,2015,8,17203,1601,18804,1037686
274190,2015,9,26569,847,27416,1863667
274230,2015,5,1043,471,1514,78090
274250,2014,6,559,145,704,108996
274270,2016,8,1358,181,1539,146959
274290,2014,6,1478,595,2073,227034
274310,2014,6,1563,505,2068,207363
274350,2015,8,1035,61,1096,59822
274480,2014,8,211,20,231,19787
274500,2016,8,1309,89,1398,94477
274520,2017,8,2844,154,2998,171170
274560,2014,6,1290,474,1764,371346
274700,2015,8,61,3,64,4166
274880,2014,5,87,38,125,9374
274900,2014,8,3549,663,4212,421780
274920,2015,8,3277,601,3878,589693
274940,2014,8,18793,2819,21612,1853782
274980,2014,6,663,219,882,113112
275060,2015,4,49,171,220,6894
275100,2015,8,2251,473,2724,239901
275180,2014,8,428,62,490,57457
275200,2015,8,1016,95,1111,123277
275290,2014,8,292,65,357,28897
275350,2014,8,67,16,83,6138
275390,2014,8,1416,96,1512,178892
275470,2014,8,873,152,1025,149872
275490,2014,5,799,993,1792,230126
275510,2014,5,79,73,152,54975
275530,2014,6,529,186,715,102189
275610,2014,5,430,376,806,60948
275670,2014,8,1418,217,1635,180758
275850,2016,5,43397,41797,85194,1396577
276730,2015,5,37,19,56,7689
276810,2015,5,3366,1444,4810,332983
276870,2014,5,135,65,200,10106
276890,2014,6,117,43,160,44441
277390,2016,8,98,16,114,6649
277430,2014,8,2521,617,3138,352861
277470,2014,6,157,62,219,30364
277490,2014,8,330,64,394,39177
277510,2014,5,53,40,93,24454
277520,2015,5,127,96,223,25687
277630,2014,6,82,30,112,18131
277700,2016,8,113,12,125,13159
277870,2014,6,296,95,391,59687
277890,2014,8,779,116,895,125544
278100,2016,8,527,73,600,76653
278360,2014,8,9624,771,10395,433874
278420,2015,8,61,9,70,6947
278440,2015,6,184,66,250,23817
278460,2014,8,1250,170,1420,204007
278530,2014,5,106,76,182,21151
278570,2015,8,215,50,265,31428
278620,2014,5,252,117,369,44547
278640,2014,6,165,54,219,35192
278810,2015,5,76,58,134,11271
278890,2014,8,1005,147,1152,89453
278910,2015,8,580,140,720,99790
278930,2014,6,217,63,280,40975
279070,2016,8,76,11,87,7217
279140,2015,6,227,71,298,19647
279160,2014,5,151,82,233,19494
279260,2014,6,247,91,338,32221
279440,2014,6,360,108,468,46298
279480,2014,5,46,39,85,10038
279500,2014,5,41,21,62,3431
279520,2014,5,22,21,43,11741
279580,2014,5,95,44,139,14512
279800,2015,9,692,23,715,67732
279900,2016,5,120,53,173,15864
279920,2014,5,73,38,111,7428
279940,2015,8,517,41,558,55530
279990,2014,5,110,52,162,35574
280010,2015,8,701,167,868,6343
280040,2014,5,270,118,388,60581
280140,2014,6,199,57,256,85397
280160,2016,8,3058,370,3428,287729
280180,2017,8,902,185,1087,68710
280200,2014,5,35,31,66,13942
280220,2014,9,2084,70,2154,181999
280320,2014,5,307,194,501,52890
280360,2015,5,198,135,333,25971
280460,2014,5,60,41,101,13667
280500,2014,5,27,16,43,7799
280520,2016,8,677,165,842,76215
280540,2014,6,93,35,128,11785
280560,2014,8,343,19,362,22121
280600,2015,8,201,50,251,19696
280720,2021,8,177,34,211,25465
280830,2014,6,123,52,175,6789
280890,2014,4,35,55,90,8030
280910,2014,8,317,35,352,30659
280930,2014,8,229,36,265,22641
281060,2014,6,89,32,121,39602
281200,2016,5,213,104,317,51949
281220,2014,5,420,242,662,63240
281610,2016,6,2451,642,3093,102014
281640,2016,8,1405,134,1539,154166
281750,2014,8,369,66,435,59942
281820,2014,6,42,16,58,7684
281920,2014,8,1615,170,1785,173353
281940,2015,5,661,450,1111,55156
281990,2016,8,26902,6152,33054,1967015
282050,2015,5,263,259,522,25583
282070,2014,9,39981,1948,41929,2817954
282100,2014,6,364,94,458,52767
282140,2015,9,13229,550,13779,490677
282210,2015,5,856,1024,1880,195389
282400,2014,6,1058,290,1348,83969
282440,2014,8,9266,1670,10936,1444119
282530,2014,8,703,148,851,79325
282560,2016,4,1072,3341,4413,180587
282590,2015,8,465,110,575,55309
282620,2015,5,52,33,85,6810
282640,2015,7,34,1,35,867
282680,2018,6,68,21,89,5953
282740,2014,5,11,13,24,2442
282760,2014,8,1712,193,1905,123804
282780,2015,6,74,31,105,10699
282800,2014,8,8382,602,8984,498987
282860,2015,4,52,114,166,6080
282880,2014,5,179,91,270,55931
282900,2015,9,7771,368,8139,405416
283000,2014,5,50,75,125,26680
283020,2014,4,20,39,59,17150
283040,2015,5,37,34,71,33193
283080,2015,8,206,28,234,18210
283160,2016,8,848,90,938,52810
283180,2014,6,94,31,125,22104
283230,2014,6,755,258,1013,87601
283640,2016,8,6030,474,6504,400674
283660,2014,5,183,105,288,44559
283680,2014,8,1007,113,1120,99413
283820,2014,8,93,7,100,14417
283840,2014,8,76,11,87,11241
283880,2014,8,773,102,875,129604
284050,2014,8,275,14,289,16661
284100,2016,5,80,47,127,8944
284140,2014,5,59,31,90,11090
284160,2015,8,10842,958,11800,804022
284180,2014,8,91,12,103,16407
284200,2014,6,36,15,51,13974
284390,2014,8,1114,59,1173,64146
284410,2016,6,40,16,56,7705
284460,2014,8,1335,218,1553,127315
284580,2014,5,15,17,32,2354
284710,2014,8,823,87,910,71632
284730,2014,8,364,39,403,56322
284750,2014,8,580,109,689,64757
284770,2014,9,773,22,795,81709
284790,2014,9,515,21,536,71766
284810,2015,8,446,13,459,62726
284830,2014,8,672,61,733,70797
284850,2014,9,801,30,831,94987
284870,2014,8,819,85,904,65573
284890,2014,8,335,60,395,51388
284930,2014,5,162,152,314,128028
284950,2014,8,1792,382,2174,250430
284970,2014,5,52,47,99,7185
284990,2015,5,224,121,345,55645
285010,2014,6,456,151,607,187522
285070,2016,6,490,135,625,108601
285130,2014,5,112,105,217,104354
285160,2014,6,2158,622,2780,400545
285190,2017,5,5984,7452,13436,680572
285350,2014,5,12,12,24,1831
285380,2019,5,170,110,280,9677
285440,2014,8,945,51,996,78127
285740,2015,8,520,29,549,65340
285800,2014,8,710,151,861,45707
285820,2015,8,452,52,504,74233
285840,2014,8,611,93,704,143231
285900,2017,5,11034,4775,15809,1689567
285920,2018,8,3316,648,3964,489971
285960,2014,5,94,60,154,9818
285980,2014,6,76,21,97,11693
286000,2017,6,1601,421,2022,300539
286040,2014,6,1938,752,2690,192670
286100,2014,8,4538,339,4877,530340
286120,2014,5,391,335,726,129969
286160,2015,9,10024,518,10542,2297649
286200,2014,5,149,75,224,34218
286220,2014,5,57,35,92,14095
286240,2016,8,246,19,265,16563
286260,2014,8,2105,137,2242,108001
286280,2015,8,138,30,168,9977
286300,2018,7,33,2,35,1515
286320,2014,8,336,24,360,38018
286360,2014,6,462,153,615,148068
286380,2014,8,267,36,303,16573
286570,2015,5,2877,2156,5033,1022816
286660,2014,8,145,23,168,13059
286690,2014,8,19773,1910,21683,2025648
287100,2014,4,230,524,754,65778
287120,2014,6,410,137,547,180452
287200,2014,5,158,150,308,56515
287260,2014,8,774,144,918,98179
287290,2015,6,7586,2177,9763,658030
287340,2014,5,769,1106,1875,143826
287390,2014,8,15929,1207,17136,1492907
287450,2014,8,4438,392,4830,859562
287580,2014,5,322,170,492,41818
287600,2015,5,146,69,215,11937
287630,2018,8,396,49,445,17993
287700,2015,8,32906,4072,36978,1750593
287780,2014,5,13,6,19,1199
287840,2015,8,170,32,202,11520
287920,2015,5,1236,1225,2461,316391
287980,2015,9,6172,222,6394,547876
288020,2014,6,155,43,198,16023
288040,2014,6,336,93,429,30426
288060,2014,8,616,126,742,75283
288100,2016,5,10,7,17,1150
288120,2014,8,472,41,513,25599
288140,2016,5,393,234,627,29063
288160,2014,9,8172,219,8391,327417
288220,2016,8,166,16,182,14314
288260,2015,6,114,48,162,23909
288370,2014,8,219,51,270,30682
288470,2014,6,3480,976,4456,582271
288650,2014,5,25,11,36,3643
288860,2017,6,68,20,88,4917
288880,2014,5,255,143,398,34841
288930,2015,8,340,74,414,20640
289070,2016,6,29863,12306,42169,3680328
289090,2014,5,1133,662,1795,205704
289130,2014,8,8845,1672,10517,1516227
289520,2014,5,546,243,789,92537
289690,2014,5,603,471,1074,162890
289760,2015,6,401,102,503,78120
289930,2014,5,546,263,809,107388
289950,2014,6,2205,748,2953,416518
290000,2016,6,176,45,221,20426
290020,2017,8,97,21,118,8844
290080,2015,5,5737,3072,8809,534443
290260,2014,8,250,21,271,28719
290300,2015,8,4541,763,5304,378307
290320,2014,8,69,15,84,19161
290340,2015,8,5668,1191,6859,565864
290380,2014,8,135,5,140,7680
290440,2014,5,18,23,41,2392
290490,2015,5,120,166,286,11551
290530,2015,8,261,64,325,31632
290730,2014,8,2705,446,3151,164688
290770,2014,8,2638,335,2973,151247
290790,2015,5,2170,997,3167,364090
290810,2014,4,36,57,93,3184
290870,2016,6,58,17,75,3656
290890,2015,8,575,118,693,62085
290970,2014,5,186,80,266,22663
290990,2014,5,77,35,112,10447
291010,2016,5,2185,1023,3208,320602
291030,2014,5,147,99,246,14440
291050,2014,5,42,30,72,17008
291070,2014,8,87,20,107,9130
291130,2014,5,310,337,647,46458
291170,2014,6,125,49,174,59280
291190,2014,6,151,40,191,17430
291370,2014,4,47,121,168,4172
291390,2014,5,63,30,93,27880
291410,2016,8,3109,688,3797,538747
291430,2014,6,32,11,43,8444
291480,2014,6,26047,11136,37183,6656284
291550,2017,8,52691,9115,61806,8646824
291610,2014,5,17,8,25,1964
291650,2015,8,10429,1532,11961,1275530
291690,2017,6,45,14,59,2621
291710,2014,6,164,49,213,25408
291860,2018,8,4147,237,4384,295630
291910,2014,5,218,183,401,48294
291930,2014,4,65,130,195,23801
292030,2015,9,149117,3223,152340,5479626
292090,2014,7,16,4,20,2236
292120,2014,6,6374,2440,8814,707712
292140,2014,5,1646,988,2634,244770
292200,2014,6,174,57,231,26126
292330,2018,5,158,123,281,14040
292370,2014,5,120,105,225,138148
292400,2014,5,104,46,150,26143
292480,2014,5,194,97,291,31738
292500,2015,8,451,32,483,45170
292570,2014,5,300,136,436,150513
292600,2015,8,557,31,588,40133
292730,2016,5,6740,9520,16260,869560
292910,2014,8,1775,208,1983,193272
293200,2014,5,38,26,64,6361
293220,2020,5,464,349,813,32618
293240,2015,8,383,37,420,30959
293260,2015,8,2839,434,3273,688214
293340,2014,5,60,51,111,8239
293420,2014,5,27,13,40,2753
293440,2014,6,108,31,139,9372
293460,2015,5,86,39,125,7589
293480,2020,4,77,122,199,18647
293520,2015,6,321,127,448,23901
293540,2014,5,1022,525,1547,587059
293600,2015,5,33,40,73,11794
293660,2014,8,312,31,343,20234
293680,2014,8,537,62,599,39684
293740,2014,8,236,44,280,40224
293780,2017,9,3223,117,3340,241677
293860,2014,5,307,192,499,64476
293900,2014,8,190,18,208,14630
293920,2014,5,29,34,63,6600
293940,2014,5,192,103,295,58602
293960,2014,5,33,17,50,7403
294000,2015,8,226,39,265,43218
294020,2014,5,267,133,400,112327
294040,2015,6,855,301,1156,169868
294060,2015,6,80,32,112,5793
294140,2014,8,789,161,950,43222
294160,2014,8,586,94,680,137088
294190,2015,4,8,13,21,6451
294230,2014,8,443,93,536,112749
294370,2014,6,280,84,364,43378
294440,2014,8,434,60,494,85093
294460,2014,8,114,23,137,23697
294750,2014,8,174,43,217,30296
294810,2014,8,889,70,959,117011
294830,2014,5,82,116,198,22503
294860,2014,8,7915,698,8613,767675
295110,2015,5,45336,30556,75892,3491666
295490,2014,5,78,36,114,17454
295550,2014,5,773,357,1130,240272
295630,2014,8,74,17,91,6526
295670,2017,6,193,49,242,14753
295690,2015,8,1076,127,1203,163254
295730,2014,8,176,35,211,20050
295750,2014,8,252,59,311,21796
295790,2014,8,4722,1094,5816,370263
295850,2014,6,239,98,337,17359
295870,2014,6,51,17,68,5179
295930,2014,5,236,279,515,85962
296030,2016,7,27,5,32,2716
296050,2014,5,502,221,723,135658
296070,2014,5,790,362,1152,80496
296150,2014,4,21,51,72,3143
296220,2014,6,196,53,249,29162
296300,2017,6,4038,1209,5247,166473
296470,2014,9,5636,266,5902,942809
296490,2015,9,1923,81,2004,149323
296510,2014,6,48,20,68,15213
296550,2015,8,77,14,91,2775
296570,2014,8,734,145,879,54081
296590,2014,4,15,26,41,5272
296630,2014,6,281,102,383,29897
296710,2015,8,1160,120,1280,86683
296730,2014,6,115,36,151,14596
296770,2014,5,601,365,966,119747
296790,2017,6,18,5,23,663
296830,2015,5,654,446,1100,88829
296850,2014,5,30,21,51,7774
296870,2015,8,1367,131,1498,231019
296910,2014,6,1207,420,1627,119160
296930,2014,6,142,37,179,24152
296970,2015,8,1835,123,1958,171206
297000,2015,5,3732,1766,5498,591573
297020,2014,6,2205,765,2970,396159
297100,2014,4,53,100,153,21493
297120,2014,8,839,158,997,116134
297130,2015,6,2953,829,3782,350359
297290,2014,8,149,33,182,18966
297330,2014,5,65,52,117,4745
297370,2014,8,104,12,116,5721
297410,2014,7,35,7,42,8004
297450,2016,5,79,56,135,8049
297490,2014,8,235,29,264,36596
297590,2014,8,57,1,58,3481
297660,2016,7,38,4,42,2048
297740,2015,5,30,24,54,12778
297920,2015,6,178,58,236,42425
298050,2016,6,2679,1117,3796,243222
298160,2014,6,989,265,1254,220102
298260,2014,5,3487,1957,5444,614140
298340,2014,5,116,82,198,12657
298360,2015,8,106,6,112,6827
298400,2014,8,362,28,390,14116
298420,2016,6,11,3,14,651
298480,2014,6,291,91,382,41778
298520,2014,8,1372,261,1633,267763
298560,2016,8,209,38,247,29606
298600,2014,8,1856,163,2019,180720
298630,2015,8,9822,1161,10983,1296849
298790,2014,7,36,3,39,2295
298820,2014,7,32,4,36,10437
298830,2014,7,24,2,26,7906
298840,2014,7,18,2,20,7244
298850,2014,5,17,10,27,7398
298900,2016,5,2889,2542,5431,236698
298930,2014,6,249,70,319,27592
298950,2014,6,90,29,119,7165
299090,2015,5,12,14,26,893
299250,2016,4,194,298,492,50077
299340,2016,5,92,102,194,27685
299360,2015,6,8995,2615,11610,2434754
299380,2016,7,10,1,11,189
299400,2017,8,87,9,96,3005
299420,2014,5,169,95,264,65086
299440,2014,5,51,22,73,15395
299480,2016,6,559,233,792,80072
299540,2014,8,290,44,334,25000
299660,2014,8,374,33,407,15732
299680,2015,6,957,244,1201,30008
299720,2014,8,851,158,1009,141326
299740,2018,5,14956,6673,21629,1123426
299800,2016,8,50,3,53,7307
299950,2017,8,408,94,502,24477
300060,2016,5,691,546,1237,81212
300220,2014,5,257,151,408,78439
300280,2015,6,66,27,93,12687
300300,2014,8,484,52,536,79995
300320,2014,5,74,68,142,25831
300340,2015,8,176,23,199,17782
300360,2014,5,50,29,79,9428
300380,2017,8,3617,685,4302,214682
300400,2015,8,76,12,88,6820
300540,2014,5,58,55,113,41138
300550,2014,8,3160,333,3493,530607
300570,2015,8,1330,78,1408,161086
300580,2015,6,308,113,421,80607
300610,2014,5,115,114,229,15411
300620,2014,7,12,1,13,1601
300630,2016,5,57,28,85,5017
300760,2015,5,57,41,98,10825
300840,2014,8,61,4,65,4831
301050,2015,5,71,33,104,10371
301150,2014,8,281,52,333,28842
301190,2014,8,656,119,775,92221
301200,2014,8,532,100,632,81939
301220,2014,2,20,132,152,7667
301300,2014,8,199,6,205,14015
301360,2014,5,33,43,76,4842
301380,2014,8,102,8,110,5183
301420,2014,6,30,12,42,4184
301460,2014,8,431,103,534,39987
301520,2017,6,70946,26834,97780,10145493
301540,2014,5,54,65,119,46227
301640,2015,8,6987,1048,8035,939676
301650,2016,8,444,39,483,38993
301750,2014,5,488,456,944,244616
301840,2018,8,170,32,202,9691
301860,2015,6,1665,586,2251,111781
301910,2015,6,4460,1550,6010,536513
301920,2015,8,76,4,80,6056
301930,2016,7,18,2,20,1690
301970,2014,8,998,92,1090,216726
301990,2014,6,50,21,71,16198
302060,2014,5,196,108,304,116689
302270,2014,5,765,748,1513,140731
302290,2014,4,7,11,18,1024
302310,2014,5,66,92,158,46769
302440,2014,5,30,33,63,9877
302510,2014,8,12509,2430,14939,984278
302590,2014,8,1717,298,2015,488098
302610,2014,8,1176,96,1272,81725
302670,2018,6,3730,1594,5324,436655
302690,2014,8,349,57,406,25535
302710,2014,8,846,122,968,80959
302790,2014,8,652,52,704,51616
302850,2014,5,54,38,92,16655
302870,2014,5,13,14,27,1745
302950,2014,5,56,48,104,12497
302970,2014,8,60,11,71,3950
303260,2015,5,47,47,94,15243
303310,2016,8,374,7,381,8530
303340,2014,5,42,27,69,10040
303430,2014,8,388,30,418,28098
303470,2014,5,77,37,114,14527
303510,2014,5,75,84,159,31499
303530,2014,5,23,11,34,4329
303550,2015,8,165,17,182,11663
303680,2014,8,109,17,126,22937
303690,2014,6,120,32,152,24824
303720,2016,5,31,15,46,31878
303790,2014,6,330,124,454,46894
303800,2014,6,543,144,687,123994
303830,2014,4,12,47,59,11642
303840,2014,6,117,46,163,23065
303860,2014,6,38,13,51,3715
303870,2014,4,18,35,53,3316
303880,2014,4,9,19,28,964
303910,2014,5,15,11,26,4229
303940,2014,6,100,28,128,5630
304050,2015,6,39269,11164,50433,7700319
304170,2014,2,30,137,167,9906
304240,2015,8,5151,500,5651,415885
304290,2014,8,121,28,149,18474
304410,2014,9,1748,50,1798,102298
304430,2016,9,16902,786,17688,669904
304460,2014,5,224,100,324,19643
304530,2017,5,1394,941,2335,82676
304580,2015,5,104,151,255,22816
304650,2015,8,4703,975,5678,740790
304670,2014,8,266,66,332,33296
304730,2014,5,1849,1034,2883,231014
304910,2015,6,140,36,176,13240
304930,2017,8,252271,24725,276996,27381399
304930,2017,8,252271,24725,276996,27381399
304950,2015,8,278,61,339,15364
305010,2014,3,7,30,37,5642
305050,2014,8,2563,561,3124,646962
305070,2014,5,163,107,270,16194
305260,2014,6,2386,719,3105,338532
305380,2015,8,967,92,1059,50345
305480,2014,5,21,15,36,10451
305490,2014,5,40,23,63,11197
305500,2015,5,68,51,119,7093
305620,2017,8,34834,3057,37891,1875963
305640,2014,5,342,149,491,60176
305780,2014,8,103,25,128,20870
305800,2014,5,49,31,80,4252
305820,2015,6,36,13,49,8103
305920,2014,8,237,33,270,17884
305940,2018,6,348,136,484,29603
305960,2014,5,249,342,591,15422
305980,2014,5,137,127,264,23222
306000,2016,5,38,44,82,7218
306020,2014,8,3019,246,3265,354027
306260,2014,5,21,31,52,4868
306440,2015,5,54,53,107,7711
306550,2014,8,195,32,227,25130
306660,2014,8,1815,385,2200,210440
306670,2015,4,100,331,431,23835
306680,2014,6,220,74,294,26073
306700,2014,8,178,22,200,14530
306760,2016,8,1595,370,1965,129459
306950,2014,5,42,26,68,17110
307010,2014,8,186,36,222,17202
307050,2014,6,1525,595,2120,50609
307090,2014,6,191,66,257,28161
307130,2014,5,117,87,204,19739
307150,2018,5,19,12,31,1397
307170,2014,5,285,177,462,72503
307190,2014,5,68,30,98,9912
307210,2015,5,44,29,73,10783
307230,2014,8,1554,310,1864,156861
307270,2014,5,22,20,42,10691
307430,2015,6,61,21,82,9755
307570,2014,6,110,45,155,10117
307580,2015,9,705,35,740,41216
307590,2015,8,201,32,233,28487
307620,2015,5,48,35,83,13265
307670,2015,6,1715,477,2192,203211
307690,2014,8,11261,1366,12627,930591
307780,2015,6,16573,6213,22786,1455905
307880,2021,5,2942,2384,5326,399316
307940,2016,6,227,75,302,13838
307980,2014,5,33,18,51,9900
308040,2014,8,1240,279,1519,394370
308060,2017,6,432,133,565,45330
308080,2022,6,82,29,111,4348
308173,2015,6,237,73,310,30126
308180,2014,7,14,3,17,736
308270,2014,8,254,61,315,19789
308360,2014,8,44,9,53,5847
308380,2014,5,21,23,44,7788
308420,2014,8,2472,357,2829,242342
308440,2015,8,78,7,85,7239
308460,2014,6,120,49,169,17480
308520,2015,5,36,30,66,5527
308560,2015,6,23,9,32,4835
308600,2017,8,89,2,91,4312
310060,2015,8,722,118,840,101271
310080,2014,8,4770,301,5071,283021
310110,2014,5,101,93,194,13654
310360,2015,9,1177,47,1224,81099
310460,2014,4,6,20,26,3617
310470,2015,5,629,844,1473,96203
310490,2015,8,139,23,162,20588
310510,2015,8,857,195,1052,100663
310560,2015,8,14682,1910,16592,1073123
310700,2014,8,373,49,422,35371
310740,2015,6,150,39,189,17788
310790,2014,8,853,87,940,94024
310810,2015,6,47,17,64,22108
310850,2015,5,122,178,300,27283
310880,2014,5,24,36,60,4106
310890,2015,5,384,338,722,58538
311010,2016,8,501,58,559,22816
311170,2014,5,16,22,38,1920
311210,2015,5,32412,20416,52828,3021623
311240,2016,8,1247,106,1353,38650
311250,2014,6,228,86,314,45797
311260,2022,5,1043,1005,2048,57840
311290,2017,6,1472,592,2064,133510
311340,2014,8,7083,1422,8505,890926
311480,2014,8,538,118,656,83966
311490,2015,5,14,14,28,1262
311680,2014,6,56,21,77,10137
311690,2016,8,14732,969,15701,1144928
311720,2014,8,336,70,406,51420
311730,2015,5,3964,2457,6421,383476
311800,2014,8,298,11,309,14346
311840,2015,5,26,19,45,9559
311860,2014,5,86,44,130,239817
311870,2014,8,876,67,943,74119
311910,2014,5,67,50,117,28565
311930,2015,8,80,3,83,3644
311980,2014,2,13,56,69,3463
312050,2014,5,19,23,42,2461
312150,2014,6,617,264,881,177783
312220,2014,4,15,28,43,1775
312230,2015,8,205,50,255,17360
312240,2015,7,15,3,18,1243
312280,2015,6,1164,413,1577,327332
312300,2014,8,112,10,122,12211
312410,2014,7,29,6,35,2958
312430,2017,5,120,96,216,10104
312440,2015,5,19,13,32,2449
312450,2015,6,661,273,934,159890
312510,2014,8,61,10,71,8942
312520,2017,8,966,168,1134,65076
312530,2015,9,12794,555,13349,1183631
312540,2015,8,371,30,401,36523
312560,2016,8,156,16,172,8093
312600,2014,5,72,34,106,17055
312610,2014,8,1296,116,1412,229374
312630,2014,6,164,56,220,32615
312650,2017,8,130,31,161,8616
312660,2017,8,6266,888,7154,715583
312720,2014,8,98,9,107,18173
312750,2014,8,765,146,911,135594
312780,2015,6,850,215,1065,84513
312790,2015,5,114,65,179,29936
312840,2015,8,1937,423,2360,138534
312900,2014,5,79,38,117,6527
312920,2015,6,75,23,98,4406
312960,2014,5,70,80,150,37382
312980,2016,8,216,29,245,11249
313010,2015,4,518,1196,1714,105319
313020,2014,8,1884,258,2142,139502
313080,2015,5,294,174,468,55442
313120,2022,6,13839,4326,18165,1154025
313130,2014,5,81,61,142,26044
313160,2014,8,9432,963,10395,916206
313340,2014,8,9263,1261,10524,375718
313390,2017,8,78,17,95,5839
313400,2014,8,238,11,249,36276
313470,2014,8,75,12,87,7164
313590,2014,6,174,59,233,13144
313630,2016,8,1651,394,2045,140276
313650,2014,5,222,141,363,47920
313690,2014,8,1857,298,2155,330037
313780,2017,8,524,107,631,27395
313810,2015,6,115,46,161,14089
313830,2014,5,191,89,280,95240
313980,2014,6,102,38,140,9351
314000,2015,5,682,385,1067,314286
314010,2016,8,480,117,597,133835
314020,2014,8,3602,682,4284,349778
314070,2015,8,593,65,658,57877
314120,2014,6,19,8,27,1994
314150,2015,5,275,196,471,34406
314180,2016,8,247,6,253,25164
314200,2014,6,73,27,100,11561
314210,2014,3,6,37,43,11856
314220,2014,5,64,41,105,5310
314240,2016,5,256,180,436,32705
314250,2014,6,412,122,534,90354
314280,2014,5,795,524,1319,151164
314290,2014,5,30,32,62,10935
314330,2016,7,41,5,46,3530
314340,2014,5,46,43,89,4353
314360,2014,8,78,7,85,7746
314370,2016,6,77,23,100,1269
314410,2015,8,1946,155,2101,257372
314450,2016,8,1262,256,1518,295982
314460,2014,5,31,28,59,15645
314470,2014,8,109,22,131,10927
314520,2015,5,838,507,1345,89325
314560,2015,5,65,37,102,12976
314570,2014,5,18,19,37,13725
314590,2017,8,53,13,66,7385
314630,2018,7,14,2,16,465
314660,2015,8,1803,229,2032,204545
314710,2016,5,1244,1246,2490,106427
314760,2014,5,9,12,21,1000
314790,2016,8,813,133,946,69338
314810,2014,6,535,160,695,59860
314830,2015,5,427,209,636,100193
314850,2014,3,2,22,24,605
314970,2016,6,977,254,1231,257484
314980,2014,6,357,115,472,39123
315060,2015,5,172,89,261,102572
315070,2020,4,23,89,112,33878
315080,2014,7,35,7,42,13687
315110,2014,6,73,23,96,9671
315130,2015,5,26,28,54,3286
315320,2014,4,45,101,146,8258
315340,2014,6,107,30,137,9007
315430,2016,8,3605,852,4457,392114
315450,2014,5,29,17,46,1454
315460,2018,8,2222,186,2408,166057
315480,2014,4,4,16,20,981
315680,2015,4,18,35,53,2633
315830,2014,8,92,17,109,7789
315850,2014,5,123,61,184,7810
315860,2015,5,207,90,297,21991
315920,2014,5,110,53,163,33552
315930,2014,8,46,9,55,4321
315940,2014,5,36,20,56,5060
316010,2015,6,15980,6382,22362,4109602
316020,2014,7,31,4,35,2206
316080,2015,8,95,11,106,15976
316140,2014,5,46,34,80,8507
316180,2014,5,49,31,80,9666
316370,2015,5,47,38,85,8044
316480,2014,6,94,25,119,15703
316600,2014,8,301,25,326,36509
316610,2015,8,155,7,162,7590
316660,2014,6,53,15,68,13208
316720,2014,9,1343,34,1377,29973
316740,2014,5,26,24,50,1653
316750,2015,4,86,228,314,11493
316790,2015,8,3633,408,4041,516584
316810,2014,5,42,37,79,2997
316890,2015,5,184,98,282,19907
316930,2015,5,353,188,541,21849
316970,2014,5,43,39,82,6943
317040,2014,8,274,24,298,35522
317060,2016,5,48,51,99,7900
317100,2015,6,235,69,304,23784
317280,2016,6,94,29,123,18849
317290,2014,5,20,13,33,8492
317300,2014,6,123,40,163,26569
317320,2016,8,111,6,117,3464
317360,2014,8,7735,662,8397,1293392
317370,2017,7,40,9,49,6920
317440,2014,5,82,61,143,25783
317510,2014,8,748,98,846,32142
317530,2016,5,73,49,122,5536
317610,2014,5,44,19,63,9221
317620,2014,6,460,195,655,97267
317710,2014,8,506,61,567,51120
317730,2015,4,32,55,87,1609
317820,2015,6,1108,366,1474,174216
317840,2014,6,29,9,38,2742
317940,2015,6,116,48,164,6158
317950,2014,5,23,21,44,2290
318020,2015,5,1216,751,1967,163715
318090,2016,5,129,60,189,8572
318100,2018,5,929,829,1758,103699
318130,2015,9,1386,47,1433,24068
318230,2015,8,676,159,835,87209
318260,2015,5,64,32,96,5355
318310,2014,8,276,18,294,18594
318330,2014,8,97,10,107,8459
318430,2014,8,2762,518,3280,328982
318440,2014,5,17,19,36,2404
318480,2015,7,38,3,41,10477
318530,2014,8,749,134,883,58997
318600,2016,6,2654,818,3472,561716
318650,2014,5,61,32,93,6023
318860,2015,5,64,34,98,10298
318970,2017,8,365,51,416,22302
319050,2015,6,686,190,876,79925
319140,2014,6,362,130,492,24939
319250,2014,8,360,38,398,36912
319270,2014,8,90,13,103,21980
319320,2014,8,243,35,278,42511
319450,2014,8,163,38,201,30719
319480,2015,8,700,66,766,67316
319550,2014,8,758,103,861,28464
319570,2015,4,171,261,432,133765
319630,2015,9,101790,3702,105492,4017852
319740,2015,6,240,81,321,20377
319760,2016,8,116,16,132,9903
319780,2015,4,40,81,121,21582
319830,2015,6,669,174,843,332904
319850,2014,8,267,53,320,55422
319910,2015,5,3158,1593,4751,392900
319970,2014,6,362,129,491,44123
320040,2016,6,1098,328,1426,170583
320090,2015,7,33,4,37,3307
320120,2014,5,23,21,44,4482
320140,2015,8,1483,191,1674,136473
320150,2014,8,213,42,255,47000
320240,2018,6,1970,684,2654,146235
320300,2015,8,6925,653,7578,1631855
320340,2015,5,470,472,942,73558
320430,2014,6,237,65,302,17068
320520,2015,6,75,30,105,15153
320540,2015,6,349,143,492,47118
320610,2015,6,94,27,121,7533
320630,2014,6,90,29,119,9531
320650,2014,5,37,30,67,6538
320670,2014,6,63,19,82,9199
320820,2015,5,654,331,985,43631
320840,2014,6,238,65,303,29297
321150,2014,6,445,170,615,183443
321260,2015,5,415,344,759,75018
321270,2016,6,445,124,569,30900
321330,2015,6,34,11,45,2494
321350,2015,5,16,8,24,1382
321360,2015,6,2390,902,3292,192523
321370,2014,5,52,29,81,2356
321400,2019,6,1191,335,1526,325150
321490,2014,4,16,37,53,4487
321560,2014,8,116,17,133,11428
321660,2014,4,16,39,55,12901
321800,2014,8,552,87,639,154901
321830,2014,6,136,49,185,8782
321920,2014,6,181,51,232,63264
321950,2014,5,200,219,419,98464
321960,2015,5,1242,1501,2743,174672
322080,2015,6,58,19,77,7121
322110,2017,8,2075,137,2212,113055
322170,2014,9,40871,2014,42885,1317156
322190,2016,9,2215,89,2304,232902
322210,2015,8,1347,84,1431,68968
322290,2015,8,442,37,479,49773
322440,2015,5,31,27,58,2052
322450,2018,8,54,2,56,2565
322500,2016,8,11942,1757,13699,842122
322520,2015,5,490,280,770,58202
322550,2015,6,14,5,19,695
322630,2016,5,26,30,56,2269
322680,2015,8,530,65,595,35901
322750,2017,8,173,36,209,8275
322770,2019,8,2027,119,2146,107763
322850,2015,5,184,128,312,46324
322900,2015,6,241,99,340,28793
322910,2015,6,1065,439,1504,129644
322920,2015,5,2059,1572,3631,207392
322950,2015,5,33,42,75,3458
322970,2015,5,120,80,200,36981
323040,2015,6,48,15,63,6467
323060,2016,5,1319,582,1901,127534
323190,2018,8,10959,1636,12595,679334
323320,2015,8,3470,327,3797,330240
323380,2015,8,970,74,1044,56854
323450,2015,8,77,13,90,11800
323460,2015,8,248,43,291,38750
323470,2015,8,11590,1535,13125,824682
323490,2014,8,401,34,435,14406
323580,2015,6,4478,1221,5699,1022556
323630,2015,8,163,12,175,10521
323680,2015,3,7,34,41,1669
323700,2014,6,28,11,39,2594
323720,2015,6,634,219,853,63723
323850,2016,8,6322,872,7194,952680
323900,2015,6,321,105,426,61673
324070,2014,8,125,26,151,21432
324090,2016,5,70,42,112,6992
324120,2014,6,171,68,239,7324
324140,2015,8,182,9,191,15536
324160,2015,9,1568,23,1591,54869
324260,2015,6,421,170,591,43024
324310,2016,5,1218,776,1994,151645
324390,2015,8,40,10,50,5299
324400,2015,5,8,10,18,1458
324420,2014,5,34,30,64,19533
324470,2015,6,126,35,161,7688
324510,2018,6,537,178,715,28943
324520,2016,8,137,31,168,8184
324570,2015,8,427,89,516,69530
324610,2014,2,16,113,129,5292
324650,2016,6,234,68,302,11167
324710,2015,8,143,12,155,11032
324730,2015,6,19,7,26,4766
324740,2016,6,302,85,387,62365
324750,2014,5,40,33,73,13812
324810,2016,6,3427,1028,4455,575390
325060,2015,8,94,12,106,8338
325090,2014,6,375,99,474,97717
325120,2015,8,414,58,472,12129
325150,2014,8,94,11,105,11882
325160,2014,7,35,2,37,2924
325520,2015,8,278,43,321,18812
325610,2015,6,10499,3484,13983,1331963
325630,2015,5,84,100,184,10190
325730,2016,6,143,46,189,15417
325790,2015,4,79,121,200,17167
325860,2014,6,30,10,40,5171
325870,2014,6,40,15,55,9048
325880,2015,5,34,38,72,3911
325930,2016,8,152,18,170,14172
326110,2016,5,9,13,22,817
326120,2015,8,208,49,257,126956
326150,2014,8,467,39,506,23872
326160,2018,5,821,766,1587,50554
326180,2014,5,882,458,1340,151771
326190,2014,6,697,212,909,112245
326340,2015,5,375,171,546,31007
326360,2017,5,369,180,549,140653
326380,2015,7,33,7,40,3570
326410,2015,8,2048,497,2545,355878
326420,2014,4,9,31,40,563
326460,2020,8,8959,955,9914,1529238
326470,2014,6,27,11,38,2335
326480,2014,8,2203,174,2377,119624
326520,2016,6,69,18,87,15264
326650,2015,3,6,39,45,1747
326670,2015,5,459,228,687,62016
326720,2014,8,132,21,153,12122
326730,2014,5,34,39,73,17106
326840,2016,8,272,57,329,15792
326950,2015,6,229,86,315,48100
327010,2014,4,107,178,285,16051
327030,2016,8,1661,404,2065,286591
327070,2016,5,1636,765,2401,102616
327090,2018,5,1327,710,2037,118244
327150,2014,6,36,11,47,2522
327260,2014,8,250,51,301,23987
327310,2014,8,207,38,245,36665
327410,2014,8,5332,1042,6374,63745
327440,2014,6,129,35,164,6916
327500,2015,8,62,6,68,5448
327510,2016,6,666,214,880,77315
327520,2015,6,54,16,70,4732
327560,2016,8,434,43,477,14506
327640,2015,5,719,418,1137,200818
327670,2015,8,478,110,588,31449
327760,2018,7,23,3,26,518
327860,2018,8,1044,238,1282,101445
327880,2015,8,378,46,424,21470
327890,2015,6,3567,999,4566,579156
327960,2014,3,4,17,21,629
327980,2015,7,16,1,17,3070
328000,2016,5,6,6,12,2059
328060,2015,5,272,253,525,120018
328270,2014,8,408,86,494,31554
328500,2014,6,353,130,483,69690
328550,2014,7,20,5,25,2417
328590,2017,6,131,36,167,9217
328600,2014,5,179,92,271,62977
328640,2014,5,20,16,36,1961
328650,2015,5,8,5,13,1212
328680,2014,5,32,17,49,61532
328710,2015,5,67,30,97,3554
328730,2014,8,293,19,312,41866
328760,2015,8,1115,84,1199,94409
328780,2014,7,34,5,39,5876
328940,2015,5,259,150,409,40667
329000,2014,5,31,32,63,204615
329020,2014,5,131,57,188,40295
329050,2015,8,3639,342,3981,299184
329110,2014,6,2597,852,3449,319394
329130,2015,8,1902,135,2037,147501
329240,2015,6,55,17,72,11212
329280,2016,5,66,49,115,15970
329320,2014,8,84,10,94,5708
329340,2016,7,10,2,12,483
329380,2015,6,617,175,792,261792
329430,2015,6,3238,1036,4274,403911
329440,2015,5,810,478,1288,72200
329460,2015,8,350,34,384,45169
329490,2015,8,2030,372,2402,168948
329690,2014,8,102,16,118,6417
329790,2015,5,171,100,271,105485
329860,2015,8,716,85,801,67022
330000,2015,5,66,58,124,25903
330100,2016,6,134,38,172,15356
330180,2015,8,230,52,282,40046
330270,2015,5,162,101,263,24926
330370,2015,6,50,14,64,3878
330390,2015,8,955,92,1047,66929
330450,2015,6,23,7,30,7574
330580,2019,6,950,261,1211,115710
330620,2014,6,81,26,107,9863
330660,2015,5,46,25,71,23683
330670,2015,7,28,3,31,4134
330680,2014,3,3,18,21,6079
330770,2016,8,104,22,126,8575
330820,2015,6,772,200,972,85060
330830,2021,9,12881,575,13456,592856
330840,2014,6,7341,2250,9591,598965
330990,2014,5,156,92,248,34154
331220,2014,6,113,34,147,18428
331340,2015,5,99,91,190,20388
331390,2014,8,121,18,139,14964
331400,2014,4,10,37,47,10669
331440,2014,8,1417,303,1720,132371
331460,2015,8,72,9,81,6967
331470,2014,9,24564,1233,25797,1097391
331480,2017,8,405,51,456,20399
331510,2014,8,105,20,125,4654
331570,2015,6,28,8,36,7333
331600,2015,8,3887,785,4672,345720
331610,2014,4,12,44,56,7757
331670,2014,8,687,59,746,307175
331690,2018,8,346,54,400,16287
331720,2015,6,113,30,143,16013
331760,2015,5,47,26,73,17491
331790,2015,5,88,57,145,328357
331870,2017,8,733,138,871,58771
331910,2014,4,9,25,34,9905
331980,2014,5,92,70,162,17414
332070,2014,5,1466,1504,2970,781378
332200,2015,8,2738,150,2888,173768
332250,2015,8,158,38,196,13827
332270,2017,7,24,5,29,1331
332310,2017,6,7792,2309,10101,752946
332330,2015,8,59,11,70,12553
332370,2015,7,9,1,10,488
332380,2015,8,63,10,73,4060
332390,2015,8,103,14,117,7124
332400,2015,8,117,16,133,6889
332410,2016,8,92,15,107,6596
332480,2014,8,432,84,516,49478
332490,2014,6,191,62,253,22785
332530,2015,5,61,36,97,16888
332540,2017,8,50,1,51,2613
332610,2015,8,122,14,136,4953
332620,2015,5,105,47,152,15196
332630,2015,7,28,5,33,1563
332710,2014,5,76,64,140,19502
332730,2015,5,15,16,31,852
332790,2015,5,175,222,397,104603
332830,2014,8,74,5,79,10016
332880,2015,7,20,3,23,1610
333120,2014,4,34,55,89,56163
333210,2015,5,167,85,252,16431
333250,2015,8,1247,217,1464,67366
333290,2015,7,15,1,16,269
333300,2015,8,520,61,581,31818
333330,2015,6,57,15,72,11842
333340,2016,5,63,74,137,3888
333390,2015,7,35,8,43,3275
333420,2016,6,3706,1237,4943,360956
333490,2015,7,24,4,28,6868
333510,2015,7,37,8,45,3322
333580,2015,7,14,2,16,970
333600,2014,9,13511,601,14112,578066
333640,2015,9,1121,35,1156,57607
333650,2015,5,25,32,57,6733
333660,2015,5,61,43,104,9378
333730,2015,4,14,22,36,10754
333870,2014,8,77,17,94,3841
333880,2014,6,170,62,232,16257
333930,2015,8,37347,8984,46331,5760753
333970,2015,6,74,26,100,14390
333980,2015,8,1875,262,2137,117269
334030,2015,5,175,93,268,81483
334070,2015,5,552,294,846,112315
334100,2015,7,21,3,24,1664
334140,2015,8,77,4,81,3267
334190,2014,6,174,48,222,13023
334210,2016,6,564,171,735,568944
334230,2014,8,10028,1358,11386,847565
334270,2014,5,32,21,53,6707
334280,2016,5,33,20,53,3414
334300,2015,8,105,18,123,97493
334420,2015,6,783,227,1010,61009
334560,2015,8,197,30,227,37263
334620,2015,6,29,10,39,7554
334690,2015,6,204,65,269,26497
334710,2014,6,47,19,66,11377
334830,2015,6,31,11,42,1104
334840,2015,8,48,9,57,12689
334850,2015,5,71,31,102,11532
334940,2018,8,132,7,139,3909
334960,2015,4,4,8,12,701
335000,2015,8,1586,97,1683,51834
335010,2015,6,37,10,47,7221
335070,2015,6,189,52,241,13437
335100,2014,6,155,54,209,21006
335190,2015,8,223,47,270,24780
335200,2015,6,40,17,57,7311
335220,2015,5,18,10,28,15131
335240,2015,8,9364,1707,11071,2070157
335300,2015,8,20745,2973,23718,1453157
335450,2015,7,15,1,16,7154
335460,2015,8,51,10,61,19395
335560,2015,7,18,1,19,5932
335620,2018,8,590,43,633,21435
335660,2015,5,83,45,128,13099
335670,2014,9,6156,285,6441,297947
335690,2015,4,20,31,51,12064
335700,2015,5,130,61,191,18226
335830,2015,5,161,86,247,17685
335840,2015,6,108,34,142,22435
335900,2014,5,21,28,49,22923
335920,2015,8,171,15,186,6733
336010,2014,5,46,22,68,6240
336020,2015,5,24,29,53,5869
336030,2016,7,35,7,42,10741
336040,2015,5,121,52,173,44922
336060,2015,6,190,58,248,16257
336080,2015,8,186,46,232,19949
336090,2014,6,72,25,97,30490
336100,2014,5,38,18,56,3429
336110,2015,8,89,19,108,12682
336130,2016,8,240,25,265,11451
336150,2015,6,136,35,171,12181
336200,2015,5,31,18,49,17388
336210,2016,5,14,17,31,450
336240,2016,8,237,29,266,15991
336250,2015,5,44,54,98,12637
336280,2014,5,51,25,76,54281
336300,2017,8,245,42,287,26034
336420,2015,6,293,76,369,73833
336440,2019,8,171,9,180,8151
336610,2014,8,362,28,390,32233
336700,2014,7,17,3,20,1518
336710,2015,7,18,4,22,11167
336730,2015,6,18,5,23,10542
336840,2015,7,21,3,24,1041
336940,2018,8,61,4,65,1650
337000,2016,5,13241,6096,19337,1155405
337040,2014,5,85,39,124,15443
337070,2015,5,234,109,343,9544
337110,2015,5,31,32,63,5335
337150,2014,8,548,76,624,74192
337180,2015,5,48,28,76,10776
337210,2015,5,82,52,134,8611
337220,2015,5,35,38,73,5478
337270,2015,8,180,29,209,17032
337280,2015,6,45,16,61,2581
337290,2018,8,66,5,71,5505
337340,2017,9,4689,84,4773,57511
337350,2015,8,156,7,163,6077
337360,2016,5,70,62,132,18795
337480,2015,6,164,43,207,21407
337490,2016,8,148,25,173,5467
337670,2015,7,32,1,33,3313
337680,2015,6,82,24,106,14447
337700,2015,5,17,8,25,727
337720,2016,8,126,2,128,2765
337820,2016,6,153,39,192,10977
337850,2015,8,112,19,131,22270
337960,2015,8,72,17,89,9847
337970,2015,5,8,5,13,5765
337980,2015,6,75,24,99,6578
338000,2015,8,687,58,745,132342
338040,2016,6,39,15,54,1906
338050,2015,5,234,117,351,93178
338120,2015,5,132,61,193,26025
338130,2016,5,101,45,146,25402
338170,2016,8,1835,328,2163,324272
338180,2015,5,1408,953,2361,445267
338190,2015,8,164,19,183,16676
338310,2016,8,46,6,52,6188
338320,2015,6,271,71,342,59406
338330,2018,7,25,4,29,1428
338390,2016,5,1094,490,1584,100047
338420,2015,5,79,37,116,10229
338530,2015,5,154,106,260,274955
338630,2015,5,16,8,24,2873
338810,2017,6,187,59,246,70254
338830,2014,5,21,16,37,3062
338890,2015,6,37,13,50,1809
338980,2015,6,90,25,115,14158
339000,2014,5,72,90,162,9853
339110,2016,5,15,14,29,5775
339120,2014,8,465,93,558,125823
339130,2015,8,326,23,349,22482
339160,2015,8,254,48,302,48498
339190,2015,8,462,81,543,34506
339200,2015,8,1136,278,1414,123228
339210,2015,5,94,68,162,22945
339230,2015,5,878,485,1363,73556
339250,2017,5,10,5,15,683
339280,2015,6,3346,1048,4394,884685
339290,2015,5,152,78,230,41169
339340,2016,8,1677,253,1930,199427
339350,2014,9,1526,46,1572,48543
339400,2015,8,1847,315,2162,129309
339440,2016,8,168,15,183,8893
339460,2015,7,27,4,31,6090
339500,2015,4,3,9,12,3115
339510,2014,8,103,20,123,12722
339570,2015,8,106,18,124,5548
339580,2016,6,390,115,505,41288
339590,2017,7,41,8,49,12031
339600,2015,5,1241,1150,2391,359362
339640,2015,5,72,58,130,8121
339690,2015,7,22,3,25,5339
339700,2015,5,84,51,135,10839
339710,2016,5,6,4,10,2242
339720,2018,7,16,3,19,824
339790,2015,8,263,40,303,32933
339800,2015,9,14868,549,15417,855769
339860,2015,3,7,32,39,45167
339910,2015,8,324,54,378,17727
340000,2016,8,488,49,537,44476
340030,2016,3,6,38,44,11312
340050,2015,6,1405,362,1767,173540
340070,2015,5,363,348,711,125900
340170,2015,5,1346,853,2199,164421
340220,2015,4,45,86,131,29819
340250,2015,7,14,1,15,4373
340270,2015,5,310,151,461,25027
340280,2015,8,226,19,245,26528
340320,2015,6,118,49,167,43837
340330,2015,6,16,5,21,5249
340340,2015,8,347,83,430,27311
340360,2015,8,191,30,221,19415
340370,2015,7,10,1,11,300
340380,2015,7,10,2,12,253
340390,2015,7,31,5,36,2885
340440,2018,6,28,9,37,5573
340450,2015,6,34,11,45,4460
340460,2015,5,302,375,677,71462
340470,2015,5,74,47,121,22219
340480,2015,5,11,6,17,580
340490,2016,8,597,125,722,74553
340520,2015,8,517,36,553,29519
340560,2016,5,4,6,10,431
340580,2017,8,241,29,270,19799
340600,2015,7,20,4,24,2067
340630,2015,4,34,106,140,4966
340650,2015,5,66,67,133,318054
340680,2016,7,9,2,11,1158
340720,2015,7,24,3,27,3522
340730,2015,8,699,120,819,78222
340750,2015,5,15,17,32,8466
340770,2016,6,221,57,278,24606
340830,2015,8,321,65,386,41903
340880,2015,7,21,3,24,986
340960,2015,7,36,6,42,876
341000,2016,8,2814,296,3110,176745
341020,2015,6,160,61,221,13320
341030,2015,5,111,71,182,11965
341040,2017,6,39,12,51,1364
341090,2015,8,188,25,213,36714
341120,2015,8,213,23,236,34233
341150,2015,8,184,22,206,14837
341270,2016,5,13,10,23,1941
341290,2016,7,13,2,15,723
341310,2015,6,1036,366,1402,256746
341360,2015,5,8,7,15,1114
341440,2015,5,36,46,82,3403
341470,2015,6,57,24,81,7733
341500,2015,6,1017,375,1392,264412
341510,2015,7,33,8,41,9708
341530,2015,8,69,17,86,26883
341550,2015,8,347,35,382,26893
341570,2022,6,19,5,24,923
341680,2015,8,50,8,58,5581
341690,2015,5,35,16,51,4521
341710,2018,6,134,54,188,10429
341730,2015,8,266,50,316,27992
341750,2015,5,10,7,17,938
341760,2015,7,15,1,16,828
341780,2015,5,27,19,46,44421
341800,2015,9,4538,78,4616,836026
341820,2015,8,55,10,65,3445
341860,2015,5,110,83,193,29061
341870,2015,6,296,98,394,30643
341930,2015,5,34,32,66,4693
341940,2015,6,4528,1305,5833,240088
341950,2015,6,150,44,194,27616
342020,2015,5,79,55,134,21325
342090,2015,4,20,35,55,12807
342100,2015,7,28,5,33,2078
342130,2016,5,19,10,29,5952
342150,2017,5,303,222,525,121259
342180,2016,8,2584,400,2984,168513
342190,2017,6,91,23,114,7468
342200,2015,6,3761,1188,4949,787170
342240,2015,5,12,10,22,9735
342260,2015,6,213,65,278,20728
342280,2015,8,97,14,111,6009
342300,2015,8,606,50,656,54495
342310,2019,5,406,183,589,28754
342350,2015,8,122,28,150,12851
342450,2015,5,38,40,78,3197
342480,2016,5,653,299,952,241759
342490,2015,8,134,29,163,6681
342500,2015,4,13,23,36,5481
342520,2015,4,16,54,70,2230
342530,2015,8,60,9,69,2875
342550,2016,5,112,72,184,4951
342560,2018,9,1178,39,1217,53190
342570,2015,4,176,273,449,104751
342580,2015,8,2198,141,2339,163052
342610,2015,8,174,15,189,15290
342620,2015,8,334,64,398,49201
342650,2015,6,28,12,40,11135
342870,2015,4,22,36,58,1296
342920,2015,7,35,2,37,2946
342970,2016,5,147,69,216,63213
343020,2015,7,9,1,10,4973
343070,2015,5,100,80,180,10027
343090,2015,8,205,29,234,29741
343100,2015,6,796,212,1008,122039
343170,2015,5,20,21,41,5845
343280,2015,5,106,63,169,62971
343340,2015,4,35,59,94,29598
343370,2015,8,88,5,93,4612
343430,2015,7,16,4,20,764
343440,2015,8,513,87,600,69406
343560,2015,8,315,39,354,40072
343570,2015,7,23,2,25,676
343710,2015,5,1507,681,2188,191890
343780,2015,8,1513,132,1645,136685
343860,2017,8,1495,237,1732,76114
343930,2015,6,131,54,185,47698
344130,2015,6,205,86,291,129283
344190,2015,6,169,67,236,55658
344230,2015,6,147,41,188,86402
344240,2017,5,338,164,502,24324
344270,2015,7,13,3,16,1380
344300,2015,5,141,76,217,140919
344340,2015,8,101,22,123,9338
344410,2015,6,165,68,233,16474
344480,2015,8,173,2,175,9334
344500,2015,5,95,57,152,14507
344740,2017,8,554,92,646,43874
344770,2015,9,1564,29,1593,50759
344840,2015,5,98,127,225,19612
344850,2015,6,932,294,1226,227897
344860,2015,8,190,13,203,14530
344880,2015,5,47,26,73,18139
344890,2015,5,24,21,45,2040
344910,2015,5,349,205,554,139973
344960,2015,7,9,2,11,204
345010,2016,6,215,87,302,11661
345060,2015,8,142,33,175,18427
345080,2015,6,97,36,133,14214
345090,2015,8,279,66,345,33457
345120,2015,8,334,42,376,47724
345180,2015,8,3812,482,4294,453908
345200,2015,8,252,26,278,30997
345220,2015,5,397,228,625,185890
345230,2018,5,22,12,34,511
345330,2019,8,93,17,110,5154
345340,2015,6,14,4,18,1723
345350,2015,8,1894,458,2352,232259
345390,2015,8,1593,204,1797,166533
345430,2019,8,177,16,193,6242
345480,2016,6,55,17,72,4214
345540,2015,6,81,21,102,9839
345640,2015,5,40,30,70,4810
345660,2015,6,933,325,1258,64247
345700,2016,5,75,40,115,4474
345710,2015,4,17,49,66,2026
345750,2015,5,49,55,104,11727
345820,2015,8,1276,77,1353,136580
345860,2015,8,168,32,200,25940
345990,2016,6,27,9,36,3019
346040,2015,4,56,99,155,12234
346090,2015,7,40,4,44,4236
346110,2017,5,120478,53229,173707,9103947
346120,2015,8,2946,508,3454,670347
346180,2015,6,526,142,668,60869
346210,2015,6,79,23,102,136398
346330,2022,5,1918,900,2818,774021
346340,2015,6,22,6,28,2422
346370,2015,4,110,371,481,11702
346420,2015,6,193,64,257,28907
346440,2015,6,21,8,29,1859
346450,2015,5,52,26,78,4219
346470,2015,8,279,22,301,23400
346490,2015,5,4,6,10,945
346500,2018,7,33,1,34,1212
346510,2015,7,30,3,33,2254
346560,2015,8,1214,72,1286,79286
346610,2016,5,38,27,65,4253
346630,2015,6,253,73,326,95478
346670,2015,4,8,17,25,784
346730,2015,8,756,86,842,40686
346770,2015,8,49,5,54,1587
346780,2015,8,47,4,51,49325
346800,2015,4,23,43,66,1655
346810,2015,8,414,81,495,52321
346830,2015,5,147,85,232,31223
346850,2015,8,283,25,308,35574
346900,2015,8,31115,3646,34761,3759378
346940,2015,8,1973,319,2292,268438
346970,2020,8,220,30,250,17232
347000,2018,5,57,25,82,2382
347040,2015,7,40,9,49,15727
347060,2016,5,36,34,70,5043
347160,2015,8,522,71,593,50672
347280,2016,6,26,11,37,1197
347290,2017,6,354,146,500,24511
347330,2016,7,10,1,11,1842
347400,2015,6,84,22,106,5743
347430,2015,8,1357,247,1604,162472
347440,2015,6,109,43,152,10283
347470,2015,8,52,3,55,2494
347480,2015,5,5,7,12,535
347510,2015,8,222,26,248,34565
347520,2015,7,36,4,40,3831
347560,2015,5,616,289,905,433639
347600,2017,8,199,35,234,7231
347670,2015,8,365,68,433,18440
347690,2015,5,33,16,49,2100
347710,2015,6,96,27,123,7296
347720,2016,8,187,18,205,6253
347730,2015,7,34,3,37,2553
347790,2015,6,31,8,39,2448
347830,2015,8,1854,181,2035,136968
348030,2016,5,176,129,305,10204
348160,2017,7,40,3,43,1136
348180,2015,5,32,22,54,10323
348200,2015,8,209,32,241,12031
348240,2015,8,168,26,194,10909
348270,2015,5,54,48,102,4606
348280,2015,7,18,4,22,537
348300,2015,8,51,7,58,12364
348340,2015,6,88,35,123,13472
348360,2015,6,402,128,530,60790
348400,2015,5,46,27,73,6943
348430,2015,8,55,1,56,3529
348440,2015,8,72,4,76,3692
348460,2016,5,239,275,514,101843
348470,2015,6,672,187,859,50954
348490,2015,8,117,27,144,10695
348510,2015,4,156,269,425,40098
348530,2015,5,14,18,32,27165
348540,2015,5,157,72,229,107164
348550,2015,8,588,51,639,98108
348650,2015,4,19,47,66,7177
348670,2016,5,772,544,1316,143017
348700,2015,5,64,42,106,25656
348710,2015,8,1391,130,1521,54545
348730,2015,5,49,69,118,46141
348740,2016,7,8,2,10,2664
348800,2017,7,14,1,15,6811
348820,2015,8,164,14,178,15378
348840,2015,7,12,1,13,3912
348980,2015,4,3,11,14,1391
349020,2015,5,27,13,40,6716
349040,2016,8,12999,2719,15718,965482
349140,2015,6,96,41,137,18778
349190,2015,6,23,9,32,1237
349220,2015,8,414,40,454,37979
349250,2018,8,109,2,111,3097
349260,2015,5,48,26,74,14958
349460,2015,5,13,8,21,18637
349530,2015,6,19,8,27,1123
349540,2015,4,18,28,46,6477
349550,2015,5,42,27,69,7359
349680,2015,8,195,8,203,16903
349690,2015,7,32,1,33,3790
349760,2015,8,71,1,72,11438
349790,2017,8,101,23,124,10161
349840,2015,5,19,16,35,3378
349950,2015,4,17,43,60,12773
350010,2015,5,219,268,487,45350
350020,2015,5,128,73,201,36405
350080,2015,8,5425,703,6128,600610
350090,2016,5,18,14,32,3012
350110,2016,5,181,216,397,39288
350210,2015,7,34,6,40,2381
350310,2015,5,157,106,263,13303
350480,2016,7,30,6,36,1122
350490,2015,4,10,17,27,1177
350530,2015,4,49,81,130,18393
350600,2016,5,115,57,172,6422
350610,2015,7,30,3,33,1698
350620,2015,8,44,7,51,4059
350630,2015,6,53,17,70,5987
350640,2016,6,1673,570,2243,144312
350740,2016,8,864,77,941,57122
350770,2015,5,77,37,114,6074
350780,2015,6,107,30,137,6040
350810,2015,6,533,171,704,157568
350880,2017,7,17,4,21,604
350970,2015,8,249,56,305,16926
351030,2022,6,732,298,1030,461488
351050,2015,5,36,17,53,9298
351090,2015,8,320,18,338,28359
351100,2018,8,457,75,532,35601
351140,2015,5,190,152,342,147269
351150,2015,5,333,150,483,97066
351230,2015,8,108,13,121,6646
351240,2015,7,34,5,39,6241
351250,2015,8,150,24,174,31172
351290,2019,5,3571,3213,6784,192819
351300,2015,5,67,49,116,7021
351320,2016,7,14,2,16,392
351330,2016,7,23,4,27,1029
351340,2015,6,395,133,528,26335
351400,2015,5,36,36,72,28342
351450,2015,5,60,38,98,11212
351480,2015,8,241,16,257,15054
351490,2015,8,811,184,995,173820
351630,2016,5,88,94,182,45681
351710,2015,8,1979,153,2132,131949
351720,2016,7,31,7,38,21144
351730,2016,5,72,46,118,7541
351800,2015,6,1275,320,1595,141778
351910,2015,5,378,342,720,103074
351920,2016,9,2053,67,2120,88976
351940,2016,8,1127,175,1302,633209
351970,2015,8,4844,834,5678,410109
351990,2016,8,1035,177,1212,51129
352010,2015,5,192,89,281,34686
352070,2015,8,122,9,131,11484
352210,2015,7,15,3,18,1347
352220,2015,8,184,43,227,41509
352240,2016,5,76,46,122,6719
352370,2016,6,31,11,42,2896
352400,2015,8,2053,339,2392,343167
352430,2019,5,103,56,159,7664
352460,2017,5,2733,1411,4144,331065
352520,2015,8,4018,253,4271,138573
352550,2017,4,695,1337,2032,65065
352580,2015,6,44,17,61,4396
352610,2015,8,97,9,106,5853
352620,2015,8,78,14,92,13644
352740,2015,5,11,5,16,916
352760,2015,6,17,6,23,3905
352780,2015,8,176,23,199,9782
352790,2016,6,12,5,17,1826
352850,2015,5,16,16,32,1914
352890,2016,6,192,61,253,19612
352900,2015,5,22,21,43,11346
352960,2015,5,68,47,115,9363
353090,2015,8,350,10,360,25441
353130,2016,5,990,506,1496,402752
353190,2016,5,151,84,235,9210
353330,2015,9,705,37,742,18697
353340,2015,6,19,5,24,695
353550,2015,5,340,164,504,94279
353580,2016,8,118,17,135,6060
353630,2016,5,72,67,139,14452
353640,2015,8,1293,153,1446,161824
353700,2016,8,821,100,921,61366
353890,2016,6,54,14,68,2953
353940,2015,6,40,15,55,2450
354030,2015,5,25,11,36,9179
354040,2015,7,22,3,25,15585
354050,2015,5,12,9,21,1436
354160,2015,5,225,200,425,36749
354180,2015,5,38,21,59,8943
354200,2015,5,629,412,1041,116828
354230,2015,6,23,7,30,2106
354240,2015,8,2041,338,2379,226838
354280,2016,7,14,2,16,754
354400,2016,8,205,8,213,8642
354650,2015,8,510,93,603,12777
354740,2016,8,75,5,80,6386
354770,2015,7,18,2,20,686
354860,2016,6,266,82,348,69112
354930,2015,5,10,7,17,7465
354950,2015,6,45,14,59,8832
354970,2015,5,48,28,76,4047
355010,2017,6,50,19,69,5714
355050,2015,8,824,76,900,40265
355060,2016,5,237,221,458,26820
355080,2015,4,6,10,16,2945
355100,2015,5,30,25,55,7749
355130,2015,6,274,89,363,40514
355180,2017,8,9177,1994,11171,2044268
355240,2015,6,144,43,187,19679
355270,2015,8,167,36,203,3816
355280,2017,7,37,8,45,32754
355310,2016,5,27,14,41,1116
355370,2017,7,27,3,30,1444
355410,2015,8,110,22,132,42936
355510,2016,5,11,16,27,1460
355520,2015,6,230,70,300,56917
355530,2015,8,242,45,287,31002
355630,2015,8,185,15,200,10581
355690,2016,7,14,2,16,1008
355790,2017,8,1081,264,1345,142380
355800,2016,5,439,246,685,73251
355840,2015,5,8320,7995,16315,2337644
355860,2015,6,221,72,293,15560
355910,2015,7,17,3,20,984
355920,2016,8,187,23,210,106799
355970,2015,6,307,95,402,20436
355980,2015,9,755,20,775,45531
356000,2015,6,76,22,98,6189
356050,2015,5,575,276,851,46737
356070,2015,8,890,118,1008,19124
356090,2015,7,25,1,26,834
356100,2015,7,40,5,45,2360
356110,2015,7,12,1,13,397
356130,2015,5,307,296,603,176643
356170,2015,7,11,2,13,1366
356190,2017,6,13464,3940,17404,952284
356310,2015,5,654,668,1322,266981
356400,2016,8,1481,114,1595,95420
356420,2015,8,240,38,278,63199
356450,2018,8,50,9,59,1114
356460,2016,7,23,5,28,1124
356510,2015,8,557,105,662,4208
356520,2015,8,848,98,946,48284
356530,2015,8,131,15,146,10752
356540,2015,6,19,8,27,6543
356550,2015,6,16,5,21,3253
356560,2015,7,19,4,23,3282
356570,2015,8,4056,566,4622,367745
356790,2015,8,52,7,59,12368
356800,2015,5,9,10,19,1588
356890,2015,6,102,36,138,14833
356910,2015,5,59,27,86,11480
357010,2016,7,29,6,35,2048
357030,2016,6,16,6,22,1953
357070,2015,8,1525,158,1683,110025
357120,2016,6,123,34,157,19142
357190,2017,8,1170,172,1342,126699
357200,2015,4,16,37,53,24960
357280,2015,5,314,143,457,112559
357300,2015,8,557,40,597,47703
357310,2017,6,978,259,1237,71974
357320,2015,5,26,18,44,1045
357340,2016,8,488,47,535,38592
357480,2015,5,1024,741,1765,139766
357490,2016,7,14,2,16,2433
357600,2015,8,243,12,255,23419
357650,2017,6,167,60,227,13345
357670,2016,6,115,49,164,18658
357690,2015,6,24,9,33,747
357720,2015,8,303,34,337,15660
357750,2015,7,17,2,19,506
357780,2015,8,689,157,846,117960
357830,2015,5,24,13,37,4016
357840,2015,5,27,16,43,1270
357890,2015,8,48,4,52,3453
357900,2015,5,499,601,1100,306739
358030,2015,7,25,1,26,993
358070,2015,8,92,6,98,10071
358080,2016,5,107,78,185,165616
358090,2015,8,1198,259,1457,69125
358130,2016,8,1404,158,1562,124777
358460,2016,6,157,62,219,28318
358650,2015,8,148,22,170,19267
358750,2016,8,471,83,554,42444
358760,2016,7,14,3,17,448
358810,2015,8,84,15,99,6669
358830,2016,8,168,23,191,15166
358960,2015,8,154,26,180,20642
359050,2015,9,7202,365,7567,401903
359060,2015,4,28,46,74,12124
359100,2018,8,235,32,267,7638
359140,2016,8,339,15,354,12562
359190,2015,5,122,69,191,9711
359230,2015,6,506,206,712,46328
359250,2015,5,42,19,61,19479
359260,2015,5,13,9,22,17674
359280,2015,5,45,20,65,8988
359310,2015,8,2510,366,2876,231468
359340,2017,7,10,2,12,2459
359350,2016,8,246,53,299,27778
359390,2015,8,1537,92,1629,85901
359400,2015,8,217,10,227,7355
359420,2017,7,19,1,20,651
359450,2015,5,12,7,19,2707
359560,2015,6,127,35,162,12473
359580,2015,5,244,148,392,57964
359670,2015,5,9,5,14,3383
359810,2015,5,221,97,318,34300
359840,2017,8,178,14,192,23270
359870,2016,8,5453,506,5959,568989
359900,2015,5,357,262,619,61729
359920,2015,8,169,34,203,11350
359940,2017,6,116,49,165,6625
359960,2015,5,122,58,180,56825
360010,2015,8,55,10,65,22000
360030,2015,5,16,7,23,2619
360150,2015,5,564,462,1026,94526
360170,2016,6,5136,2120,7256,2150505
360380,2015,5,525,261,786,203135
360390,2015,5,47,35,82,22310
360430,2020,5,11148,11890,23038,855604
360450,2015,8,122,29,151,14939
360550,2015,8,128,17,145,3693
360580,2015,5,18,20,38,1840
360590,2015,2,14,96,110,13044
360640,2015,8,1513,153,1666,177179
360650,2015,8,646,97,743,111056
360730,2015,6,417,175,592,65569
360740,2015,9,3763,115,3878,287413
360830,2017,6,1928,532,2460,156754
360840,2015,8,90,10,100,8176
360870,2015,8,964,190,1154,150511
360880,2016,5,19,23,42,7388
360940,2015,6,1946,665,2611,169424
361040,2016,8,214,11,225,6631
361130,2015,5,28,18,46,3042
361160,2015,7,9,2,11,4619
361190,2015,5,252,149,401,110421
361200,2015,5,43,37,80,9409
361230,2018,8,58,1,59,692
361280,2016,8,2637,291,2928,452658
361300,2016,8,2149,352,2501,157371
361350,2016,8,57,7,64,3150
361360,2015,8,90,12,102,6525
361370,2017,3,1,10,11,430
361430,2015,5,18,14,32,2033
361550,2015,6,830,312,1142,35377
361560,2015,4,9,31,40,1159
361630,2015,8,1057,193,1250,146246
361950,2015,7,25,6,31,3487
361990,2015,8,716,64,780,91287
362090,2015,8,180,23,203,18243
362290,2015,8,42,8,50,8764
362310,2018,7,31,6,37,2741
362380,2016,7,17,2,19,4132
362410,2015,5,102,50,152,17465
362610,2015,5,104,118,222,164487
362660,2015,5,77,40,117,27355
362680,2015,9,3905,148,4053,186371
362810,2015,8,203,39,242,15647
362830,2015,4,19,32,51,4326
362860,2015,8,68,14,82,4625
362890,2020,8,10666,604,11270,595780
362960,2016,8,5133,802,5935,562631
363130,2015,5,686,344,1030,37898
363180,2015,6,18,7,25,2721
363240,2015,6,44,16,60,11489
363270,2016,5,35,22,57,7312
363330,2015,8,359,47,406,46314
363410,2015,6,149,47,196,14231
363420,2016,8,279,25,304,20602
363430,2015,5,21,31,52,3109
363440,2015,8,1157,275,1432,134259
363460,2015,8,312,54,366,22595
363500,2015,7,25,3,28,1294
363510,2015,5,38,41,79,25664
363520,2016,6,164,69,233,17630
363530,2016,4,62,184,246,5592
363580,2015,7,15,3,18,6476
363600,2015,6,903,309,1212,154592
363620,2015,5,419,185,604,92562
363650,2015,5,23,22,45,2652
363680,2016,5,2763,1239,4002,321637
363790,2015,6,365,99,464,31654
363930,2016,8,2383,487,2870,122734
363940,2015,5,31,34,65,9143
363950,2019,8,124,8,132,3682
363960,2015,4,25,42,67,3700
363970,2015,8,38021,4128,42149,4338397
363980,2015,8,203,34,237,13357
364050,2017,6,870,222,1092,61819
364060,2015,6,21,9,30,2628
364100,2015,6,15,6,21,1069
364130,2015,5,12,7,19,761
364200,2016,7,43,5,48,3954
364230,2016,8,192,6,198,15643
364250,2015,7,26,4,30,3123
364300,2016,5,209,95,304,13915
364350,2015,5,22,16,38,8624
364360,2016,6,27628,8776,36404,2085605
364390,2016,8,428,30,458,12578
364630,2017,6,104,33,137,8469
364640,2015,5,196,88,284,22072
364690,2015,4,384,630,1014,144865
364720,2016,7,10,1,11,835
364740,2017,7,11,1,12,119196
364770,2015,7,36,8,44,6045
364790,2015,6,11,3,14,3211
364830,2016,8,50,3,53,5025
364840,2015,7,23,3,26,2049
364900,2015,4,6,21,27,4511
364910,2016,5,61,66,127,58611
364930,2015,8,654,47,701,39150
365020,2015,5,279,151,430,17477
365060,2015,7,12,3,15,353
365070,2015,5,450,331,781,66097
365090,2015,7,22,2,24,985
365120,2015,6,52,18,70,5812
365150,2015,5,16,18,34,863
365160,2017,8,972,154,1126,52920
365190,2016,8,164,28,192,20949
365200,2016,4,5,10,15,448
365210,2015,8,65,7,72,4637
365260,2015,8,56,11,67,8090
365280,2015,5,26,23,49,4212
365300,2016,8,6727,416,7143,625220
365320,2015,5,71,32,103,2854
365330,2015,5,33,23,56,3223
365340,2015,5,13,14,27,996
365350,2015,8,81,12,93,6309
365360,2017,8,3877,481,4358,139426
365440,2016,5,21,10,31,3616
365450,2015,8,9070,617,9687,877129
365480,2015,5,40,23,63,8987
365500,2015,7,28,4,32,1173
365560,2015,5,66,34,100,7905
365680,2015,5,43,21,64,10880
365760,2015,6,37,14,51,2207
365770,2015,6,410,112,522,82652
365800,2015,5,47,28,75,9022
365810,2017,6,454,174,628,37128
365860,2015,8,41,10,51,7185
365870,2015,8,74,7,81,4759
365880,2015,6,68,25,93,7992
365900,2015,8,162,17,179,13983
365960,2015,8,763,158,921,75347
366000,2022,8,132,20,152,6179
366040,2015,8,132,21,153,13305
366090,2017,8,1358,220,1578,130016
366180,2016,5,43,20,63,8003
366210,2015,7,38,7,45,10724
366230,2016,6,28,10,38,6226
366240,2016,6,87,25,112,5045
366250,2015,8,966,100,1066,156631
366260,2016,8,158,25,183,21016
366270,2016,7,42,7,49,6224
366280,2016,6,72,19,91,8061
366320,2016,8,1062,209,1271,98326
366350,2015,5,11,14,25,779
366440,2016,5,762,571,1333,105183
366510,2015,6,59,23,82,3684
366590,2015,7,25,1,26,1584
366600,2015,5,4,6,10,2252
366620,2016,7,31,5,36,6461
366640,2017,6,138,52,190,14015
366690,2016,6,61,18,79,4240
366760,2016,6,465,164,629,180595
366780,2016,7,25,1,26,2041
366860,2015,5,22,11,33,1128
366870,2017,8,284,66,350,14326
366910,2017,5,729,337,1066,48486
366970,2015,8,188,13,201,12843
367000,2015,8,314,42,356,26547
367030,2015,5,34,15,49,3144
367050,2015,7,10,1,11,324
367080,2017,8,127,22,149,10341
367110,2015,6,75,23,98,4390
367120,2015,8,1483,237,1720,167485
367140,2016,7,38,3,41,1216
367240,2018,5,20,29,49,5040
367260,2015,7,24,6,30,2050
367300,2015,8,93,13,106,14846
367350,2015,8,45,9,54,9988
367430,2015,7,40,3,43,4841
367450,2016,8,2802,325,3127,806360
367500,2016,8,10682,1263,11945,970603
367520,2017,9,21467,959,22426,999648
367570,2015,8,709,62,771,40351
367580,2015,9,5799,166,5965,168568
367700,2015,4,13,52,65,3819
367710,2015,5,42,38,80,2290
367780,2015,5,55,36,91,9665
367800,2015,6,7,3,10,442
367990,2015,4,4,15,19,913
368000,2017,6,41,12,53,5042
368050,2015,6,76,23,99,9023
368070,2017,5,2354,1915,4269,228348
368080,2016,6,138,58,196,21510
368140,2015,7,40,9,49,3603
368180,2017,8,129,23,152,10894
368230,2015,8,7672,1006,8678,1120501
368250,2015,7,23,5,28,3908
368290,2015,5,40,21,61,5513
368310,2015,7,9,2,11,1182
368360,2015,6,3870,1111,4981,578493
368370,2015,8,4432,482,4914,305686
368390,2017,8,412,16,428,10229
368430,2016,6,337,105,442,16808
368450,2015,5,107,73,180,8682
368570,2016,8,231,13,244,8129
368590,2015,5,325,160,485,103455
368610,2015,8,213,17,230,18451
368640,2016,8,196,41,237,14141
368650,2015,8,500,41,541,37880
368680,2016,8,68,2,70,3687
368690,2015,5,7,7,14,729
368700,2015,7,15,3,18,5826
368710,2015,6,46,19,65,28945
368720,2015,5,99,71,170,41241
368730,2015,6,1323,337,1660,360564
368740,2016,6,144,54,198,14810
368760,2015,5,14,13,27,2157
368770,2015,5,19,16,35,3958
368780,2015,5,21,19,40,4960
368800,2016,8,111,17,128,8051
368830,2015,8,68,12,80,6664
368890,2015,8,81,5,86,5003
368950,2015,8,1442,97,1539,107768
368970,2015,5,17,8,25,28368
368980,2015,5,43,37,80,6567
369000,2015,5,296,128,424,45686
369030,2016,5,136,91,227,23830
369060,2015,4,11,22,33,7128
369070,2016,6,830,334,1164,61787
369180,2015,5,39,44,83,5238
369230,2016,5,21,16,37,1394
369290,2015,8,167,38,205,22320
369310,2015,7,17,1,18,7528
369360,2015,4,11,24,35,15153
369400,2015,6,707,206,913,137568
369420,2015,8,397,29,426,34059
369530,2020,8,156,14,170,8293
369550,2016,8,138,23,161,7859
369560,2018,8,91,16,107,6422
369570,2015,6,29,10,39,937
369580,2015,8,2287,323,2610,90470
369890,2015,6,112,42,154,21388
369990,2016,8,2463,375,2838,211874
370020,2015,9,608,30,638,33996
370050,2015,7,35,2,37,29200
370060,2016,8,185,33,218,14412
370070,2015,8,124,28,152,22616
370080,2015,7,42,5,47,2636
370090,2015,5,239,105,344,69101
370130,2016,5,19,16,35,10020
370150,2015,8,85,3,88,5119
370170,2015,5,14,9,23,32197
370220,2015,5,18,27,45,1219
370240,2015,5,3504,3436,6940,469791
370280,2016,8,1223,71,1294,19363
370300,2015,8,56,11,67,11092
370360,2015,9,2216,76,2292,235754
370440,2017,5,123,68,191,3131
370460,2015,8,232,33,265,40038
370480,2015,8,92,8,100,9170
370550,2015,8,71,8,79,10378
370590,2015,5,33,21,54,15145
370600,2015,5,24,27,51,1203
370640,2015,5,21,12,33,3847
370670,2016,8,88,2,90,1360
370770,2021,8,605,135,740,155749
370840,2016,5,40,29,69,2688
370910,2016,8,968,61,1029,49640
370920,2015,8,78,13,91,8291
370940,2016,7,45,4,49,8043
371000,2015,5,21,21,42,9091
371010,2016,5,94,46,140,7708
371100,2015,8,128,22,150,17787
371120,2015,5,51,33,84,7703
371140,2018,8,67,11,78,6312
371180,2015,8,423,47,470,34774
371200,2016,8,1012,189,1201,125302
371220,2015,5,49,43,92,6791
371280,2015,5,12,9,21,2629
371300,2015,8,109,26,135,9793
371320,2015,7,20,1,21,3577
371330,2015,6,227,80,307,150672
371410,2015,5,8,11,19,4868
371420,2015,6,534,160,694,92319
371450,2015,6,143,42,185,18264
371460,2015,6,61,26,87,52886
371500,2015,8,345,38,383,16916
371520,2017,6,454,164,618,56228
371530,2015,7,18,1,19,846
371550,2015,6,126,32,158,15551
371570,2015,6,770,252,1022,154692
371880,2016,6,42,11,53,4251
371890,2015,6,81,28,109,10250
371900,2015,5,27,13,40,25675
371970,2015,8,923,112,1035,96949
372080,2017,7,29,4,33,1549
372150,2015,4,8,25,33,6688
372160,2016,5,10,13,23,489
372250,2015,7,24,5,29,1901
372330,2017,5,37,21,58,10696
372350,2016,8,78,10,88,3009
372360,2016,8,1629,372,2001,221667
372380,2015,6,44,17,61,2777
372430,2016,4,5,10,15,398
372490,2016,5,64,38,102,59606
372540,2016,5,1021,478,1499,42192
372690,2016,8,149,31,180,7106
372740,2015,4,14,32,46,5450
372750,2016,5,58,86,144,32912
372780,2015,5,27,20,47,2070
372800,2015,6,1530,396,1926,368618
372820,2015,5,69,76,145,29213
372830,2015,8,81,18,99,8899
372930,2015,8,117,13,130,10774
372940,2015,8,155,5,160,10456
372960,2015,7,19,1,20,1470
372970,2015,7,30,7,37,2957
373290,2015,5,38,33,71,32468
373360,2015,5,86,47,133,19151
373390,2015,9,1454,49,1503,24239
373420,2015,8,8398,866,9264,1501547
373480,2016,5,92,55,147,13878
373600,2015,7,39,4,43,7751
373610,2015,8,60,13,73,8356
373620,2015,7,32,7,39,10994
373630,2015,7,23,5,28,5732
373650,2016,6,72,26,98,7438
373720,2016,5,175,100,275,62827
373770,2016,9,2083,74,2157,101532
373880,2016,4,9,17,26,711
373920,2016,5,121,97,218,7148
373930,2017,6,1856,703,2559,117416
373970,2015,8,242,23,265,42227
373990,2016,6,120,47,167,19193
374030,2016,5,1091,530,1621,49839
374040,2017,8,9296,1936,11232,914016
374050,2016,5,35,26,61,4253
374060,2015,6,136,44,180,8898
374150,2016,7,17,2,19,1986
374170,2016,5,15,12,27,1328
374280,2021,5,1065,828,1893,36346
374320,2016,8,74255,6992,81247,3294533
374410,2015,8,209,11,220,18734
374520,2016,5,60,63,123,7333
374640,2015,4,24,45,69,3663
374670,2016,8,790,142,932,60741
374680,2015,5,8,4,12,285
374830,2015,6,199,50,249,71784
374900,2016,6,549,147,696,66443
374950,2015,5,37,46,83,4981
374990,2015,5,5,5,10,399
375000,2015,5,7,4,11,2467
375010,2015,5,140,63,203,223594
375030,2015,6,147,37,184,5971
375040,2015,5,24,17,41,6906
375120,2015,8,159,30,189,15551
375130,2015,8,209,9,218,10854
375170,2015,6,26,7,33,4909
375210,2016,8,46,5,51,2054
375230,2016,5,4851,5089,9940,502562
375290,2015,6,18,6,24,13579
375320,2015,5,40,28,68,39391
375330,2015,5,27,27,54,3871
375420,2015,5,18,9,27,7592
375430,2015,5,6,4,10,3169
375460,2015,4,500,762,1262,174632
375480,2020,9,984,43,1027,38212
375520,2015,6,106,27,133,50494
375530,2018,8,1370,131,1501,40073
375580,2017,6,34,13,47,16792
375600,2015,6,617,233,850,146974
375680,2016,4,86,198,284,159054
375710,2015,5,219,124,343,41204
375750,2017,8,205,15,220,18155
375770,2015,5,25,11,36,12680
375790,2015,5,13,8,21,6094
375820,2015,8,1842,119,1961,211410
375840,2015,8,174,27,201,26825
375850,2015,5,40,39,79,74862
375910,2015,5,1752,1067,2819,200623
375950,2015,8,4856,494,5350,587504
376150,2015,4,13,30,43,1508
376250,2016,6,32,10,42,5444
376300,2015,8,1761,134,1895,136267
376310,2016,4,187,336,523,24995
376450,2016,5,32,15,47,2807
376520,2016,8,260,32,292,22421
376560,2015,8,77,14,91,5536
376570,2016,6,2824,1158,3982,857109
376680,2015,6,70,29,99,11482
376870,2015,6,5121,1664,6785,346763
376880,2016,6,43,16,59,3666
377060,2017,6,162,61,223,4562
377070,2015,7,21,3,24,3170
377080,2015,8,260,20,280,26704
377140,2016,5,334,244,578,20087
377160,2015,6,92044,38135,130179,6601188
377190,2015,7,31,7,38,8326
377200,2015,7,11,1,12,647
377250,2018,7,16,1,17,503
377260,2018,5,145,70,215,64192
377280,2015,6,17,5,22,1235
377310,2015,5,143,105,248,342253
377320,2017,7,13,3,16,144
377330,2015,8,566,74,640,74268
377450,2015,8,68,2,70,8444
377470,2015,5,75,44,119,10804
377480,2016,5,82,39,121,6239
377550,2015,6,18,5,23,969
377690,2016,8,134,8,142,8126
377840,2016,8,3430,261,3691,333922
377860,2015,9,699,21,720,41705
377870,2015,8,338,56,394,27685
377880,2016,8,132,21,153,7768
377900,2015,6,459,148,607,65176
377970,2015,5,137,59,196,12001
377980,2016,5,34,30,64,9041
378030,2015,7,39,5,44,1890
378070,2016,6,37,11,48,1344
378080,2015,8,56,12,68,11922
378100,2015,5,228,268,496,207618
378260,2016,6,61,19,80,7766
378270,2015,5,222,109,331,103963
378280,2015,5,19,20,39,971
378350,2017,7,11,2,13,333
378370,2015,5,1712,1120,2832,371579
378540,2017,6,2236,703,2939,161690
378630,2015,6,41,13,54,3066
378660,2015,5,792,419,1211,35018
378700,2016,5,21,10,31,510
378720,2015,8,2237,204,2441,176523
378750,2015,8,91,5,96,9605
378770,2015,8,70,4,74,4448
378800,2016,5,192,104,296,18471
378810,2016,7,32,8,40,7750
378830,2015,5,25,14,39,6074
378850,2015,8,56,10,66,1798
378860,2017,6,2828,1102,3930,264945
378930,2016,5,69,32,101,8135
379290,2015,5,58,60,118,39922
379320,2015,6,66,18,84,30416
379340,2015,5,5,5,10,222
379390,2015,7,11,2,13,550
379420,2016,8,94,13,107,7665
379430,2018,6,19839,5990,25829,827988
379520,2015,7,27,4,31,2828
379530,2015,8,84,21,105,12085
379610,2016,7,36,4,40,2039
379640,2015,8,197,18,215,13614
379720,2016,8,55864,4112,59976,3197626
379760,2015,7,42,6,48,1112
379990,2015,4,12,31,43,6901
380020,2015,5,509,220,729,122540
380100,2016,7,12,1,13,1610
380150,2015,8,830,179,1009,47422
380210,2015,5,12,9,21,3776
380220,2016,5,482,222,704,60211
380360,2015,6,578,202,780,197435
380540,2015,5,23,17,40,1089
380550,2015,5,46,27,73,30753
380560,2015,5,14,8,22,1375
380660,2016,8,56,7,63,1738
380670,2016,8,303,15,318,31446
380690,2015,5,12,11,23,6212
380700,2015,5,23,16,39,9629
380750,2016,6,286,112,398,20773
380810,2017,8,75,1,76,1986
380860,2017,7,20,5,25,504
380920,2017,7,37,6,43,967
380990,2015,5,17,16,33,1157
381020,2017,8,547,41,588,31731
381050,2015,6,42,17,59,1651
381090,2015,5,26,21,47,2223
381100,2015,8,194,37,231,12945
381120,2016,5,1379,839,2218,193100
381130,2015,4,10,29,39,623
381140,2015,5,164,73,237,32780
381170,2015,5,29,28,57,23756
381210,2016,6,95679,28932,124611,5757369
381220,2015,5,35,28,63,9844
381260,2015,5,101,45,146,9754
381320,2016,8,53,13,66,5496
381340,2016,7,18,1,19,409
381560,2015,5,327,333,660,72142
381610,2015,7,29,7,36,6413
381750,2018,5,110,60,170,8203
381780,2015,8,930,90,1020,92477
381850,2015,5,20,11,31,1206
381870,2015,8,82,13,95,27725
381880,2016,8,64,7,71,4611
381900,2015,8,72,16,88,7050
381910,2015,6,19,5,24,2390
381990,2015,6,522,219,741,215886
382050,2016,8,492,59,551,68385
382070,2015,6,54,18,72,6820
382080,2015,5,116,112,228,62752
382130,2015,6,30,11,41,1711
382140,2015,6,768,261,1029,71382
382160,2015,4,19,52,71,5663
382180,2015,6,38,16,54,2693
382260,2016,8,237,18,255,15765
382270,2015,7,12,1,13,549
382300,2015,5,262,202,464,96909
382360,2017,5,139,73,212,11056
382420,2016,5,107,96,203,10032
382490,2015,8,4808,287,5095,884002
382890,2015,6,420,156,576,55096
382900,2015,6,750,213,963,103271
382920,2015,8,53,11,64,6684
383020,2016,5,7,6,13,555
383070,2016,5,16,20,36,2191
383150,2016,6,2372,948,3320,335791
383180,2016,5,526,268,794,117625
383230,2016,6,1259,390,1649,106207
383240,2015,5,11,14,25,3625
383270,2016,8,608,38,646,28775
383330,2015,5,144,87,231,311967
383460,2015,8,211,23,234,22763
383540,2015,6,19,6,25,1856
383630,2015,6,31,12,43,4476
383670,2015,6,24,8,32,5421
383690,2015,8,117,18,135,8330
383700,2015,6,33,12,45,2575
383710,2015,4,16,26,42,8497
383720,2015,5,43,20,63,9081
383750,2015,6,51,17,68,6858
383790,2016,5,295,212,507,51261
383870,2016,8,28348,4871,33219,959053
383930,2016,8,297,54,351,36687
383950,2015,6,30,11,41,2699
383980,2017,8,3705,434,4139,286514
384000,2015,6,218,72,290,12762
384010,2015,6,23,9,32,3691
384080,2016,5,140,91,231,18891
384100,2016,7,30,7,37,1662
384110,2015,8,632,92,724,64735
384120,2015,5,29,14,43,3926
384180,2016,6,1205,328,1533,247520
384190,2016,8,13482,1051,14533,577340
384200,2018,6,17,7,24,877
384210,2015,5,8,5,13,1617
384250,2017,5,83,52,135,25179
384280,2015,8,104,9,113,2868
384300,2015,6,5244,1782,7026,272887
384310,2015,6,241,70,311,29571
384320,2015,5,35,33,68,4533
384330,2016,6,38,16,54,3111
384360,2015,6,512,162,674,66008
384480,2016,8,66,7,73,18651
384490,2016,5,2179,1140,3319,180526
384500,2016,8,476,72,548,25829
384590,2015,7,20,1,21,616
384630,2015,9,929,47,976,71175
384680,2015,8,354,28,382,20887
384690,2015,8,57,1,58,8179
384700,2015,6,19,5,24,5235
384740,2017,6,453,185,638,47217
384750,2016,5,132,140,272,16340
384890,2015,7,18,3,21,1875
384920,2015,4,11,33,44,191
384940,2016,6,19,5,24,7083
384960,2020,8,106,21,127,71688
384990,2015,6,62,16,78,8752
385060,2015,7,29,4,33,1485
385070,2015,6,170,67,237,310592
385240,2016,8,628,138,766,80668
385250,2015,8,323,5,328,11841
385270,2018,5,765,350,1115,238249
385360,2015,5,46,34,80,11067
385370,2016,8,1925,315,2240,154848
385410,2017,6,10,4,14,34741
385440,2015,6,34,10,44,2489
385490,2015,5,59,52,111,21051
385560,2016,8,498,88,586,71503
385590,2015,6,121,35,156,8988
385600,2015,5,18,25,43,5010
385690,2015,7,31,1,32,2743
385710,2015,8,1115,231,1346,114325
385730,2016,5,1598,938,2536,141022
385760,2016,5,4097,3570,7667,501303
385770,2015,8,3353,418,3771,826505
385800,2015,8,9810,633,10443,565127
385830,2015,5,249,312,561,89348
385860,2015,5,26,13,39,7894
385890,2015,5,210,266,476,121739
385950,2016,4,7,13,20,4697
385960,2015,3,2,12,14,827
386070,2015,8,4386,1050,5436,569681
386080,2016,8,129,30,159,8483
386110,2015,3,6,35,41,31960
386140,2017,5,34,18,52,12957
386160,2015,6,51,19,70,17304
386180,2017,5,7380,4013,11393,1727005
386200,2017,7,18,3,21,346
386280,2015,5,105,93,198,7127
386290,2015,6,51,16,67,6532
386330,2015,3,2,14,16,707
386350,2015,6,55,19,74,7009
386360,2015,8,28249,5976,34225,5751466
386400,2015,6,57,18,75,5362
386420,2015,6,119,30,149,34234
386480,2015,6,830,299,1129,42735
386490,2016,5,81,54,135,35737
386510,2015,5,85,61,146,61080
386520,2015,8,131,17,148,9949
386540,2015,4,21,39,60,8005
386560,2015,8,96,10,106,4071
386590,2015,6,525,225,750,58812
386620,2017,8,1015,130,1145,107391
386640,2015,5,112,91,203,24927
386650,2016,5,68,54,122,5525
386690,2016,6,188,51,239,98151
386700,2015,6,104,42,146,23181
386710,2017,5,10,11,21,1365
386750,2016,6,37,15,52,6997
386770,2017,6,72,22,94,6731
386840,2015,7,34,4,38,5918
386870,2015,5,47,33,80,4283
386900,2015,8,101,7,108,5335
386930,2017,5,40,48,88,3085
386940,2016,9,5401,284,5685,770483
386990,2015,6,137,49,186,13779
387010,2015,5,91,41,132,12355
387060,2015,8,96,20,116,19096
387070,2015,2,17,81,98,8665
387090,2016,5,17,13,30,1710
387100,2017,7,18,2,20,858
387240,2015,8,75,10,85,10440
387270,2015,5,10,5,15,1018
387290,2016,9,12030,454,12484,764826
387340,2016,8,2086,141,2227,108610
387370,2016,6,241,94,335,29848
387400,2016,3,3,15,18,598
387430,2015,5,20,9,29,2434
387840,2015,8,268,65,333,58034
387850,2015,6,46,14,60,12250
387870,2015,8,89,21,110,9626
387930,2015,5,152,125,277,92279
387970,2015,5,402,460,862,143286
388050,2015,5,44,35,79,124050
388060,2015,5,284,159,443,99503
388080,2015,8,897,188,1085,36755
388210,2016,9,2167,57,2224,265169
388260,2015,7,25,4,29,1689
388320,2016,6,533,160,693,23358
388360,2015,6,49,21,70,5591
388370,2017,6,97,39,136,14297
388410,2015,6,4015,1284,5299,560050
388420,2015,8,239,26,265,45498
388430,2015,6,50,16,66,3261
388440,2015,5,15,16,31,12226
388450,2015,8,77,3,80,2932
388490,2015,5,168,134,302,53036
388500,2015,4,5,17,22,5511
388550,2017,5,13,9,22,3957
388620,2015,8,248,43,291,26669
388720,2015,7,39,9,48,2083
388750,2016,8,1755,152,1907,176322
388800,2015,8,629,102,731,40371
388880,2016,8,5274,365,5639,280771
388900,2016,6,78,24,102,6570
388910,2017,7,25,2,27,599
388960,2017,5,23,16,39,13777
388970,2015,8,91,17,108,6609
389040,2016,5,866,602,1468,45174
389050,2016,6,115,30,145,5389
389120,2016,6,12,5,17,774
389140,2018,8,308,11,319,5018
389170,2016,8,748,68,816,23221
389190,2016,6,52,19,71,5643
389220,2017,5,114,49,163,18823
389260,2017,8,58,8,66,3477
389310,2015,5,43,21,64,9273
389400,2015,6,83,21,104,117046
389510,2016,8,1148,101,1249,24581
389650,2015,8,119,6,125,8855
389670,2020,6,271,89,360,9142
389730,2017,8,10670,1748,12418,541238
389740,2015,4,7,25,32,1491
389810,2015,5,39,42,81,31443
389840,2015,5,35,27,62,2821
389850,2015,8,68,5,73,6532
389870,2015,5,156,69,225,20939
390030,2017,8,229,53,282,12783
390040,2016,6,177,67,244,14004
390200,2015,5,97,53,150,21880
390210,2015,5,44,21,65,2632
390290,2015,8,436,45,481,33682
390310,2016,5,88,43,131,6929
390330,2016,6,43,12,55,3475
390340,2016,4,523,1440,1963,79802
390460,2016,5,11,8,19,6841
390520,2015,8,865,109,974,54274
390570,2015,5,53,61,114,145725
390610,2015,8,174,9,183,10150
390620,2017,7,26,2,28,8911
390670,2015,5,2590,1116,3706,661286
390680,2016,7,39,1,40,3372
390710,2018,8,133,20,153,24827
390720,2016,8,225,11,236,15074
390730,2016,8,207,12,219,12100
390870,2015,5,34,24,58,8414
390890,2015,8,106,7,113,6204
390920,2015,7,35,5,40,4080
390930,2016,7,36,5,41,1145
391040,2016,8,3016,551,3567,318467
391100,2015,5,9,6,15,692
391140,2018,8,51,3,54,4155
391170,2015,8,254,32,286,24917
391180,2015,6,26,9,35,8607
391210,2015,7,18,4,22,6689
391220,2016,8,37915,2708,40623,2491210
391250,2015,8,76,8,84,2925
391260,2015,6,700,253,953,259225
391310,2016,5,103,47,150,57739
391340,2015,5,36,50,86,16546
391390,2015,7,26,2,28,5494
391490,2015,8,143,21,164,14024
391540,2015,9,80595,3296,83891,3581310
391550,2016,5,13,8,21,571
391600,2016,6,84,33,117,35685
391630,2015,5,18,14,32,3995
391640,2017,6,17,7,24,2874
391650,2017,7,13,1,14,4707
391660,2015,5,65,30,95,281562
391720,2016,8,10917,1172,12089,1203631
391730,2016,8,1376,204,1580,112130
391820,2016,5,17,20,37,9709
391960,2015,6,14,4,18,7495
392000,2016,6,216,57,273,12659
392020,2015,8,141,10,151,7109
392030,2016,8,56,2,58,3988
392070,2015,8,105,19,124,9281
392110,2017,8,5945,1350,7295,750761
392120,2016,5,11,12,23,8748
392190,2016,6,68,24,92,6851
392260,2016,6,132,34,166,10395
392280,2017,5,127,62,189,5755
392410,2016,6,186,77,263,23968
392450,2015,8,445,60,505,42391
392580,2016,6,408,127,535,45755
392600,2015,7,24,1,25,1725
392610,2017,8,55,3,58,634
392620,2015,7,13,3,16,671
392680,2016,6,28,10,38,6630
392720,2015,7,11,1,12,83
392780,2015,5,16,7,23,10102
392820,2015,5,125,128,253,65781
392940,2015,8,105,21,126,8796
392950,2015,8,3466,379,3845,111305
392970,2016,8,145,10,155,7041
393080,2017,5,754,877,1631,194722
393150,2015,6,48,15,63,23356
393200,2016,8,427,80,507,19637
393220,2017,7,30,1,31,1981
393230,2016,4,9,33,42,18953
393240,2015,5,13,9,22,2530
393380,2020,8,18586,4180,22766,1602466
393430,2016,8,702,126,828,113121
393460,2016,5,35,24,59,10459
393520,2018,8,610,67,677,28974
393530,2016,5,1283,636,1919,310042
393600,2015,6,14,6,20,3828
393610,2015,8,80,16,96,5801
393750,2016,5,106,55,161,5204
393790,2016,6,68,20,88,17344
393820,2016,5,21,30,51,1283
393860,2016,5,16,8,24,1909
393920,2015,5,84,75,159,12237
393930,2016,5,251,139,390,121719
393980,2015,6,405,130,535,29924
394130,2016,8,119,6,125,15129
394140,2015,8,67,14,81,84569
394160,2016,8,179,41,220,44054
394220,2015,8,94,20,114,9049
394230,2016,5,5233,3224,8457,492052
394260,2016,6,28,10,38,7498
394280,2015,5,108,76,184,25140
394290,2015,8,71,5,76,7511
394310,2016,6,5316,1464,6780,541121
394360,2016,8,19863,3491,23354,1352834
394390,2015,7,16,2,18,440
394430,2017,7,37,2,39,1189
394450,2015,5,324,177,501,31231
394490,2017,4,12,30,42,917
394510,2015,8,11171,970,12141,972013
394540,2016,6,306,82,388,128550
394550,2015,8,63,7,70,2741
394600,2015,6,126,45,171,13415
394690,2016,8,3715,601,4316,229619
394700,2016,8,243,43,286,24002
394760,2016,6,868,313,1181,86791
394770,2015,5,14,21,35,2083
394870,2015,6,477,196,673,119891
394970,2016,9,1845,88,1933,123529
395100,2016,7,11,2,13,4622
395140,2015,8,67,8,75,13082
395160,2015,6,299,127,426,24453
395170,2015,8,3946,258,4204,176148
395200,2015,6,899,258,1157,121232
395350,2016,5,180,103,283,12817
395400,2015,5,14,17,31,5700
395420,2015,6,82,30,112,16767
395470,2016,5,25,12,37,1210
395500,2016,8,183,29,212,4538
395520,2015,8,2211,289,2500,284121
395570,2016,6,387,158,545,35242
395580,2015,7,14,2,16,712
395620,2016,8,106,17,123,3964
395850,2016,8,315,57,372,14195
395860,2015,8,137,27,164,13040
395900,2015,5,57,33,90,7538
395920,2015,5,18,10,28,2149
396030,2015,5,141,66,207,49900
396090,2015,6,145,48,193,15478
396160,2015,5,278,310,588,203725
396230,2015,8,135,26,161,5886
396320,2016,5,15,10,25,4129
396350,2017,8,253,9,262,7012
396480,2016,8,450,98,548,37826
396650,2016,9,852,35,887,21258
396660,2016,8,74,18,92,2172
396680,2016,6,34,11,45,2926
396700,2016,7,20,1,21,191
396710,2018,8,127,5,132,6613
396750,2017,8,3078,728,3806,290326
396790,2015,6,427,117,544,92056
396800,2015,8,269,37,306,31102
396850,2015,5,26,39,65,39122
396860,2015,8,133,22,155,4524
396930,2015,6,13,5,18,660
397090,2016,8,53,10,63,5128
397150,2016,6,371,107,478,36201
397160,2019,8,83,13,96,7053
397200,2015,4,9,14,23,805
397240,2015,5,7,4,11,413
397270,2015,8,843,57,900,43213
397310,2017,8,248,57,305,17224
397330,2015,8,89,14,103,9043
397340,2015,8,3862,361,4223,314932
397390,2016,6,103,38,141,13400
397400,2015,7,15,1,16,459
397460,2015,8,452,24,476,299913
397500,2015,6,363,107,470,195993
397570,2015,8,154,32,186,21358
397580,2015,4,31,73,104,19168
397690,2015,8,273,59,332,17786
397730,2016,5,23,18,41,1196
397780,2015,8,87,16,103,5915
397810,2017,4,6,16,22,960
397820,2016,5,22,17,39,2123
397850,2017,7,10,1,11,349
397860,2016,7,16,2,18,692
397900,2017,5,4414,2713,7127,1457596
397940,2015,6,80,24,104,66074
397950,2016,8,3521,370,3891,368787
397960,2015,7,8,2,10,684
397970,2015,6,16,5,21,1361
397990,2015,8,73,14,87,7931
398020,2015,5,10,9,19,377
398100,2015,8,356,84,440,34077
398110,2015,5,10,11,21,1962
398120,2016,5,14,19,33,2194
398140,2017,6,27,11,38,3713
398150,2016,5,24,18,42,9021
398170,2016,8,200,45,245,17066
398180,2015,5,136,62,198,14748
398450,2015,8,182,44,226,31425
398460,2015,8,109,9,118,2744
398480,2015,5,7,4,11,1821
398530,2015,5,10,7,17,449
398670,2016,5,6,6,12,638
398680,2016,5,451,215,666,106560
398710,2015,8,4499,288,4787,352371
398830,2015,5,7,5,12,31527
398850,2016,9,2761,120,2881,167656
398890,2016,7,16,4,20,1244
398940,2015,7,26,3,29,4561
398960,2015,6,17,6,23,1468
398970,2015,4,8,21,29,37965
398980,2015,8,154,17,171,3094
399000,2015,5,26,15,41,47245
399040,2015,8,66,11,77,8738
399070,2015,8,280,42,322,14404
399130,2016,5,63,72,135,22591
399140,2015,7,33,4,37,5238
399530,2016,7,10,2,12,4781
399600,2016,8,289,10,299,6414
399640,2015,8,354,21,375,19170
399670,2015,8,2028,287,2315,110360
399790,2015,5,384,395,779,215948
399820,2016,8,1046,229,1275,94463
399890,2015,6,137,38,175,32135
399910,2015,7,40,3,43,14646
399920,2015,5,22,14,36,7054
400020,2016,6,253,68,321,38154
400030,2016,5,108,90,198,51883
400130,2015,5,8,5,13,527
400160,2015,8,284,28,312,23635
400170,2015,6,1010,377,1387,184404
400180,2016,8,487,112,599,89332
400200,2015,5,52,24,76,3186
400280,2018,7,15,1,16,226
400350,2018,6,13,4,17,512
400360,2016,5,74,35,109,5240
400380,2015,5,9,11,20,16447
400450,2016,8,232,51,283,20385
400510,2016,5,127,117,244,36990
400580,2015,8,141,9,150,11211
400630,2016,9,1142,44,1186,70101
400660,2015,8,325,34,359,22576
400800,2016,6,259,101,360,26799
400880,2016,4,6,18,24,1658
400910,2016,9,5359,110,5469,153932
401120,2015,8,52,8,60,10262
401190,2015,5,1566,873,2439,129812
401290,2015,7,42,3,45,1796
401330,2015,5,32,17,49,2383
401360,2016,6,198,58,256,12607
401510,2016,7,14,1,15,283
401680,2016,8,894,93,987,55987
401710,2017,6,395,119,514,45668
401810,2017,8,468,43,511,28341
401820,2016,6,83,29,112,4466
401840,2015,8,62,14,76,13199
401890,2016,6,126,48,174,8931
402020,2015,6,1523,651,2174,66541
402030,2015,5,40,18,58,3962
402040,2016,8,294,72,366,19291
402060,2016,6,125,49,174,5358
402120,2015,8,227,40,267,19603
402130,2017,5,278,241,519,25191
402150,2016,6,36,12,48,3340
402160,2015,5,152,126,278,7872
402170,2015,5,26,31,57,51628
402260,2016,8,286,64,350,22012
402300,2015,5,42,22,64,4589
402310,2016,8,314,56,370,19052
402330,2017,8,1646,142,1788,49786
402340,2016,8,67,8,75,5735
402390,2015,7,20,3,23,2797
402430,2016,8,556,47,603,66375
402530,2016,8,270,16,286,21984
402560,2016,5,344,274,618,263899
402570,2016,8,3555,788,4343,707718
402670,2015,5,11,15,26,1625
402750,2016,5,164,72,236,22438
402840,2015,8,1591,304,1895,379611
402880,2016,6,285,77,362,11997
403070,2015,7,30,3,33,1507
403120,2015,6,155,62,217,45340
403180,2015,8,170,37,207,36322
403190,2015,6,3793,1101,4894,361192
403200,2015,4,19,44,63,455
403230,2015,7,15,3,18,1008
403290,2016,6,90,24,114,3779
403400,2016,6,126,36,162,33672
403430,2016,8,202,34,236,45606
403510,2015,6,143,37,180,27325
403590,2016,4,57,95,152,5920
403640,2016,8,17614,4161,21775,1127089
403680,2015,5,6,8,14,424
403700,2015,8,190,30,220,10509
403780,2015,7,31,1,32,2173
403830,2015,8,228,13,241,9927
403880,2015,5,44,37,81,9365
403940,2016,8,313,64,377,23784
403970,2016,6,683,197,880,43647
404030,2015,7,19,1,20,2622
404050,2015,5,95,42,137,16342
404100,2015,7,29,6,35,1957
404180,2016,8,77,18,95,14066
404200,2018,8,296,65,361,25063
404510,2016,8,52,10,62,7893
404530,2017,8,204,28,232,12972
404540,2017,8,973,126,1099,86553
404580,2015,5,80,36,116,16901
404590,2017,5,1279,991,2270,78646
404620,2016,6,456,140,596,63353
404640,2016,5,115,103,218,27929
404660,2015,5,19,9,28,18612
404680,2017,8,1864,221,2085,90716
404700,2016,8,104,19,123,18105
404770,2016,5,191,112,303,71631
404820,2016,8,129,13,142,13624
404860,2015,7,17,4,21,2402
404960,2018,7,17,2,19,316
405000,2016,8,96,12,108,5258
405010,2021,8,461,65,526,16752
405190,2017,4,4,10,14,195
405240,2017,5,13,8,21,1282
405290,2017,8,215,13,228,11887
405310,2016,8,1447,293,1740,211964
405340,2017,5,23,14,37,2140
405440,2016,5,6,7,13,22252
405500,2016,5,228,276,504,47177
405530,2019,7,29,2,31,1052
405540,2016,7,37,9,46,3265
405550,2016,7,36,5,41,4574
405610,2015,5,160,128,288,85532
405640,2016,9,8094,348,8442,334799
405650,2015,8,154,38,192,11253
405710,2019,6,805,248,1053,110066
405720,2016,6,62,20,82,6952
405760,2016,6,41,17,58,6853
405780,2015,6,101,38,139,6345
405820,2015,9,1387,60,1447,75696
405830,2017,9,817,39,856,41597
405900,2016,8,1900,248,2148,169503
405950,2015,8,361,23,384,76293
405960,2016,5,21,19,40,1247
405970,2016,8,124,26,150,16515
406120,2016,5,9,6,15,5458
406150,2015,9,9772,472,10244,205520
406170,2016,5,191,128,319,14230
406220,2016,8,46,9,55,3489
406290,2016,8,677,101,778,68306
406310,2016,5,101,57,158,14836
406550,2016,8,236,5,241,9133
406650,2015,6,39,11,50,3559
406720,2016,5,145,88,233,8234
406730,2015,5,35,28,63,29760
406850,2016,8,210,39,249,21939
406870,2016,8,368,17,385,34880
406920,2015,7,24,1,25,1075
406940,2016,6,132,50,182,7918
406970,2016,8,745,165,910,33684
407000,2017,4,12,27,39,43004
407020,2015,8,133,32,165,9837
407110,2017,7,21,3,24,624
407230,2015,6,381,155,536,254231
407290,2015,6,83,28,111,12852
407300,2015,6,393,101,494,41424
407310,2017,9,509,13,522,27742
407330,2016,8,814,67,881,107936
407340,2016,8,73,4,77,3453
407380,2015,7,35,1,36,2628
407420,2015,5,227,264,491,3497
407530,2017,5,4175,2828,7003,2284297
407560,2016,6,564,236,800,55427
407600,2015,5,29,28,57,2931
407620,2015,5,73,81,154,8541
407680,2015,5,58,34,92,25982
407780,2016,8,173,22,195,10327
407810,2016,8,566,114,680,59432
407830,2016,4,5,9,14,1472
407840,2016,5,1868,1468,3336,275847
407880,2016,8,87,5,92,10469
407940,2016,8,69,2,71,21745
408000,2015,8,221,52,273,16840
408110,2016,8,91,19,110,61839
408170,2015,7,21,1,22,685
408250,2016,5,116,52,168,13642
408280,2015,8,597,94,691,16801
408400,2015,8,49,11,60,1896
408410,2017,8,555,35,590,31098
408520,2017,8,421,35,456,9389
408640,2016,5,114,75,189,14198
408650,2016,8,304,22,326,10727
408750,2015,7,23,5,28,8851
408760,2016,5,172,120,292,48819
408770,2015,6,86,35,121,9571
408900,2020,8,119,19,138,3968
408920,2016,5,105,62,167,6832
408960,2016,8,99,23,122,5469
409000,2016,5,134,71,205,10748
409040,2016,5,28,14,42,2742
409070,2015,6,21,8,29,6433
409100,2015,8,750,125,875,39880
409160,2015,8,6829,448,7277,387663
409290,2016,5,29,15,44,6555
409320,2016,5,117,54,171,4934
409340,2016,5,67,33,100,11451
409360,2015,5,21,11,32,1030
409370,2015,5,15,11,26,5364
409380,2015,8,190,32,222,50302
409390,2016,6,35,14,49,3361
409410,2017,5,26,15,41,2606
409450,2015,8,305,49,354,30224
409460,2016,5,19,9,28,904
409490,2018,5,38,24,62,2221
409510,2015,4,507,1137,1644,235724
409520,2016,5,31,15,46,1722
409560,2016,6,65,17,82,10654
409600,2015,6,70,28,98,52889
409660,2016,8,445,47,492,22630
409710,2016,5,6304,4186,10490,1289273
409730,2016,8,83,19,102,12776
409850,2017,8,177,41,218,18248
409870,2016,8,179,9,188,24630
409890,2016,6,217,87,304,26902
410000,2016,7,11,2,13,606
410110,2015,8,2402,437,2839,221369
410150,2015,7,32,3,35,4248
410320,2016,9,3170,132,3302,202538
410430,2015,6,347,120,467,27957
410440,2015,6,31,8,39,5844
410470,2015,6,11,3,14,2484
410570,2016,8,137,33,170,19101
410820,2016,8,351,19,370,35368
410830,2017,8,59,6,65,2248
410840,2017,6,163,43,206,9572
410850,2015,5,634,289,923,60732
410890,2015,8,255,9,264,28301
410900,2017,6,1378,354,1732,483174
410910,2015,7,20,4,24,2626
411120,2017,8,163,27,190,48850
411130,2016,5,30,22,52,912
411300,2017,6,5875,1713,7588,254457
411370,2016,8,933,80,1013,81464
411390,2015,7,11,1,12,1440
411480,2017,5,79,66,145,58623
411560,2015,8,984,155,1139,78406
411570,2015,8,102,10,112,6903
411590,2015,8,60,11,71,3983
411600,2016,5,33,20,53,2826
411610,2016,7,33,5,38,5261
411620,2016,5,20,13,33,2290
411630,2015,5,7,6,13,338
411680,2015,8,49,9,58,5442
411690,2015,5,12,6,18,1260
411750,2016,6,31,9,40,2172
411760,2015,8,233,41,274,21774
411830,2016,9,2633,132,2765,120376
411960,2016,9,1491,16,1507,60953
411970,2017,8,283,7,290,15235
412010,2015,5,21,11,32,914
412170,2015,6,176,51,227,300130
412230,2015,6,40,12,52,6172
412250,2015,5,15,10,25,5548
412270,2015,8,69,10,79,7377
412400,2016,1,248,1006,1254,101100
412410,2015,5,31,18,49,2585
412450,2016,5,907,634,1541,15180
412460,2016,5,133,124,257,16973
412490,2016,5,20,9,29,6902
412520,2015,6,228,61,289,16747
412540,2016,6,16,6,22,5642
412620,2017,8,92,8,100,3427
412660,2016,8,69,14,83,2779
412670,2015,8,187,4,191,10841
412730,2015,4,48,87,135,10660
412770,2015,8,246,48,294,26400
412790,2016,6,84,27,111,4773
412830,2016,9,4274,104,4378,160015
412970,2015,5,9,5,14,674
413150,2016,9,88300,2125,90425,4913541
413410,2016,9,4204,120,4324,234336
413420,2016,9,3435,88,3523,178510
413480,2016,7,25,6,31,1089
413490,2015,5,6,5,11,107
413500,2016,8,57,8,65,3462
413680,2015,5,136,63,199,15124
413700,2016,7,16,1,17,723
413710,2015,5,480,328,808,69108
413740,2018,5,20,15,35,1937
413760,2015,5,13,19,32,1168
413830,2016,5,10,5,15,2286
413870,2016,8,84,6,90,7928
414060,2015,5,10,11,21,3330
414080,2021,6,307,122,429,46174
414090,2016,5,9,6,15,369
414190,2016,8,203,43,246,18930
414260,2015,6,24,9,33,2345
414340,2017,8,14216,1226,15442,422733
414370,2016,8,53,4,57,7425
414510,2016,8,222,34,256,16256
414530,2017,5,950,675,1625,404721
414550,2018,6,97,35,132,4908
414660,2015,8,232,36,268,32897
414700,2017,8,7802,1202,9004,387821
414730,2016,5,391,187,578,144330
414740,2017,5,693,637,1330,41266
414870,2018,8,222,47,269,14505
414950,2015,6,96,38,134,6419
415010,2016,5,41,47,88,1015
415030,2015,6,339,96,435,55894
415090,2017,7,20,2,22,340
415150,2016,8,115,22,137,14837
415170,2017,8,198,5,203,6229
415200,2016,8,3613,383,3996,330158
415240,2016,6,85,22,107,8598
415270,2016,8,1395,313,1708,100051
415300,2017,6,156,46,202,18594
415350,2016,8,367,37,404,25583
415400,2015,8,146,28,174,8296
415420,2015,8,1188,83,1271,66370
415480,2016,8,481,99,580,42408
415530,2016,7,10,1,11,3630
415590,2018,6,403,114,517,31051
415610,2016,8,338,22,360,16134
415670,2016,8,58,4,62,8855
415740,2016,8,168,38,206,13002
415830,2015,8,50,6,56,51907
415840,2016,5,71,35,106,62379
415850,2015,8,211,39,250,11118
415860,2016,5,485,520,1005,218644
415880,2017,6,681,218,899,226459
415890,2015,5,10,10,20,1980
415910,2015,7,39,4,43,4442
415920,2015,8,96,3,99,2392
415960,2016,6,144,45,189,238706
415990,2015,7,19,3,22,1479
416040,2016,4,69,108,177,132997
416110,2016,8,77,11,88,8992
416130,2015,6,1567,433,2000,433025
416180,2016,7,31,4,35,1338
416210,2017,6,629,208,837,86444
416250,2016,7,15,3,18,2274
416260,2015,4,17,43,60,1462
416290,2015,5,21,25,46,12815
416350,2015,5,24,29,53,17448
416360,2017,8,69,2,71,4046
416370,2015,5,37,25,62,20130
416380,2015,6,71,22,93,6348
416450,2016,5,220,131,351,89737
416530,2017,8,49,4,53,3345
416550,2015,8,117,9,126,9322
416600,2018,8,530,54,584,33451
416610,2016,5,34,17,51,120462
416630,2015,5,45,52,97,13835
416640,2015,6,85,23,108,7163
416670,2015,5,164,132,296,35451
416680,2016,8,847,46,893,66546
416720,2016,5,20,15,35,1293
416770,2015,8,478,38,516,27127
416790,2016,8,188,21,209,16107
416830,2018,7,42,4,46,1296
416850,2016,7,12,2,14,1012
416870,2018,7,41,1,42,3934
417060,2015,5,10,6,16,2776
417290,2018,8,1384,112,1496,58680
417310,2016,6,14,6,20,1133
417350,2015,3,1,9,10,255
417400,2017,7,12,2,14,188
417430,2016,5,425,211,636,54966
417480,2016,6,14,4,18,4434
417860,2015,8,22767,2904,25671,1689541
417880,2016,5,584,264,848,34561
417900,2016,7,22,1,23,888
417910,2016,5,860,652,1512,290227
417980,2015,8,44,9,53,6636
417990,2015,8,293,72,365,8473
418040,2015,8,421,36,457,31245
418060,2017,5,52,25,77,5906
418110,2015,6,115,44,159,20945
418120,2016,8,305,64,369,28914
418150,2015,8,102,20,122,5983
418160,2015,7,38,8,46,114665
418180,2016,6,1063,418,1481,150883
418210,2016,7,42,5,47,1228
418240,2016,9,7170,260,7430,405980
418270,2016,6,63,22,85,10941
418300,2015,8,305,43,348,21925
418310,2015,5,13,9,22,37003
418340,2016,8,7769,1508,9277,387405
418370,2017,8,15768,1384,17152,668829
418430,2022,4,5,11,16,7277
418460,2017,6,11458,3155,14613,952431
418610,2016,5,54,52,106,117621
418650,2017,9,1679,66,1745,179033
418670,2016,8,158,30,188,7152
418910,2015,5,86,65,151,12114
418950,2016,8,332,79,411,43330
419020,2017,6,15,4,19,633
419080,2016,6,56,20,76,14464
419090,2015,8,41,9,50,18191
419480,2017,6,1497,416,1913,114116
419500,2015,8,51,3,54,20300
419590,2016,6,29,10,39,28641
419810,2016,7,24,2,26,3213
420060,2016,8,275,36,311,18790
420070,2015,5,56,27,83,7200
420110,2016,9,7531,193,7724,318426
420160,2016,5,8,4,12,476
420180,2017,8,57,10,67,3937
420270,2015,5,67,45,112,15201
420290,2020,8,7673,953,8626,546456
420360,2016,7,36,6,42,12186
420380,2016,6,14,4,18,1523
420500,2016,6,13,4,17,335
420530,2016,9,7376,117,7493,176242
420550,2021,8,80,19,99,4724
420570,2016,7,23,3,26,1078
420660,2018,8,47,6,53,660
420740,2015,8,1181,110,1291,127552
420770,2015,6,121,37,158,20548
420790,2016,6,621,180,801,189535
420850,2016,6,78,27,105,13130
420900,2016,6,10,3,13,1638
420930,2016,8,297,59,356,36071
420980,2017,8,128,11,139,10595
421020,2017,5,2541,1365,3906,270550
421040,2016,8,3200,425,3625,166125
421050,2016,8,1600,213,1813,123013
421060,2016,5,119,65,184,102505
421120,2016,9,1616,85,1701,114359
421140,2016,6,10,4,14,3386
421260,2015,8,95,3,98,8234
421600,2016,5,36,31,67,6361
421610,2016,7,36,6,42,2036
421630,2015,8,112,4,116,5551
421660,2016,8,290,7,297,7324
421670,2016,8,734,101,835,106536
421740,2016,8,172,36,208,23890
421810,2015,6,235,73,308,25907
421870,2016,7,12,3,15,3470
421890,2015,5,24,18,42,1720
421900,2015,5,24,15,39,4506
422110,2016,8,119,5,124,6435
422250,2015,5,275,200,475,221079
422270,2016,4,8,17,25,1423
422590,2016,4,9,28,37,1922
422610,2016,5,21,12,33,3454
422650,2016,6,56,16,72,11057
422810,2017,6,1083,354,1437,69036
422860,2020,8,149,15,164,8126
422900,2016,8,409,36,445,36823
422910,2016,8,88,6,94,12431
422920,2016,7,46,3,49,9617
422970,2016,9,3797,190,3987,102656
422980,2016,7,23,4,27,4119
423120,2015,8,193,22,215,8663
423220,2016,7,19,1,20,1796
423230,2016,8,2954,295,3249,218506
423270,2016,6,29,9,38,1443
423320,2015,8,64,15,79,6836
423440,2015,7,32,2,34,2376
423490,2017,8,233,47,280,17133
423550,2016,6,60,21,81,44497
423580,2016,8,1380,321,1701,246461
423590,2016,8,239,33,272,14057
423610,2016,6,112,31,143,8330
423620,2016,6,320,92,412,25817
423650,2016,5,40,24,64,8921
423700,2016,5,27,37,64,4175
423710,2016,5,100,133,233,323181
423720,2016,7,11,1,12,2096
423740,2015,6,25,10,35,5647
423800,2016,6,31,13,44,2869
423810,2016,6,334,134,468,47487
423870,2016,7,25,6,31,4446
423880,2015,8,5747,648,6395,21187
423950,2016,5,374,173,547,37167
424010,2016,7,18,2,20,730
424060,2015,4,8,13,21,1109
424170,2015,6,37,10,47,6039
424210,2015,6,11,3,14,1919
424250,2016,6,241,65,306,23771
424260,2016,5,37,26,63,1574
424280,2016,9,11633,206,11839,1154435
424370,2020,6,1828,697,2525,169573
424640,2016,7,34,6,40,5169
424750,2015,7,9,1,10,183
424760,2016,6,26,10,36,4335
424830,2016,4,90,287,377,74642
424840,2017,8,4797,587,5384,280612
424850,2019,5,10,9,19,3917
425070,2016,7,35,5,40,1510
425160,2016,8,61,7,68,9157
425210,2016,6,499,146,645,51119
425220,2016,6,1253,392,1645,131305
425240,2017,6,75,24,99,8710
425300,2016,6,57,18,75,3975
425310,2016,4,10,17,27,841
425410,2016,8,239,30,269,41756
425450,2018,6,14,6,20,1524
425580,2016,9,5729,126,5855,199346
425600,2016,8,69,9,78,3043
425650,2016,8,98,7,105,2509
425670,2016,8,333,53,386,21724
425720,2016,8,219,41,260,37955
425820,2016,8,49,8,57,5563
425900,2016,7,18,3,21,201
426000,2016,8,2650,553,3203,320028
426010,2016,4,16,28,44,2594
426170,2016,5,26,13,39,4103
426190,2017,8,79,13,92,8604
426240,2016,7,18,1,19,335
426290,2016,6,43,13,56,7899
426310,2017,6,139,50,189,8498
426330,2015,8,121,13,134,8355
426590,2015,5,34,29,63,1820
426790,2016,8,755,86,841,70248
427030,2016,6,726,232,958,29768
427050,2016,6,8,3,11,309
427100,2016,5,1218,1015,2233,118947
427240,2017,8,339,36,375,17351
427250,2016,8,1220,280,1500,123076
427270,2017,5,3473,1682,5155,1115355
427290,2018,6,2618,907,3525,162765
427470,2016,6,164,67,231,34890
427490,2017,8,221,35,256,8264
427510,2016,6,170,50,220,24344
427520,2020,9,35074,465,35539,1706659
427550,2016,5,76,42,118,14697
427570,2017,5,81,56,137,10484
427660,2016,5,112,78,190,5838
427680,2018,8,70,4,74,2229
427700,2017,8,156,4,160,3466
427730,2016,6,7938,2892,10830,1305248
427770,2016,7,40,3,43,16744
427780,2015,6,231,61,292,55706
427810,2016,6,220,68,288,6551
427820,2016,8,612,118,730,58049
427860,2016,6,58,22,80,4331
427910,2016,6,244,72,316,26069
427930,2016,5,33,26,59,44138
427980,2016,6,322,87,409,65431
428040,2015,7,19,1,20,1247
428100,2016,8,74,2,76,5740
428110,2016,5,14,9,23,3900
428180,2019,8,269,67,336,13177
428200,2017,5,153,66,219,5659
428220,2016,8,236,39,275,9855
428350,2016,8,52,10,62,8126
428410,2016,7,23,2,25,1035
428440,2016,5,137,82,219,3649
428460,2015,7,35,5,40,4151
428510,2015,6,34,10,44,44601
428530,2016,5,18,11,29,5942
428550,2016,9,4399,202,4601,246833
428590,2016,5,7,9,16,4740
428690,2017,6,5461,1978,7439,714623
428740,2016,4,7,11,18,1403
428750,2016,8,637,46,683,85022
428760,2015,5,22,19,41,7584
428830,2016,8,109,12,121,19424
428860,2017,8,92,14,106,3681
428880,2016,8,214,33,247,15649
428900,2016,8,634,95,729,129612
428920,2016,6,11,3,14,3694
428980,2017,4,4,13,17,749
429020,2016,4,21,42,63,7209
429050,2016,6,818,302,1120,151025
429060,2016,5,38,36,74,11425
429120,2016,6,18,7,25,1239
429200,2016,5,22,14,36,7297
429220,2016,6,37,13,50,3999
429250,2016,7,17,4,21,1984
429330,2016,8,256,38,294,39048
429350,2016,7,24,1,25,4698
429390,2016,5,32,17,49,2039
429430,2016,4,8,18,26,5919
429470,2015,8,665,96,761,198916
429570,2016,6,3184,957,4141,197450
429580,2016,5,117,100,217,32523
429600,2016,5,112,75,187,22491
429610,2016,8,169,33,202,22107
429620,2016,6,521,181,702,41331
429660,2017,8,5377,305,5682,284444
429680,2016,6,833,291,1124,137325
429690,2016,7,29,3,32,1314
429700,2016,5,244,115,359,114736
429720,2016,8,452,43,495,15935
429780,2017,6,330,129,459,21045
429940,2016,8,487,43,530,24192
429950,2015,4,17,46,63,35072
430070,2019,8,69,17,86,4852
430170,2016,6,58,23,81,1139
430210,2017,6,429,151,580,36544
430230,2016,7,13,3,16,732
430240,2016,5,7,5,12,158
430290,2016,7,29,2,31,2709
430300,2016,5,7,4,11,494
430410,2017,8,63,11,74,4679
430890,2017,7,17,1,18,6493
431120,2017,8,110,17,127,9836
431180,2016,8,652,91,743,50468
431200,2016,7,33,4,37,22101
431220,2016,5,68,72,140,32383
431230,2016,8,90,21,111,12878
431240,2020,8,12459,1187,13646,2271522
431250,2016,8,236,56,292,33903
431260,2016,6,346,94,440,25654
431290,2016,5,25,11,36,9986
431370,2016,7,11,2,13,2849
431410,2016,7,22,4,26,1300
431510,2016,8,250,50,300,35333
431540,2016,8,932,109,1041,72959
431590,2016,8,253,32,285,19144
431600,2016,8,799,107,906,48672
431630,2016,7,20,4,24,694
431640,2016,5,45,47,92,37470
431650,2017,6,284,95,379,24670
431680,2016,5,11,13,24,5976
431700,2017,8,60,3,63,1771
431710,2016,8,279,42,321,152788
431740,2016,5,22,13,35,13020
431750,2016,6,29,10,39,45950
431810,2016,5,113,50,163,10662
431830,2016,7,26,5,31,2163
431840,2016,5,74,54,128,21527
431850,2016,8,49,9,58,4205
431870,2016,6,48,16,64,3795
431910,2016,6,154,40,194,10209
431930,2018,8,101,4,105,7543
431960,2018,9,43990,1212,45202,5279723
432010,2016,8,368,79,447,31135
432100,2016,8,307,51,358,47218
432130,2016,7,23,4,27,558
432180,2016,7,20,4,24,5752
432190,2016,8,80,11,91,8333
432230,2016,7,25,5,30,1337
432260,2016,6,45,12,57,9880
432290,2016,5,68,54,122,35978
432330,2016,6,38,15,53,6473
432380,2016,7,15,1,16,1476
432420,2017,5,8,7,15,392
432470,2016,5,96,124,220,232598
432480,2016,7,18,2,20,172
432590,2016,5,19,14,33,960
432640,2016,5,17,21,38,962
432720,2016,6,45,17,62,2214
432870,2016,6,36,10,46,2503
432940,2017,8,57,6,63,2000
432950,2017,5,53,23,76,18173
432980,2016,8,121,8,129,15925
432990,2016,7,36,3,39,20938
433100,2016,8,565,139,704,26994
433110,2016,5,13,11,24,4015
433190,2017,5,56,27,83,3996
433210,2016,5,34,51,85,41485
433300,2016,5,220,171,391,22027
433320,2016,5,119,135,254,20337
433340,2017,9,17305,653,17958,1216760
433350,2016,5,1060,968,2028,553384
433380,2016,5,42,23,65,1245
433400,2016,8,49,6,55,1858
433450,2016,5,41,19,60,2453
433490,2016,7,22,3,25,872
433530,2017,8,1142,285,1427,72180
433570,2016,6,7,3,10,206
433590,2016,7,30,7,37,1200
433600,2016,8,151,30,181,13136
433660,2016,7,10,2,12,674
433670,2016,4,55,106,161,33752
433840,2016,5,35,16,51,1925
433890,2016,7,29,4,33,1768
433900,2017,5,41,27,68,1192
433910,2016,8,858,200,1058,64909
433950,2016,9,4292,106,4398,263361
434000,2016,8,276,31,307,18386
434020,2016,8,210,37,247,12959
434050,2016,8,525,121,646,42602
434130,2016,7,34,3,37,2555
434160,2017,8,46,6,52,1122
434170,2016,8,578,33,611,319411
434210,2016,8,502,46,548,224555
434220,2016,7,31,4,35,34825
434230,2016,7,16,2,18,4930
434240,2016,7,13,2,15,1638
434250,2016,5,868,376,1244,153543
434260,2016,8,1623,372,1995,53461
434290,2016,5,67,31,98,13160
434300,2018,4,5,9,14,6087
434310,2017,6,23,8,31,1322
434360,2017,5,44,31,75,3716
434390,2016,6,11,3,14,2429
434410,2016,8,186,8,194,7895
434420,2016,6,630,261,891,141688
434460,2017,6,1065,273,1338,270427
434510,2017,8,178,41,219,89730
434530,2016,7,22,3,25,4584
434570,2016,9,13474,704,14178,842105
434600,2017,6,25,9,34,665
434620,2016,6,159,48,207,7119
434650,2016,8,10543,1130,11673,864412
434680,2016,5,99,64,163,11498
434700,2016,7,13,3,16,606
434730,2016,8,1831,449,2280,282077
434740,2016,8,68,12,80,4555
434750,2016,7,21,2,23,655
434790,2016,6,10,4,14,138
434820,2016,8,48,10,58,9532
434860,2016,7,12,3,15,155
434870,2016,5,5,5,10,415
434880,2016,5,79,37,116,6248
434930,2016,5,9,10,19,374
434960,2016,5,4,6,10,298
435010,2016,5,16,19,35,3550
435020,2017,6,43,18,61,1667
435030,2016,8,3522,274,3796,68466
435040,2016,6,31,9,40,6714
435100,2017,6,116,38,154,7378
435150,2017,9,28259,1357,29616,1688895
435260,2016,7,20,3,23,1332
435300,2016,8,281,23,304,9670
435360,2016,7,38,5,43,2039
435400,2017,9,2913,58,2971,152554
435460,2016,8,49,6,55,4182
435480,2016,5,73,41,114,5146
435490,2016,8,190,13,203,15932
435530,2016,8,2874,510,3384,145897
435600,2016,5,18,10,28,1606
435790,2016,8,112,16,128,10822
435800,2016,8,51,4,55,5778
435840,2016,7,24,4,28,774
436000,2016,6,63,20,83,2930
436060,2016,5,13,6,19,2523
436070,2017,7,15,2,17,522
436140,2016,5,26,12,38,25362
436150,2016,6,1665,616,2281,479096
436180,2017,5,679,686,1365,207863
436220,2016,8,133,8,141,12141
436230,2017,8,117,26,143,7813
436260,2016,5,109,89,198,1630
436270,2016,5,14,9,23,4417
436280,2016,6,45,19,64,7298
436290,2017,6,170,64,234,13744
436320,2017,8,1494,240,1734,152832
436390,2016,8,209,18,227,14925
436410,2016,4,5,14,19,319
436470,2018,7,21,2,23,1123
436480,2016,5,25,14,39,5052
436490,2016,8,144,34,178,9106
436500,2016,6,285,82,367,23326
436520,2017,5,3801,2811,6612,1853533
436530,2016,6,197,53,250,12702
436670,2017,8,361,22,383,14844
436690,2018,6,24,10,34,1094
436940,2016,8,46,5,51,4319
437000,2016,6,78,30,108,10504
437060,2016,7,19,2,21,1831
437080,2016,6,51,14,65,1740
437090,2016,7,39,5,44,5313
437100,2016,8,60,5,65,4157
437160,2016,8,1261,81,1342,103237
437180,2016,5,16,7,23,31444
437220,2017,5,9037,6540,15577,843301
437250,2017,8,175,25,200,9203
437390,2017,8,98,24,122,24578
437420,2016,8,135,17,152,20939
437520,2016,8,60,1,61,1300
437530,2016,8,122,30,152,9803
437550,2016,7,31,6,37,2067
437570,2016,8,612,93,705,75642
437690,2018,7,24,4,28,258
437710,2016,7,10,2,12,411
437720,2017,5,47,24,71,5961
437730,2019,7,22,2,24,481
437870,2016,5,78,68,146,11664
437880,2016,6,11,4,15,4803
437920,2016,8,2007,231,2238,314191
438000,2018,7,42,5,47,4912
438020,2016,4,66,171,237,206563
438080,2016,8,377,91,468,64972
438130,2016,8,210,15,225,26201
438220,2016,6,9,3,12,329
438260,2016,7,13,3,16,173
438300,2016,5,12,10,22,706
438310,2016,5,15,20,35,394
438320,2017,8,133,1,134,3290
438340,2016,5,72,44,116,4450
438420,2016,6,226,88,314,11300
438430,2016,6,192,52,244,18552
438460,2022,7,25,3,28,479
438480,2016,8,436,94,530,54215
438490,2016,6,2207,589,2796,243065
438640,2016,8,1469,336,1805,245948
438680,2016,8,837,148,985,209616
438720,2016,5,22,24,46,4803
438730,2016,5,14,11,25,883
438740,2017,5,14544,6258,20802,629644
438920,2016,8,190,46,236,20857
438940,2016,7,10,2,12,589
439190,2016,8,2894,448,3342,660285
439250,2016,8,192,33,225,138504
439310,2016,6,65,17,82,4075
439340,2019,6,230,85,315,19243
439440,2016,6,62,20,82,5595
439550,2016,5,29,27,56,11062
439720,2016,6,59,25,84,5907
439730,2016,7,13,1,14,1000
439740,2016,7,10,2,12,522
439750,2016,7,23,5,28,3345
439770,2016,7,38,9,47,4398
439800,2016,7,39,8,47,3014
439880,2016,7,17,4,21,3148
439910,2016,8,207,49,256,56986
439920,2016,6,179,45,224,16467
439940,2016,8,678,57,735,50663
440020,2016,5,80,107,187,7400
440100,2016,7,10,1,11,95
440340,2016,5,62,30,92,8964
440420,2016,8,229,25,254,9123
440450,2016,5,28,16,44,1336
440470,2016,4,6,15,21,344
440550,2016,8,141,18,159,8628
440630,2016,8,608,82,690,74964
440650,2017,8,1445,165,1610,97394
440690,2016,6,48,14,62,1015
440720,2016,5,8,8,16,196
440730,2017,5,362,267,629,42826
440740,2016,5,160,128,288,97765
440750,2016,5,13,6,19,19402
440790,2016,5,5,6,11,11176
440800,2016,7,25,4,29,791
440810,2016,5,31,45,76,1567
440880,2016,9,562,28,590,29167
440900,2018,6,15438,6596,22034,1140205
440950,2016,5,27,16,43,5261
441010,2018,8,118,21,139,21989
441050,2016,8,336,15,351,12481
441060,2016,7,15,2,17,564
441230,2016,7,26,3,29,1485
441250,2016,5,31,14,45,1879
441280,2016,8,151,10,161,7230
441350,2016,5,46,20,66,2770
441510,2016,7,35,3,38,3435
441670,2016,6,112,33,145,10885
441790,2017,5,727,820,1547,86608
441830,2016,6,769,267,1036,70256
442070,2016,8,203,23,226,122221
442120,2017,6,472,124,596,66560
442140,2016,5,8,4,12,723
442190,2016,5,10,11,21,554
442220,2016,5,38,35,73,12950
442260,2016,6,33,9,42,699
442290,2016,5,67,57,124,6074
442500,2016,6,395,100,495,38927
442710,2016,6,276,96,372,99194
442770,2016,6,13,5,18,407
442780,2017,6,1029,403,1432,67065
442810,2016,5,227,190,417,90063
442890,2016,5,33,31,64,3348
443250,2016,7,23,5,28,1537
443260,2016,5,35,21,56,3955
443360,2016,8,112,10,122,6158
443420,2016,8,153,23,176,17964
443450,2016,8,47,8,55,3699
443460,2016,8,44,7,51,6159
443570,2016,5,29,31,60,5400
443580,2016,6,1387,501,1888,137385
443630,2016,8,61,7,68,3432
443650,2016,7,40,6,46,1780
443810,2016,8,4190,812,5002,376582
443830,2016,5,11,9,20,1228
443850,2016,5,11,6,17,371
443860,2016,8,126,18,144,9108
443880,2017,6,95,38,133,16977
444000,2016,8,72,11,83,1691
444090,2018,8,132844,23677,156521,14371946
444090,2018,8,132844,23677,156521,14371946
444130,2016,8,55,12,67,2948
444140,2016,8,336,28,364,23894
444160,2016,5,77,60,137,34485
444170,2017,7,38,1,39,686
444180,2016,5,73,32,105,2027
444210,2016,4,4,11,15,824
444220,2016,5,349,164,513,127104
444260,2016,5,218,104,322,70170
444270,2016,7,37,5,42,3089
444280,2016,8,72,14,86,40862
444350,2016,4,30,103,133,3921
444420,2016,4,19,48,67,2746
444440,2016,5,32,24,56,7240
444520,2016,6,75,20,95,46706
444550,2016,7,22,5,27,951
444590,2016,8,171,31,202,9881
444620,2016,4,26,41,67,19950
444640,2016,8,4575,876,5451,1410438
444670,2016,8,60,8,68,3228
444690,2016,5,56,36,92,2771
444720,2016,5,189,88,277,24304
444740,2016,5,6,5,11,475
444770,2016,8,206,10,216,11170
444800,2016,8,158,21,179,10312
444870,2016,7,8,2,10,1512
444880,2016,5,115,69,184,19986
444930,2016,6,225,68,293,48795
444940,2016,8,174,13,187,12967
445000,2018,7,17,1,18,338
445070,2016,7,16,2,18,1145
445110,2016,8,174,17,191,25837
445130,2016,8,593,140,733,51025
445190,2017,8,1297,258,1555,81722
445220,2020,8,2545,255,2800,197511
445230,2016,8,649,146,795,49841
445600,2016,8,44,11,55,3283
445770,2016,8,155,31,186,16045
445870,2017,5,31,15,46,3645
445980,2018,8,2003,238,2241,261463
446020,2018,6,2680,759,3439,191656
446030,2017,8,62,5,67,3382
446040,2016,8,102,20,122,6842
446070,2016,7,19,2,21,669
446100,2016,6,74,20,94,4983
446120,2018,8,182,29,211,10628
446150,2018,5,1260,789,2049,455442
446240,2016,5,19,9,28,680
446250,2016,5,32,15,47,3022
446310,2016,8,70,4,74,4208
446330,2016,8,48,2,50,3341
446390,2016,6,332,100,432,19323
446540,2016,5,95,62,157,16758
446550,2017,8,42,10,52,4154
446600,2016,6,52,14,66,7132
446610,2017,5,20,14,34,6480
446640,2016,8,199,22,221,138730
446760,2017,7,29,3,32,4247
446770,2016,6,96,28,124,75301
446790,2017,6,445,167,612,45719
446800,2016,6,3506,949,4455,337931
446810,2017,8,94,13,107,3482
446840,2017,8,463,24,487,33964
446870,2016,4,4,14,18,2015
446910,2016,8,54,5,59,8811
446990,2016,6,168,57,225,21389
447010,2016,7,19,1,20,2874
447020,2016,8,8546,698,9244,796543
447120,2018,8,162,25,187,9061
447170,2016,6,114,30,144,5098
447180,2016,5,53,27,80,3964
447190,2016,8,95,12,107,3985
447200,2016,8,92,10,102,7131
447210,2017,7,41,2,43,1376
447290,2017,8,379,90,469,23579
447310,2016,6,56,18,74,9469
447530,2016,9,8906,209,9115,290658
447570,2016,8,250,41,291,21650
447780,2016,8,181,34,215,25250
447800,2016,8,69,12,81,7497
447820,2017,8,11577,2450,14027,1052510
447860,2016,5,34,20,54,8162
447890,2016,8,429,71,500,65918
447950,2016,8,75,4,79,14477
447960,2016,5,29,14,43,2977
447990,2016,5,11,6,17,11453
448000,2016,5,127,112,239,42836
448010,2016,7,27,3,30,20964
448050,2016,7,34,3,37,1811
448070,2016,5,287,215,502,204293
448090,2016,5,14,10,24,6382
448110,2016,5,20,12,32,4249
448160,2016,7,41,3,44,1595
448170,2017,7,37,8,45,3875
448240,2016,5,150,104,254,26115
448280,2016,8,914,127,1041,203196
448290,2017,8,246,46,292,7884
448320,2017,8,174,35,209,13445
448370,2016,8,876,49,925,24334
448380,2016,7,24,3,27,1079
448440,2016,5,185,138,323,82542
448470,2016,5,131,97,228,222993
448480,2016,5,25,15,40,16045
448500,2016,7,25,2,27,9974
448510,2016,8,4876,418,5294,600140
448520,2016,7,28,1,29,5475
448550,2016,7,16,1,17,1437
448560,2016,6,96,35,131,10797
448570,2016,6,75,30,105,13853
448620,2016,5,52,32,84,9694
448630,2016,4,35,53,88,192449
448640,2016,5,54,31,85,293115
448720,2016,6,23,6,29,1374
448730,2016,5,8,4,12,411
448790,2016,5,21,10,31,41006
448850,2018,9,613,21,634,13985
448910,2016,8,64,12,76,7428
449020,2016,8,347,50,397,48516
449050,2016,5,191,192,383,40244
449060,2016,8,93,18,111,7395
449090,2016,6,44,17,61,2582
449120,2016,5,10,5,15,23929
449170,2016,7,30,1,31,40350
449180,2016,7,25,1,26,1630
449220,2016,5,558,341,899,232984
449250,2016,8,147,11,158,7591
449300,2016,5,211,134,345,20787
449310,2016,7,20,2,22,540
449320,2016,5,11,6,17,420
449340,2016,5,23,11,34,16288
449350,2016,5,8,4,12,595
449450,2016,7,39,3,42,1057
449460,2017,6,30,11,41,1945
449510,2017,8,64,11,75,1816
449530,2016,6,339,88,427,253400
449540,2016,8,2797,390,3187,294984
449550,2016,8,71,4,75,7878
449640,2017,6,37,14,51,1397
449680,2016,8,1769,311,2080,388554
449690,2016,6,42,13,55,1931
449700,2017,6,9,3,12,186
449710,2016,6,238,88,326,26076
449730,2016,8,125,10,135,15441
449800,2016,8,2225,433,2658,119678
449820,2016,5,36,28,64,3159
449960,2018,8,1713,99,1812,43452
450060,2016,5,24,21,45,2664
450110,2016,6,73,30,103,20442
450170,2017,8,85,9,94,3979
450190,2016,6,137,37,174,38895
450250,2016,5,17,11,28,1041
450290,2016,5,16,12,28,2635
450440,2016,8,79,6,85,3304
450500,2016,8,208,19,227,16659
450540,2016,9,1721,50,1771,9766
450650,2016,7,18,2,20,3969
450670,2016,6,281,90,371,27120
450700,2018,6,114,36,150,17202
450760,2016,7,14,1,15,1413
450860,2020,5,101,86,187,12647
450950,2017,8,85,9,94,3644
451010,2016,8,112,11,123,8117
451020,2017,8,2181,240,2421,146382
451080,2017,7,18,3,21,2864
451100,2016,7,29,1,30,4295
451400,2016,6,60,23,83,4656
451570,2016,8,114,14,128,4834
451600,2019,8,119,15,134,5561
451640,2016,7,27,5,32,1808
451760,2016,8,789,43,832,41053
451780,2016,6,206,67,273,25108
451800,2016,5,6,5,11,366
451840,2016,8,481,71,552,35371
451880,2016,6,319,121,440,349290
451990,2016,6,63,26,89,2321
452060,2017,8,1124,134,1258,90117
452120,2016,8,41,9,50,4975
452230,2016,5,179,109,288,75066
452420,2016,8,160,22,182,12961
452450,2016,5,58,31,89,7011
452510,2016,8,551,31,582,44801
452540,2017,8,199,33,232,5909
452570,2017,8,446,9,455,19817
452860,2016,8,162,14,176,8373
452920,2016,7,29,3,32,3699
452930,2016,4,5,8,13,701
452970,2016,5,63,30,93,4756
453030,2016,6,11,3,14,553
453090,2018,8,1051,92,1143,86033
453100,2016,8,172,33,205,42885
453130,2016,7,24,2,26,2176
453220,2017,7,10,2,12,295
453290,2016,6,136,36,172,4687
453300,2016,8,65,16,81,7592
453310,2017,8,189,36,225,4832
453340,2016,8,605,36,641,24411
453500,2018,5,18,8,26,656
453650,2016,7,13,3,16,621
453660,2016,5,10,5,15,3517
453690,2018,8,112,23,135,7292
453710,2016,8,80,19,99,6358
453720,2016,6,86,32,118,7288
453730,2016,5,16,10,26,3529
453740,2016,7,20,2,22,3690
453750,2016,6,199,58,257,27106
453770,2016,5,25,11,36,4394
453780,2016,7,17,1,18,685
453790,2016,8,94,19,113,1814
453810,2016,5,17,11,28,4223
453830,2016,7,9,1,10,5071
453850,2016,5,163,85,248,222892
453910,2018,7,9,1,10,275
454060,2016,8,686,144,830,80417
454070,2016,5,147,107,254,11256
454100,2016,8,308,77,385,27255
454130,2016,7,21,4,25,1933
454160,2016,8,109,5,114,2425
454180,2016,5,121,63,184,84274
454190,2016,8,109,10,119,3323
454220,2016,6,62,16,78,26515
454250,2016,8,160,23,183,12260
454320,2016,8,101,7,108,10790
454330,2017,7,12,2,14,788
454410,2017,8,356,63,419,19138
454420,2016,6,15,4,19,4060
454520,2016,6,24,9,33,597
454600,2016,5,269,216,485,120414
454610,2016,5,30,14,44,3327
454630,2016,7,13,1,14,271
454650,2016,6,7107,1898,9005,535273
454700,2016,5,8,10,18,4655
454720,2016,7,13,2,15,1219
454770,2017,7,13,1,14,484
454890,2016,8,307,60,367,310160
454900,2016,8,57,5,62,6881
454970,2016,7,28,4,32,5705
455000,2016,5,38,23,61,46323
455110,2016,6,22,7,29,10004
455120,2016,5,171,136,307,26135
455190,2017,6,7,3,10,291
455400,2016,8,684,69,753,80832
455490,2016,5,35,24,59,3659
455640,2016,7,12,2,14,1599
455690,2017,7,39,2,41,4758
455700,2016,5,17,15,32,2921
455770,2017,7,9,2,11,550
455820,2018,8,288,50,338,9217
455830,2016,6,10,3,13,582
455960,2016,5,22,10,32,2397
455980,2018,8,789,128,917,73841
456130,2016,7,19,2,21,5356
456170,2017,6,61,23,84,1882
456180,2018,7,32,5,37,1293
456430,2016,8,166,24,190,11343
456670,2017,8,2055,269,2324,126026
456690,2016,7,22,3,25,4460
456740,2017,7,13,1,14,136
456780,2016,5,54,29,83,5070
456810,2016,6,107,38,145,34699
456830,2016,7,15,2,17,1861
457210,2016,9,704,35,739,41246
457320,2016,8,383,35,418,28414
457370,2017,7,12,2,14,1447
457380,2017,6,56,20,76,4838
457450,2016,6,22,7,29,5878
457480,2016,8,162,25,187,12854
457490,2016,8,142,21,163,28693
457520,2016,5,68,33,101,8392
457530,2016,8,88,18,106,3736
457600,2016,6,83,33,116,4488
457680,2016,8,468,76,544,12623
457690,2016,4,8,28,36,544
457710,2016,4,111,269,380,263944
457730,2017,6,271,94,365,30350
457760,2017,6,314,123,437,25175
457770,2016,7,20,3,23,2492
457820,2016,5,69,38,107,287010
457890,2017,6,124,32,156,14758
457960,2016,8,579,50,629,60792
457980,2016,7,15,3,18,198
458000,2016,6,336,100,436,17202
458030,2016,5,18,14,32,2535
458170,2017,7,31,3,34,2100
458330,2018,7,30,3,33,1598
458370,2016,7,20,4,24,5471
458410,2018,5,30,15,45,4804
458450,2016,4,14,28,42,2334
458470,2016,8,296,23,319,32591
458480,2016,8,132,17,149,22246
458510,2016,7,18,4,22,3711
458520,2018,5,79,115,194,30574
458540,2017,8,49,7,56,3945
458600,2017,5,58,30,88,232140
458630,2016,6,77,25,102,9957
458660,2021,7,32,4,36,3051
458680,2017,6,57,18,75,8510
458710,2016,9,1864,64,1928,113038
458730,2016,8,323,48,371,24861
458770,2016,5,297,213,510,33760
458830,2016,5,95,66,161,10089
458920,2016,6,93,29,122,9904
458960,2016,5,300,169,469,102051
459090,2016,8,207,15,222,6077
459130,2016,5,29,13,42,12395
459170,2016,5,21,17,38,9486
459220,2017,8,1758,193,1951,197404
459310,2016,5,68,37,105,3049
459350,2017,7,41,8,49,3290
459440,2016,4,30,53,83,3272
459610,2017,7,17,1,18,712
459640,2017,5,7,4,11,652
459820,2016,8,5370,717,6087,535661
459830,2018,7,17,1,18,1302
459940,2016,6,172,68,240,4045
460120,2016,9,1987,71,2058,75376
460150,2016,6,47,16,63,11723
460190,2016,6,34,10,44,12152
460220,2016,8,58,7,65,3643
460340,2016,8,296,31,327,9673
460430,2017,8,381,26,407,11437
460560,2016,7,20,4,24,3780
460630,2016,8,66,4,70,4638
460640,2016,5,69,47,116,4499
460650,2016,6,31,8,39,1623
460700,2016,8,431,92,523,46714
460750,2016,8,54,11,65,5803
460780,2016,8,67,4,71,3314
460790,2017,8,6225,482,6707,424901
460810,2017,8,1741,195,1936,143289
460910,2016,8,84,19,103,28651
460960,2016,8,210,32,242,58181
460970,2016,7,23,1,24,2994
461010,2016,6,150,41,191,43190
461030,2016,5,19,11,30,4320
461170,2017,8,116,18,134,2171
461230,2016,8,138,15,153,12188
461360,2016,8,64,8,72,5471
461390,2017,5,13,10,23,29091
461400,2020,6,71,26,97,1406
461410,2018,8,54,7,61,2404
461480,2016,7,36,4,40,4649
461490,2016,5,52,37,89,8615
461560,2016,8,4078,220,4298,326618
461620,2016,8,945,80,1025,47924
461640,2016,8,558,92,650,130570
461650,2016,5,9,5,14,1113
461680,2016,4,45,88,133,12792
461700,2016,8,207,17,224,13365
461710,2016,7,40,8,48,11507
461730,2017,5,181,84,265,73275
461750,2016,6,78,31,109,34088
461760,2016,6,42,12,54,31866
461810,2016,7,21,1,22,683
461830,2016,6,12,4,16,4940
461840,2016,9,2048,90,2138,7447
461850,2016,5,42,19,61,20166
461860,2016,5,15,12,27,3046
461880,2016,5,81,68,149,178564
461910,2016,6,1904,534,2438,207263
461940,2016,5,39,31,70,13947
461950,2017,8,1125,218,1343,126474
461970,2016,4,53,82,135,50087
462000,2016,8,90,12,102,7356
462070,2016,5,6,5,11,262
462100,2016,8,157,24,181,5539
462130,2016,6,14,5,19,4081
462240,2017,8,61,8,69,2560
462250,2017,7,8,2,10,426
462440,2017,5,157,197,354,8104
462480,2016,7,38,6,44,2187
462520,2016,7,25,2,27,2011
462620,2016,8,62,1,63,2917
462640,2017,5,16,10,26,697
462680,2016,6,174,52,226,22513
462700,2016,5,32,18,50,7986
462730,2016,5,37,22,59,21330
462770,2017,8,3359,331,3690,170731
462780,2016,8,3492,557,4049,596551
462830,2016,4,13,32,45,2032
462860,2016,6,28,9,37,2418
462940,2018,6,43,17,60,2882
462950,2016,5,24,24,48,2718
462960,2016,5,274,139,413,93014
462990,2016,8,179,9,188,9473
463030,2016,5,140,78,218,7982
463060,2016,6,404,128,532,32389
463150,2016,8,1404,208,1612,194090
463160,2016,6,80,22,102,8213
463180,2016,6,71,22,93,36936
463210,2016,8,676,113,789,340127
463220,2016,6,284,81,365,307976
463270,2016,8,1186,86,1272,47745
463320,2016,5,9,13,22,1252
463350,2016,6,292,99,391,93092
463390,2016,8,650,64,714,3090
463460,2016,6,25,7,32,820
463470,2016,5,18,10,28,751
463540,2016,7,15,2,17,204
463670,2017,5,20,16,36,23005
463700,2017,8,96,9,105,4327
463760,2016,8,78,16,94,5373
463830,2016,5,5,6,11,179
463860,2016,5,111,59,170,8661
463870,2016,5,11,15,26,4257
463880,2017,6,11,4,15,1661
463930,2016,8,309,24,333,41512
463980,2016,8,134,16,150,8800
464000,2016,6,30,9,39,2112
464050,2016,6,30,9,39,3624
464060,2017,8,3215,336,3551,206216
464100,2017,6,121,35,156,7640
464150,2017,8,185,40,225,12724
464230,2016,8,50,11,61,9025
464240,2016,5,14,8,22,669
464340,2017,5,687,688,1375,80157
464360,2017,8,338,12,350,13861
464380,2016,4,3,9,12,664
464440,2016,5,35,22,57,8009
464450,2016,8,347,10,357,21323
464470,2016,5,182,128,310,9154
464620,2016,8,368,27,395,14584
464650,2016,7,28,4,32,3345
464670,2016,7,15,1,16,1500
464700,2016,5,141,155,296,79707
464800,2016,5,45,47,92,28231
464850,2017,5,122,93,215,5733
464880,2017,6,267,72,339,18536
464960,2016,8,193,19,212,190974
465020,2018,7,41,2,43,3504
465130,2016,8,63,10,73,3653
465170,2016,6,129,55,184,21679
465180,2016,8,59,3,62,3479
465200,2020,8,191,15,206,11389
465240,2017,8,740,110,850,53382
465280,2016,8,158,27,185,16846
465440,2016,7,24,6,30,11121
465520,2016,8,3708,196,3904,199147
465650,2017,8,547,42,589,56722
465660,2016,5,51,39,90,9061
465670,2016,6,13,5,18,4060
465720,2016,5,62,29,91,14930
465750,2016,6,8,3,11,3190
465760,2016,6,180,65,245,20913
465780,2016,8,288,59,347,20818
465840,2016,5,59,26,85,6250
465870,2016,5,17,16,33,2619
466110,2018,8,431,32,463,9650
466130,2017,5,381,211,592,13976
466160,2017,7,18,1,19,420
466170,2016,8,352,58,410,59270
466240,2017,6,10727,3887,14614,2604178
466270,2016,8,422,56,478,41326
466300,2017,9,774,39,813,109926
466350,2016,5,61,33,94,5549
466420,2016,6,46,19,65,24957
466430,2016,7,43,1,44,3514
466490,2016,5,37,35,72,10033
466500,2016,6,1692,715,2407,93861
466520,2016,5,19,13,32,2099
466560,2018,8,9069,1217,10286,787294
466720,2016,8,53,4,57,11090
466730,2016,5,179,100,279,98551
466740,2016,6,269,85,354,16996
466770,2016,7,14,1,15,199
466780,2016,6,41,13,54,7772
466800,2016,6,120,31,151,9796
466810,2017,8,232,11,243,3690
466820,2016,7,39,6,45,3650
466830,2016,5,34,26,60,10726
466860,2018,6,1026,401,1427,43069
466870,2016,8,210,38,248,10277
466920,2016,8,40,10,50,4014
467010,2016,5,37,47,84,283367
467060,2019,5,24,14,38,6614
467210,2016,8,245,13,258,6360
467270,2017,5,23,10,33,687
467310,2016,8,45,11,56,151788
467320,2016,6,51,13,64,8650
467330,2016,7,25,6,31,4073
467350,2016,4,3,8,11,14850
467360,2016,8,657,113,770,73247
467370,2016,5,205,240,445,326346
467380,2016,9,754,34,788,39726
467390,2016,5,143,71,214,121356
467490,2016,7,18,3,21,1169
467520,2016,5,289,263,552,18054
467570,2017,5,118,122,240,5529
467660,2017,8,304,67,371,25853
467760,2018,8,82,6,88,10401
467780,2016,8,66,2,68,1838
467820,2018,8,540,40,580,50085
467850,2016,5,69,33,102,2818
467930,2016,6,344,111,455,32385
467940,2016,7,15,2,17,1136
467950,2016,6,140,52,192,76580
467960,2016,8,3277,449,3726,267054
468000,2017,4,83,128,211,5035
468100,2016,6,50,14,64,1602
468160,2017,5,35,16,51,1692
468240,2018,8,76,4,80,10514
468250,2017,5,538,278,816,193891
468330,2018,7,19,4,23,819
468490,2016,8,272,66,338,90569
468530,2016,8,806,120,926,26991
468560,2016,5,619,559,1178,179688
468570,2016,5,42,34,76,21575
468700,2016,6,373,96,469,190329
468920,2018,6,250,85,335,13901
468930,2016,5,76,44,120,14231
469610,2017,6,563,199,762,84018
469720,2017,8,176,36,212,9411
469790,2017,8,344,4,348,9499
469820,2018,8,3615,347,3962,375882
469830,2018,6,314,127,441,46719
469890,2016,8,160,35,195,64256
469980,2016,5,20,15,35,8268
470030,2016,6,18,5,23,746
470040,2017,5,47,24,71,6163
470060,2016,8,76,19,95,3871
470090,2018,7,17,1,18,345
470140,2016,5,6,6,12,3702
470210,2017,6,183,51,234,16030
470260,2016,8,1164,285,1449,79625
470270,2016,6,194,49,243,167302
470300,2016,6,28,11,39,2535
470310,2020,8,305,26,331,5707
470440,2016,8,60,1,61,749
470480,2016,6,17,6,23,3980
470590,2016,6,40,14,54,8124
470780,2017,8,94,3,97,6273
471010,2017,6,267,74,341,18919
471160,2016,7,15,2,17,1804
471170,2016,5,45,20,65,24956
471270,2016,7,8,2,10,1907
471330,2016,8,291,71,362,55280
471380,2016,6,29,10,39,4157
471700,2017,8,48,4,52,809
471710,2021,9,2476,105,2581,316036
471730,2016,6,15,5,20,1441
471810,2017,8,54,1,55,4881
471920,2016,8,88,6,94,3626
472060,2016,8,99,22,121,16627
472420,2016,8,92,18,110,3057
472680,2016,6,443,120,563,82084
472690,2016,5,21,18,39,5195
472830,2016,5,8,5,13,572
472870,2016,8,129,2,131,14157
473050,2016,3,2,15,17,2879
473140,2016,5,38,22,60,49447
473450,2016,8,81,15,96,7926
473460,2016,8,483,41,524,7752
473480,2016,5,9,7,16,3107
473530,2017,8,163,22,185,29754
473540,2016,4,4,7,11,8330
473610,2017,5,40,52,92,3065
473670,2016,5,88,101,189,35328
473690,2017,5,4739,2313,7052,228337
473720,2016,7,12,1,13,260
473770,2018,8,846,86,932,101166
473910,2016,5,109,58,167,11923
473970,2016,6,105,35,140,14745
474010,2016,5,198,111,309,37636
474050,2016,5,41,38,79,98042
474210,2016,8,468,48,516,25010
474620,2016,6,11,3,14,275
474730,2016,5,6,7,13,2170
474750,2016,8,4094,458,4552,496869
474830,2017,5,26,13,39,44378
474890,2020,6,31,10,41,2834
474910,2016,5,86,51,137,33584
474980,2016,8,57,6,63,2076
475070,2018,7,23,5,28,5484
475090,2017,5,24,31,55,1675
475150,2016,8,8737,730,9467,1041965
475490,2016,8,286,71,357,13561
475520,2016,6,7,3,10,495
475530,2017,5,11,5,16,1188
475960,2018,8,47,4,51,1841
476020,2017,8,105,13,118,10101
476240,2016,8,392,17,409,24941
476370,2016,7,12,3,15,355
476420,2017,8,109,25,134,10723
476450,2016,5,24,16,40,787
476460,2016,8,469,47,516,51501
476490,2016,8,70,6,76,6171
476510,2016,5,80,36,116,3869
476530,2016,8,211,17,228,9268
476600,2017,5,8703,6815,15518,891381
476650,2016,8,145,17,162,11056
476710,2016,5,16,9,25,2081
476920,2016,5,71,39,110,5653
476930,2016,6,44,15,59,3680
477140,2016,5,21,27,48,4731
477160,2016,8,16184,1475,17659,3097845
477170,2016,5,28,13,41,2005
477310,2016,7,37,2,39,3168
477720,2017,5,5,5,10,711
477730,2017,8,753,129,882,15757
477740,2017,8,451,20,471,23847
477770,2016,8,1012,174,1186,71503
477870,2016,8,572,103,675,37769
477950,2016,7,13,3,16,665
478210,2016,5,34,33,67,1576
479040,2016,5,20,9,29,506
479110,2016,6,25,10,35,2886
479140,2016,7,12,2,14,640
479990,2016,5,31,14,45,2862
480410,2016,7,11,1,12,1335
480430,2017,6,1353,343,1696,382313
480450,2016,8,207,12,219,16213
480480,2016,8,188,26,214,58424
480490,2017,8,13570,1450,15020,704179
480640,2017,5,214,99,313,23672
480650,2016,8,1513,278,1791,178059
480900,2016,8,78,11,89,2915
481110,2016,6,337,95,432,11277
481180,2016,8,79,8,87,3027
481420,2016,5,21,17,38,11500
481510,2017,8,5002,300,5302,216979
481600,2017,6,17,7,24,4211
481870,2018,6,186,49,235,20867
482300,2016,6,403,124,527,22083
482330,2016,6,37,10,47,2956
482450,2016,8,320,32,352,20609
482990,2016,7,32,1,33,1192
483420,2016,8,418,32,450,16734
483770,2017,4,74,148,222,14373
483960,2016,5,160,77,237,11263
483980,2016,9,826,28,854,35910
484350,2017,6,149,50,199,11632
484830,2017,7,25,6,31,12522
484900,2017,6,516,189,705,41895
484930,2017,7,38,2,40,644
484950,2016,6,705,218,923,107165
485040,2016,8,400,26,426,10234
485080,2016,5,49,22,71,22228
485160,2016,7,27,3,30,1392
485260,2016,7,31,4,35,3270
485340,2016,6,12,5,17,598
485350,2016,8,338,64,402,139393
485360,2016,8,45,8,53,7803
485370,2016,5,199,90,289,18782
485380,2016,8,1112,225,1337,98409
485390,2017,8,87,16,103,179335
485430,2016,5,7,5,12,5503
485450,2016,5,132,68,200,37149
485510,2017,8,7030,1568,8598,347803
485600,2016,7,31,3,34,1539
485610,2017,6,1430,485,1915,434225
485620,2016,6,29,10,39,2546
485630,2016,5,17,22,39,1806
485650,2016,5,140,175,315,88435
485670,2018,5,9,11,20,580
485680,2017,7,23,1,24,909
485690,2016,6,218,69,287,13817
485730,2016,6,117,46,163,68606
485750,2016,5,11,6,17,365
485800,2016,6,57,19,76,4507
485860,2016,6,154,58,212,9874
485870,2016,6,256,69,325,87797
485890,2016,5,497,343,840,30384
485920,2016,7,28,5,33,3068
485970,2016,7,32,2,34,1122
485980,2017,8,1353,183,1536,40758
486120,2016,5,23,13,36,8170
486130,2016,5,12,8,20,336
486290,2016,7,25,2,27,6066
486310,2016,8,3065,361,3426,187799
486350,2016,7,14,2,16,887
486380,2017,8,52,1,53,881
486460,2017,5,27,24,51,10204
486470,2016,5,9,9,18,480
486500,2016,5,18,9,27,17421
486510,2016,8,190,42,232,5376
486540,2016,6,123,48,171,15818
486640,2016,5,10,9,19,3629
486690,2017,6,447,138,585,12256
486720,2016,8,273,32,305,20231
486780,2016,8,387,55,442,75228
486810,2016,7,21,4,25,7405
486850,2016,6,55,15,70,6144
486880,2016,4,45,82,127,28151
486990,2017,5,8,9,17,2555
487000,2019,8,190,44,234,13437
487030,2016,6,50,18,68,12519
487040,2017,7,16,3,19,780
487120,2019,5,1880,1058,2938,150665
487160,2016,8,53,5,58,3099
487180,2016,6,143,61,204,215899
487220,2016,6,846,280,1126,411391
487330,2016,8,66,15,81,5730
487350,2016,5,72,44,116,20721
487370,2016,8,140,19,159,117137
487380,2016,7,11,2,13,718
487430,2016,8,1023,98,1121,70540
487530,2016,8,54,12,66,72714
487630,2016,5,28,14,42,2623
487720,2018,5,787,872,1659,40731
487770,2016,8,44,9,53,6530
488040,2016,7,43,4,47,4363
488070,2016,5,6,4,10,614
488220,2016,6,15,5,20,4378
488280,2016,8,415,42,457,31334
488300,2016,8,163,27,190,5830
488330,2016,5,10,5,15,19599
488460,2016,6,17,6,23,9062
488660,2016,8,147,32,179,16938
488690,2017,8,57,12,69,1820
488760,2017,8,96,15,111,5155
488770,2016,8,147,32,179,5491
488790,2017,5,3558,1533,5091,320160
488910,2016,5,147,65,212,25840
488920,2018,8,166,35,201,14833
488960,2016,7,36,2,38,1448
489000,2016,5,95,51,146,23613
489050,2016,4,3,7,10,234
489140,2017,8,678,93,771,60381
489160,2017,7,11,2,13,448
489170,2016,5,110,51,161,6332
489260,2017,6,50,16,66,4265
489360,2016,8,555,104,659,40530
489380,2018,8,365,29,394,31463
489400,2016,6,12,5,17,629
489440,2016,6,27,8,35,1257
489460,2016,6,296,83,379,47986
489520,2019,8,4847,909,5756,656913
489570,2017,6,32,13,45,1765
489580,2016,6,50,17,67,20335
489610,2016,8,370,17,387,14683
489660,2016,8,98,10,108,5490
489720,2016,7,35,3,38,1459
489760,2016,7,29,3,32,1099
489830,2016,6,36579,11540,48119,4398897
489930,2017,6,38,15,53,1728
490080,2017,5,19,20,39,1712
490220,2018,8,430,81,511,451302
490230,2016,8,278,26,304,26082
490250,2017,7,17,3,20,530
490280,2022,8,78,6,84,5099
490300,2016,6,17,7,24,5358
490450,2017,6,226,70,296,18361
490490,2017,8,141,14,155,5880
490690,2017,6,17,7,24,7823
490820,2016,8,223,48,271,44814
490860,2016,6,27,8,35,7990
490870,2016,8,69,14,83,5061
490880,2016,7,32,6,38,13885
490910,2016,5,6,9,15,5915
490950,2016,8,66,3,69,1983
490980,2016,6,80,21,101,166257
491000,2016,8,261,45,306,23827
491010,2018,7,17,2,19,23496
491040,2016,9,557,22,579,21604
491060,2016,7,13,2,15,2651
491090,2016,5,79,55,134,8080
491130,2016,8,1435,154,1589,208613
491160,2016,6,73,22,95,14490
491220,2016,8,97,10,107,3791
491260,2016,5,122,73,195,264026
491330,2016,8,210,22,232,24715
491350,2016,7,24,1,25,371
491420,2017,8,232,17,249,4098
491530,2016,5,534,363,897,65408
491560,2016,5,12,9,21,1744
491620,2016,6,54,14,68,5957
491650,2016,5,109,48,157,244440
491660,2017,6,9,3,12,313
491670,2016,7,13,3,16,1856
491700,2017,7,16,3,19,1099
491710,2016,3,2,10,12,524
491720,2016,7,21,5,26,6253
491770,2017,4,51,114,165,10824
491830,2016,6,17,5,22,497
491950,2016,8,4050,318,4368,228284
492090,2016,6,39,12,51,9068
492150,2020,6,214,63,277,17145
492170,2016,5,37,17,54,11694
492180,2018,7,23,1,24,354
492220,2016,6,100,27,127,8346
492270,2016,8,169,34,203,17449
492280,2016,7,16,4,20,3137
492290,2017,6,206,63,269,21841
492340,2021,8,191,15,206,9206
492370,2016,6,37,11,48,3458
492430,2016,6,70,29,99,8313
492500,2016,6,150,46,196,6201
492600,2016,5,11,9,20,25672
492610,2016,4,6,13,19,4163
492630,2016,8,564,74,638,39763
492710,2016,8,98,19,117,7549
492800,2016,5,205,160,365,85793
492870,2016,6,42,13,55,4684
493080,2017,8,104,5,109,3376
493100,2016,7,28,5,33,617
493180,2017,8,46,8,54,3745
493200,2017,8,1485,150,1635,54109
493220,2017,6,30,9,39,2276
493340,2016,8,18366,2076,20442,1682734
493370,2016,6,659,274,933,175778
493380,2016,5,9,4,13,966
493480,2017,5,7,10,17,1050
493540,2017,8,163,10,173,4405
493620,2016,7,10,2,12,460
493650,2016,4,74,188,262,260100
493720,2016,6,132,42,174,8393
493780,2016,5,16,7,23,22431
493790,2017,5,13,6,19,1827
493820,2017,6,28,8,36,990
493840,2017,5,746,548,1294,53532
493900,2017,8,4668,246,4914,128098
493980,2016,6,22,7,29,5318
494100,2016,7,46,1,47,1487
494170,2017,7,27,4,31,1205
494230,2016,8,486,35,521,27826
494290,2016,4,16,31,47,31467
494320,2017,5,75,42,117,5427
494350,2016,5,7,9,16,865
494440,2016,5,41,22,63,3132
494450,2016,5,25,26,51,2941
494460,2016,5,19,22,41,2654
494470,2016,5,30,25,55,3269
494580,2017,6,68,26,94,9054
494600,2016,8,92,22,114,6865
494670,2017,5,127,119,246,12024
494700,2017,7,35,4,39,1120
494810,2016,8,171,27,198,14172
494960,2017,8,67,8,75,3197
494980,2016,5,6,8,14,378
494990,2016,6,15,5,20,1438
495010,2016,4,17,29,46,4863
495050,2017,8,252,47,299,28262
495090,2016,6,31,11,42,5933
495110,2016,8,346,27,373,32704
495140,2017,5,308,189,497,40326
495280,2017,8,490,47,537,53996
495570,2016,6,28,12,40,22116
495580,2017,5,79,58,137,6897
495680,2016,7,23,3,26,891
495720,2016,8,111,18,129,3617
495730,2016,4,2,8,10,321
495750,2017,7,12,1,13,1112
495820,2017,7,12,2,14,482
495890,2016,9,8446,403,8849,288782
495910,2016,6,1388,408,1796,531876
495960,2016,5,21,12,33,3687
495980,2016,6,81,22,103,4764
495990,2016,8,666,127,793,12612
496040,2018,6,23,9,32,787
496250,2016,8,195,24,219,10100
496260,2016,8,143,9,152,8882
496290,2018,7,29,7,36,1530
496300,2016,8,3407,538,3945,509466
496320,2016,7,12,2,14,6892
496340,2017,6,59,17,76,4572
496390,2016,7,16,2,18,603
496400,2016,5,25,13,38,1657
496450,2016,7,39,5,44,859
496460,2017,5,1776,885,2661,196368
496480,2016,7,14,3,17,411
496490,2016,5,35,29,64,990
496590,2016,7,21,4,25,6392
496620,2017,8,444,84,528,39590
496630,2016,8,49,6,55,2189
496660,2017,5,9,8,17,716
496680,2016,5,161,187,348,217895
496730,2016,5,116,71,187,17114
496810,2016,8,849,97,946,50373
496850,2016,7,10,2,12,378
496890,2016,8,2044,274,2318,108051
496930,2016,8,97,22,119,5434
496960,2017,5,9,4,13,743
496980,2016,7,9,2,11,4110
497020,2016,5,15,16,31,29314
497040,2016,6,30,11,41,1491
497080,2016,8,50,12,62,6028
497100,2016,5,53,24,77,67843
497180,2016,8,917,220,1137,55408
497400,2016,6,288,83,371,46785
497420,2016,7,22,4,26,4133
497460,2016,8,49,1,50,2279
497470,2016,5,20,22,42,2281
497510,2016,7,10,1,11,730
497580,2016,5,72,31,103,9079
497640,2016,9,1289,49,1338,142959
497680,2016,6,33,9,42,1169
497700,2016,8,116,17,133,12031
497710,2017,5,9,5,14,611
497720,2016,5,22,26,48,5967
497730,2017,8,147,23,170,6861
497780,2016,8,125,1,126,3145
497800,2017,8,67,1,68,2088
497850,2016,8,299,62,361,47119
498190,2016,6,116,33,149,5741
498240,2016,6,5119,1615,6734,272720
498320,2017,4,46,97,143,270525
498330,2016,8,353,41,394,18171
498340,2019,5,50,25,75,5422
498470,2016,7,33,1,34,768
498500,2017,8,387,76,463,19395
498570,2016,8,123,25,148,6724
498580,2016,6,23,9,32,858
498660,2016,8,314,78,392,182258
498680,2016,7,10,2,12,104
498710,2018,6,81,31,112,14012
498740,2017,6,29,8,37,2771
498830,2016,7,26,6,32,3638
498850,2016,6,19,6,25,1858
498990,2017,6,38,12,50,2682
499210,2017,3,2,10,12,351
499340,2016,7,38,2,40,2973
499440,2016,9,3065,79,3144,91525
499520,2016,8,2312,357,2669,127992
499540,2016,8,62,10,72,20377
499610,2016,6,39,16,55,3118
499620,2016,8,181,44,225,23253
499660,2019,8,734,145,879,60274
499890,2017,8,188,10,198,4643
499900,2016,5,9,4,13,2244
499910,2016,7,43,1,44,752
500150,2018,6,42,18,60,17451
500170,2017,5,20,20,40,4433
500180,2016,7,9,1,10,256
500260,2018,8,378,74,452,76897
500320,2016,6,20,6,26,3675
500420,2016,8,47,10,57,4623
500660,2016,5,15,11,26,6435
500670,2017,8,240,27,267,18908
500690,2016,7,28,3,31,879
500710,2017,5,519,326,845,36893
500790,2017,7,17,1,18,3049
500870,2016,6,110,29,139,6084
500940,2016,7,16,4,20,24818
501080,2018,6,506,188,694,39242
501110,2016,6,48,17,65,5227
501120,2016,8,289,31,320,18685
501190,2016,6,85,26,111,4561
501220,2019,5,27,19,46,3625
501300,2017,9,6905,310,7215,183856
501320,2017,6,351,142,493,54477
501440,2016,5,11,5,16,1465
501530,2017,7,16,1,17,754
501590,2017,8,650,144,794,51526
501740,2016,5,21,16,37,1156
501790,2018,8,78,3,81,2397
501860,2016,5,36,20,56,1284
501930,2016,6,53,14,67,138841
501940,2016,5,24,12,36,1793
501950,2017,6,44,13,57,2382
502100,2016,5,22,16,38,3844
502140,2016,5,94,88,182,286567
502150,2016,7,21,3,24,15018
502200,2016,5,7,6,13,11002
502210,2016,7,36,8,44,1839
502280,2017,6,807,206,1013,43245
502300,2016,5,27,19,46,2491
502320,2016,6,36,11,47,2704
502380,2016,6,26,7,33,5312
502400,2016,6,128,49,177,8523
502410,2016,4,7,20,27,2505
502420,2016,4,12,26,38,3055
502430,2016,4,3,7,10,1026
502440,2016,4,4,7,11,1413
502450,2016,3,2,15,17,1942
502520,2017,8,2027,290,2317,141901
502540,2017,7,9,2,11,194
502600,2016,7,9,2,11,350
502650,2016,6,22,6,28,1345
502700,2017,7,18,1,19,3884
502720,2018,6,16,6,22,458
502740,2017,8,192,24,216,9716
502770,2016,6,325,105,430,30281
502800,2017,9,2128,84,2212,85874
502810,2016,5,11,8,19,294
502820,2017,6,530,169,699,39977
502880,2016,4,22,64,86,3302
502940,2016,8,427,65,492,29097
503140,2016,6,15,4,19,1016
503180,2020,8,56,4,60,1940
503210,2016,8,69,17,86,3318
503300,2016,8,2485,605,3090,192077
503340,2016,8,95,4,99,6042
503350,2017,8,1370,295,1665,98759
503400,2017,8,169,6,175,5250
503450,2016,5,28,25,53,3442
503460,2016,8,119,7,126,4510
503480,2016,5,70,34,104,14304
503550,2017,7,32,8,40,1781
503560,2017,8,2696,540,3236,218328
503580,2017,8,339,54,393,29723
503620,2017,6,168,68,236,10237
503680,2016,5,6,4,10,196
503770,2022,8,208,24,232,17568
503860,2016,7,30,2,32,674
503940,2018,8,1988,401,2389,94770
503950,2016,7,33,7,40,6753
503960,2016,6,26,7,33,3046
503980,2016,7,8,2,10,938
504000,2016,8,65,3,68,11813
504010,2016,5,22,12,34,968
504050,2019,5,627,276,903,50888
504090,2017,7,23,1,24,461
504130,2016,8,419,70,489,35530
504210,2016,9,1293,36,1329,112807
504230,2018,9,2258,50,2308,93498
504280,2016,5,14,7,21,848
504310,2016,6,72,25,97,45239
504380,2016,7,30,3,33,2776
504390,2016,8,177,9,186,4597
504400,2016,8,144,22,166,19116
504420,2016,6,19,5,24,954
504430,2018,7,18,4,22,316
504450,2017,5,6,8,14,887
504460,2017,8,61,15,76,9739
504470,2016,5,6,8,14,207
504560,2018,7,22,3,25,1072
504810,2016,5,22,14,36,2975
504850,2016,7,10,2,12,550
504880,2016,6,30,11,41,27652
504920,2018,8,50,2,52,1761
505070,2016,7,22,2,24,1609
505080,2017,5,21,10,31,1118
505090,2017,5,27,12,39,2041
505120,2017,5,7,5,12,1098
505170,2016,6,1060,314,1374,71855
505210,2016,6,172,55,227,84744
505330,2018,8,57,13,70,2292
505550,2016,5,6,6,12,314
505630,2017,8,203,29,232,11848
505640,2017,8,267,42,309,26392
505730,2017,5,322,153,475,94447
505750,2016,5,368,200,568,147206
506090,2017,7,12,2,14,614
506150,2017,7,23,1,24,700
506260,2017,6,27,7,34,3391
506470,2016,7,9,2,11,789
506500,2017,6,389,151,540,86233
506510,2017,8,109,4,113,3344
506590,2016,5,49,26,75,7310
506730,2017,5,182,164,346,26894
506760,2016,4,9,16,25,2667
506830,2016,6,13,4,17,3347
506840,2016,5,11,5,16,3100
506870,2017,8,378,15,393,14636
506900,2017,8,197,44,241,16078
507010,2016,6,1379,464,1843,153734
507030,2016,5,10,5,15,3022
507050,2016,6,40,17,57,2729
507060,2016,7,16,1,17,281
507120,2017,7,35,6,41,5635
507490,2016,6,1186,329,1515,163931
508170,2016,6,265,68,333,48609
508180,2016,6,103,44,147,81306
508190,2018,8,1429,350,1779,94069
508200,2017,6,7,3,10,1522
508230,2016,5,34,16,50,7145
508300,2017,5,76,40,116,16951
508390,2016,6,536,175,711,110091
508520,2017,5,9,6,15,1157
508530,2017,6,90,38,128,51844
508710,2021,6,19,8,27,939
508730,2016,6,11,3,14,473
508740,2016,5,48,25,73,3361
508760,2016,6,24,9,33,98740
508790,2016,8,213,23,236,27902
508820,2016,5,24,13,37,10442
508840,2016,6,17,7,24,4915
508900,2018,8,288,17,305,15041
508940,2017,7,11,2,13,236
508980,2017,8,482,53,535,20050
508990,2016,8,103,6,109,6344
509110,2016,8,258,55,313,248909
509160,2016,7,23,1,24,264
509170,2016,5,7,7,14,1014
509190,2016,5,30,27,57,5402
509210,2016,5,29,13,42,3047
509220,2016,8,1160,130,1290,99497
509250,2017,8,333,26,359,19434
509260,2017,4,10,17,27,494
509290,2016,6,24,9,33,851
509420,2016,5,219,101,320,74643
509570,2018,8,176,16,192,14359
509600,2016,6,88,25,113,33118
509620,2017,7,8,2,10,9020
509800,2017,5,142,98,240,24464
509820,2016,7,9,1,10,207
509880,2017,5,55,33,88,2050
509960,2016,5,20,21,41,12328
510040,2016,7,23,1,24,991
510240,2017,7,34,5,39,1770
510290,2016,7,29,6,35,1861
510360,2017,6,14,6,20,635
510510,2017,5,712,485,1197,64883
510520,2017,8,69,6,75,1109
510570,2016,5,29,18,47,1932
510620,2016,8,173,30,203,14481
510650,2016,6,73,19,92,14848
510680,2018,8,92,2,94,1155
510740,2018,7,19,4,23,746
510840,2017,5,21,12,33,8432
510850,2017,5,36,18,54,2708
511010,2016,5,18,11,29,1224
511070,2016,5,6,8,14,1038
511090,2016,8,171,26,197,6029
511140,2016,8,119,11,130,6360
511160,2016,6,79,27,106,36571
511190,2016,5,19,13,32,903
511250,2017,7,12,2,14,958
511330,2016,5,9,9,18,41280
511350,2016,8,126,6,132,7327
511380,2016,7,19,1,20,3069
511430,2020,5,40,21,61,4006
511460,2016,6,10,4,14,307
511470,2016,9,1262,24,1286,35594
511490,2016,5,20,9,29,35342
511500,2016,7,29,6,35,841
511630,2016,8,63,12,75,5341
511680,2017,8,2180,146,2326,79474
511700,2016,7,11,1,12,276
511740,2016,8,1001,170,1171,70444
511750,2016,6,40,14,54,9934
511820,2016,7,13,2,15,4206
512000,2018,7,20,1,21,300
512020,2017,5,57,26,83,75863
512170,2016,5,47,26,73,1319
512180,2017,8,237,4,241,7175
512230,2016,8,130,12,142,5271
512240,2016,7,37,2,39,1984
512250,2016,8,2122,184,2306,231286
512260,2016,7,23,2,25,1282
512300,2016,8,320,62,382,43652
512550,2016,6,17,7,24,29018
512560,2016,5,38,37,75,7453
512740,2016,8,49,2,51,26529
512770,2016,5,18,8,26,32528
512790,2016,8,781,54,835,32402
512900,2019,9,4163,208,4371,371171
513210,2016,6,33,12,45,4354
513230,2016,8,963,164,1127,16075
513250,2019,7,27,1,28,1009
513300,2017,7,17,1,18,659
513320,2016,5,56,64,120,5416
513330,2017,5,85,61,146,10410
513340,2016,8,48,2,50,19018
513370,2016,5,44,46,90,5201
513440,2016,5,73,65,138,51360
513450,2016,8,889,103,992,246280
513460,2016,5,19,25,44,1561
513480,2017,8,61,8,69,3203
513510,2016,8,1216,171,1387,111346
513550,2017,5,37,20,57,99
513580,2016,5,16,7,23,5934
513590,2016,4,30,65,95,170384
513620,2016,5,71,59,130,167127
513780,2016,6,863,252,1115,534698
513820,2016,6,25,7,32,26799
513880,2016,5,37,16,53,32403
513890,2017,8,141,12,153,4930
513980,2016,6,33,9,42,19979
513990,2016,5,29,16,45,1278
514090,2016,8,79,12,91,5849
514240,2016,5,50,58,108,7594
514290,2017,5,43,44,87,9941
514310,2016,8,362,22,384,20860
514340,2017,8,47,5,52,4025
514570,2016,5,5,7,12,325
514580,2017,8,158,21,179,16817
514620,2017,8,158,5,163,20693
514640,2016,7,10,2,12,339
514650,2016,7,35,5,40,6089
514660,2016,5,104,45,149,187505
514670,2016,5,37,23,60,3329
514780,2016,5,7,7,14,786
514810,2017,7,20,5,25,3320
514890,2016,8,56,7,63,5082
514900,2017,8,1473,277,1750,66078
514990,2017,5,50,28,78,6921
515040,2016,8,1317,175,1492,87399
515180,2018,6,800,297,1097,49413
515220,2017,8,2698,548,3246,386242
515230,2017,5,16,9,25,9651
515260,2017,6,126,37,163,5961
515470,2016,5,105,130,235,258593
515570,2016,8,132,10,142,10932
515650,2016,8,86,5,91,7441
515690,2016,5,51,61,112,242938
515740,2016,7,12,3,15,305
515910,2016,5,77,34,111,99536
515980,2017,5,22,27,49,3547
516010,2016,7,14,1,15,13717
516040,2016,5,11,7,18,799
516120,2016,7,9,1,10,212
516130,2018,6,44,18,62,1805
516410,2017,6,20,7,27,18387
516480,2017,8,175,2,177,4819
516580,2017,7,35,3,38,621
516600,2017,8,233,7,240,3118
516750,2016,8,9472,894,10366,416575
516790,2017,7,13,1,14,764
516840,2016,7,44,4,48,3600
516890,2016,7,18,3,21,1007
516920,2016,5,6,4,10,3308
516940,2016,7,18,3,21,2347
517110,2017,6,11,3,14,3203
517140,2016,6,12,5,17,525
517230,2016,7,13,1,14,518
517330,2016,8,47,7,54,4883
517350,2016,8,51,9,60,6434
517360,2016,6,57,17,74,13566
517370,2016,8,111,27,138,11141
517460,2017,5,19,10,29,2897
517470,2016,7,19,2,21,5498
517620,2016,7,8,2,10,407
517680,2016,6,18,7,25,1730
517710,2016,8,1989,280,2269,141173
517720,2017,6,102,34,136,9461
517780,2017,8,58,10,68,3574
517910,2016,8,611,41,652,20739
517930,2016,7,18,1,19,821
517970,2016,7,16,1,17,335
518060,2017,6,97,33,130,9345
518120,2016,6,98,32,130,8538
518130,2017,7,20,5,25,779
518320,2016,6,19,8,27,1904
518620,2016,4,50,106,156,35115
518650,2016,7,22,2,24,4033
518660,2016,5,286,231,517,95736
518670,2016,8,137,19,156,8993
518720,2017,8,154,37,191,6829
518730,2016,8,171,18,189,11656
518790,2017,8,11458,2821,14279,815169
518920,2016,5,71,37,108,19264
519020,2016,5,8,6,14,695
519080,2018,8,195,21,216,4793
519190,2018,5,3990,2079,6069,260661
519990,2016,3,2,10,12,4584
520150,2016,7,18,3,21,1929
520290,2016,5,18,8,26,1619
520380,2017,5,20,19,39,2362
520440,2016,8,1688,106,1794,124487
520470,2016,6,36,15,51,2406
520530,2016,5,658,283,941,59797
520600,2017,8,90,6,96,4205
520610,2016,7,31,6,37,3378
520670,2018,8,53,11,64,7011
520720,2017,6,467,163,630,42951
520750,2017,7,17,1,18,867
520850,2016,8,128,8,136,3600
520910,2016,8,62,3,65,5909
520930,2016,7,14,1,15,333
520940,2018,5,169,109,278,7168
521100,2017,5,23,17,40,6824
521130,2016,8,57,4,61,31939
521200,2016,9,628,30,658,87341
521280,2016,7,20,4,24,3347
521340,2016,5,855,405,1260,152034
521350,2017,8,116,28,144,29584
521540,2016,7,20,3,23,1038
521580,2016,6,46,14,60,3697
521590,2017,5,15,10,25,4948
521630,2016,8,229,45,274,62350
521790,2017,6,49,15,64,2524
521890,2017,5,853,450,1303,85382
521920,2017,8,196,25,221,20068
522010,2016,7,30,4,34,29107
522020,2017,8,94,22,116,6747
522030,2016,5,67,35,102,5023
522080,2017,5,7,4,11,1100
522090,2016,4,45,84,129,63906
522130,2017,7,18,2,20,556
522200,2016,4,10,21,31,450
522210,2017,8,183,29,212,13449
522220,2017,7,15,3,18,2580
522230,2017,5,108,53,161,48585
522250,2017,5,22,10,32,2745
522340,2016,7,27,1,28,952
522470,2017,8,428,42,470,13755
522490,2016,8,77,2,79,7575
522570,2016,4,211,372,583,359502
522740,2017,7,9,1,10,1089
522880,2017,7,30,2,32,3630
522990,2016,7,16,2,18,2674
523000,2016,8,415,35,450,32094
523070,2021,5,7,4,11,1705
523090,2016,7,43,6,49,2690
523150,2016,7,22,4,26,42629
523160,2016,6,68,22,90,38716
523210,2017,8,786,88,874,24350
523610,2017,5,17,10,27,938
523650,2018,6,368,128,496,14474
523680,2016,6,25,7,32,3745
523730,2016,5,37,16,53,10277
523740,2017,6,41,12,53,2356
523760,2016,7,22,5,27,1136
523780,2017,8,2417,156,2573,118976
523810,2016,6,43,14,57,2134
523870,2017,7,24,1,25,2506
523960,2018,7,26,6,32,1844
524200,2017,5,9,5,14,1076
524220,2017,8,29155,6972,36127,1175123
524540,2016,7,26,4,30,3680
524560,2016,7,28,2,30,2686
524580,2017,8,1304,234,1538,93595
524640,2017,8,408,60,468,21769
524660,2016,6,127,35,162,8765
524850,2016,8,291,36,327,23364
524970,2016,5,230,292,522,114929
525040,2017,8,195,15,210,17013
525070,2017,7,12,2,14,10485
525150,2017,7,43,5,48,34498
525190,2016,5,17,22,39,26637
525240,2018,5,52,28,80,4122
525300,2016,5,20,16,36,58355
525350,2016,5,10,11,21,1567
525360,2017,6,786,224,1010,18666
525370,2016,6,35,10,45,2142
525380,2017,5,98,45,143,4657
525450,2016,7,30,3,33,2233
525480,2017,8,822,92,914,38872
525500,2016,7,27,6,33,2108
525510,2018,8,501,37,538,24984
525610,2016,5,82,58,140,5203
525620,2018,8,109,17,126,10011
525680,2022,8,114,11,125,6340
525690,2017,7,34,1,35,1781
525740,2016,7,18,1,19,928
525920,2017,5,178,97,275,50124
526130,2020,7,22,1,23,652
526140,2017,8,194,25,219,7844
526160,2019,6,2268,792,3060,217654
526290,2018,6,31,9,40,50010
526400,2017,6,39,11,50,3742
526430,2016,5,46,22,68,6288
526490,2016,8,88,3,91,12326
526510,2016,7,21,3,24,296
526540,2016,5,129,68,197,36651
526590,2016,5,13,9,22,861
526740,2017,5,1077,694,1771,267561
526800,2016,7,41,3,44,1644
526920,2017,8,94,19,113,24288
526980,2016,5,14,14,28,2650
527150,2018,7,33,3,36,1012
527210,2016,6,14,6,20,626
527230,2018,8,2839,525,3364,285696
527240,2017,5,22,19,41,1560
527270,2017,8,931,117,1048,45345
527280,2017,6,308,132,440,21899
527290,2017,8,347,73,420,18077
527380,2017,7,21,3,24,4357
527420,2016,8,55,9,64,11551
527430,2018,5,2526,1165,3691,135595
527470,2016,8,47,8,55,3596
527720,2017,7,26,1,27,1523
527730,2016,5,11,13,24,1477
527740,2016,7,36,5,41,1891
527760,2016,5,108,95,203,198381
527770,2016,5,79,87,166,208002
527790,2016,5,17,15,32,82123
527820,2016,7,19,1,20,2147
527990,2016,6,85,33,118,34210
528070,2016,6,19,7,26,40452
528110,2016,7,17,4,21,2559
528120,2016,5,9,4,13,1747
528160,2017,6,179,62,241,9687
528180,2017,5,7,7,14,1529
528250,2016,7,24,5,29,1899
528260,2017,8,54,9,63,4386
528270,2016,7,28,3,31,381
528300,2016,6,125,38,163,23878
528430,2017,6,51,15,66,22585
528450,2017,5,8,5,13,2524
528460,2018,6,193,72,265,10267
528510,2016,5,157,76,233,285208
528610,2017,5,301,166,467,11058
528660,2016,6,226,60,286,81872
528720,2016,8,98,20,118,12430
528730,2016,5,31,19,50,1432
528740,2016,5,98,145,243,57027
528770,2016,7,13,1,14,2979
528820,2016,5,64,47,111,16145
528950,2016,7,12,1,13,2939
528990,2016,7,11,1,12,548
529130,2016,5,40,20,60,4371
529150,2016,8,316,7,323,30050
529160,2016,8,209,22,231,16958
529180,2017,5,3871,3343,7214,295606
529240,2017,5,102,120,222,142178
529280,2016,5,9,9,18,322
529360,2017,6,27,7,34,878
529410,2016,7,30,5,35,1413
529420,2016,5,7,5,12,3717
529440,2017,8,280,25,305,6810
529480,2016,6,37,13,50,11010
529490,2017,5,49,23,72,3017
529500,2016,5,23,12,35,3323
529520,2017,8,281,14,295,9280
529580,2016,7,9,2,11,995
529590,2016,8,120,15,135,18767
529660,2017,8,364,36,400,19474
529760,2017,4,76,170,246,78779
529780,2016,8,1092,79,1171,83420
529840,2017,6,484,189,673,210057
529870,2017,7,29,5,34,2998
529900,2016,8,95,15,110,14407
529910,2018,5,100,87,187,4748
529920,2017,5,11,5,16,35902
529950,2016,8,153,22,175,14308
530020,2017,6,150,40,190,25624
530040,2016,5,102,79,181,6358
530070,2017,5,1192,601,1793,82176
530370,2017,7,21,1,22,486
530390,2016,9,503,16,519,38453
530510,2017,7,33,4,37,849
530540,2016,5,32,25,57,84360
530560,2017,5,230,260,490,12026
530630,2018,5,193,114,307,9535
530740,2016,6,12,4,16,4163
530820,2017,5,5,5,10,199
530830,2018,7,8,2,10,779
530890,2016,8,2026,358,2384,131975
530930,2018,6,26,9,35,978
530950,2017,6,215,71,286,17991
530960,2016,5,72,36,108,4862
531110,2016,7,15,3,18,1403
531180,2018,7,31,2,33,780
531240,2016,5,14,12,26,26807
531270,2017,6,218,88,306,9824
531480,2016,7,14,2,16,344
531510,2018,8,463,9,472,13743
531530,2018,8,84,11,95,2504
531540,2016,6,32,10,42,2791
531640,2018,6,2499,648,3147,324938
531680,2016,8,182,39,221,28037
531730,2016,8,97,4,101,5805
531740,2016,6,45,14,59,4163
531780,2017,6,11,4,15,340
531890,2016,6,73,26,99,5635
531910,2016,7,28,3,31,2149
531930,2016,6,205,52,257,16140
531960,2016,6,629,183,812,119133
531990,2016,7,33,1,34,7172
532030,2016,5,41,37,78,48988
532110,2016,9,1512,71,1583,103841
532120,2017,7,14,1,15,290
532170,2017,7,32,3,35,1797
532190,2017,8,278,26,304,12257
532270,2016,8,84,10,94,4861
532290,2016,8,81,17,98,7400
532320,2017,8,64,3,67,3385
532660,2016,5,14,13,27,4625
532690,2017,6,10,4,14,2600
532700,2016,5,9,5,14,3296
532840,2017,8,738,172,910,83808
532920,2017,5,13,6,19,6622
533010,2016,6,47,17,64,2927
533120,2018,8,1289,272,1561,82088
533180,2016,4,11,31,42,37782
533260,2016,6,14,6,20,583
533300,2016,8,4876,306,5182,179370
533320,2016,5,15,13,28,4826
533330,2016,5,39,32,71,21422
533480,2017,6,101,35,136,9218
533540,2018,5,768,402,1170,127757
533580,2017,7,36,3,39,792
533690,2016,6,160,64,224,44119
533820,2016,6,64,24,88,277061
533860,2016,4,34,52,86,121128
533890,2016,5,13,6,19,4392
533950,2016,8,117,18,135,5222
534190,2017,7,42,7,49,3313
534200,2016,6,12,4,16,4364
534220,2017,5,247,127,374,74192
534230,2016,8,68,15,83,2425
534290,2016,8,237,41,278,38531
534320,2016,5,6,6,12,1361
534370,2018,5,412,198,610,33127
534440,2016,7,19,4,23,877
534570,2016,5,25,14,39,6227
534680,2017,7,10,1,11,916
534780,2017,8,105,8,113,676
534910,2016,5,19,10,29,781
535000,2016,7,23,1,24,1076
535170,2017,5,17,15,32,9025
535380,2016,7,10,1,11,882
535410,2017,7,27,4,31,857
535440,2016,4,6,16,22,1655
535480,2017,6,670,174,844,42547
535490,2017,5,103,68,171,9528
535520,2017,6,282,78,360,45489
535630,2016,7,27,6,33,1202
535690,2017,6,79,20,99,23122
535700,2016,5,23,10,33,3248
535750,2016,6,7,3,10,1287
535850,2017,4,86,276,362,21629
535890,2016,7,13,3,16,1603
535910,2016,7,19,1,20,1105
535980,2016,7,31,2,33,1442
536040,2016,5,44,20,64,3636
536220,2016,6,5776,1809,7585,278042
536320,2016,5,16,23,39,6025
536410,2017,5,27,14,41,165351
536430,2016,7,22,5,27,2578
536450,2017,6,33,10,43,3964
536490,2016,7,18,4,22,2504
536530,2016,5,10,7,17,596
536560,2017,8,46,6,52,5094
536630,2016,5,14,14,28,709
536640,2016,5,31,36,67,3034
536660,2017,5,41,36,77,3063
536690,2018,7,11,1,12,172
536750,2016,7,32,8,40,3474
536780,2016,8,57,8,65,8174
536930,2017,5,2116,924,3040,777318
536990,2016,8,59,12,71,3541
537000,2017,6,39,13,52,1896
537200,2016,5,22,16,38,8323
537430,2017,5,110,128,238,5391
537520,2018,5,62,45,107,2490
537740,2017,5,23,14,37,829
537800,2017,8,2739,318,3057,180315
537990,2016,5,300,168,468,12390
538060,2016,5,45,38,83,25642
538070,2017,8,259,16,275,14588
538100,2019,8,1113,129,1242,96206
538550,2016,7,17,4,21,1528
538590,2016,4,68,123,191,243018
538680,2017,9,1551,59,1610,47881
538710,2016,7,31,1,32,1574
538790,2016,5,7,10,17,625
538840,2017,8,72,16,88,7768
538920,2016,5,11,13,24,2944
538950,2016,7,31,6,37,13654
538990,2019,5,26,17,43,2132
539270,2017,7,26,5,31,1928
539300,2017,5,6,9,15,535
539340,2017,8,59,5,64,1967
539370,2016,7,24,5,29,2479
539380,2016,6,52,16,68,8493
539400,2018,8,81,4,85,4191
539450,2017,5,128,55,183,194515
539460,2016,7,19,3,22,121776
539640,2016,5,130,99,229,51259
539670,2016,8,178,23,201,36606
539720,2016,8,361,47,408,51888
539750,2016,6,47,16,63,23261
540020,2016,5,46,59,105,256959
540060,2016,8,42,10,52,2495
540100,2016,5,98,51,149,14562
540150,2016,5,6,4,10,501
540550,2016,5,8,8,16,411
540610,2016,8,962,144,1106,63983
540640,2016,6,13,5,18,72237
540660,2016,7,13,3,16,1456
540690,2017,5,23,15,38,1270
540840,2016,8,828,87,915,72299
540880,2016,8,83,6,89,2608
540900,2017,5,80,92,172,274316
541160,2016,7,10,2,12,310
541200,2017,8,47,4,51,1082
541230,2017,8,285,45,330,20946
541240,2017,7,21,2,23,2438
541300,2017,5,578,535,1113,36279
541370,2016,4,93,217,310,171048
541380,2016,4,15,24,39,9221
541450,2017,5,42,20,62,8136
541570,2016,9,726,30,756,28751
541720,2016,5,18,13,31,2816
542030,2017,7,32,1,33,1063
542050,2018,8,118,5,123,5198
542200,2017,8,96,5,101,8343
542260,2016,8,303,16,319,19072
542290,2017,7,38,1,39,1472
542340,2016,5,528,560,1088,201881
542350,2016,8,106,22,128,17386
542400,2017,8,96,24,120,13120
542550,2016,5,31,15,46,32377
542570,2017,7,16,3,19,2152
542660,2017,8,73,12,85,4840
542680,2016,5,7,7,14,733
542930,2016,4,6,10,16,37799
543010,2017,5,120,66,186,2881
543070,2017,7,20,1,21,373
543140,2016,8,405,92,497,35780
543180,2017,5,70,47,117,3488
543240,2017,8,187,35,222,6777
543260,2017,8,738,70,808,34857
543360,2016,5,49,37,86,56898
543390,2017,6,112,34,146,7572
543410,2017,6,10,3,13,462
543430,2016,5,14,8,22,2584
543440,2018,7,17,1,18,352
543460,2017,5,1024,1186,2210,149189
543650,2016,5,19,16,35,132308
543710,2016,6,11,3,14,489
543870,2017,8,181,38,219,26981
543900,2018,5,1847,1014,2861,69416
543930,2017,8,212,16,228,4409
543980,2016,8,65,7,72,3607
544180,2016,8,166,1,167,35266
544190,2016,7,38,8,46,6984
544310,2017,8,50,2,52,31928
544330,2017,8,642,146,788,92489
544530,2016,7,38,3,41,4165
544550,2017,8,878,172,1050,45840
544580,2017,7,35,6,41,1993
544600,2016,8,68,9,77,4937
544610,2017,6,475,121,596,45122
544630,2017,4,20,32,52,2201
544650,2016,7,17,4,21,1987
544680,2017,4,15,23,38,818
544710,2016,7,19,2,21,2506
544730,2017,5,322,470,792,137191
544790,2018,6,29,8,37,710
544800,2016,5,7,10,17,1019
544840,2016,6,37,14,51,10601
544870,2016,5,17,16,33,4671
544970,2017,8,180,6,186,2860
545030,2016,7,46,2,48,6237
545050,2016,5,128,83,211,4485
545060,2017,7,17,2,19,1653
545180,2018,8,59,8,67,2207
545200,2017,5,11,8,19,1357
545270,2017,6,769,314,1083,77159
545330,2016,5,13,19,32,1408
545410,2017,5,60,27,87,34499
545430,2017,8,58,5,63,1886
545540,2017,8,159,31,190,10798
545570,2016,5,19,14,33,3518
545580,2016,6,97,41,138,51051
545650,2017,5,377,460,837,146758
545670,2017,7,32,1,33,2596
545690,2016,8,383,22,405,20149
545700,2017,4,22,44,66,244539
545820,2016,5,75,66,141,10929
545830,2017,7,21,5,26,1517
545860,2016,5,46,29,75,39410
545890,2017,6,9,3,12,313
545960,2016,8,60,6,66,5638
545980,2017,8,166,6,172,6413
546030,2016,5,5,6,11,239
546050,2018,8,622,153,775,47388
546070,2017,8,49,12,61,21214
546080,2016,8,248,16,264,8169
546090,2016,8,87,7,94,3513
546170,2016,7,14,2,16,8728
546180,2016,5,10,5,15,599
546200,2016,7,16,1,17,41969
546220,2017,8,99,17,116,3266
546330,2016,7,9,1,10,534
546350,2017,6,56,24,80,5838
546410,2017,7,37,6,43,4796
546490,2016,5,27,31,58,12445
546550,2016,8,56,7,63,2634
546660,2016,5,28,36,64,105386
546700,2016,5,77,49,126,170502
546780,2016,7,20,3,23,924
546790,2016,5,8,4,12,320
546900,2018,5,27,19,46,1764
546930,2017,5,156,137,293,21498
547010,2016,5,57,45,102,15681
547090,2016,5,11,5,16,29531
547260,2016,6,43,11,54,4592
547310,2016,5,46,30,76,21057
547340,2016,8,144,22,166,17905
547360,2018,6,274,97,371,15908
547410,2016,5,449,257,706,21760
547540,2016,8,48,6,54,5943
547590,2016,8,135,27,162,7127
547680,2017,6,894,379,1273,346627
547730,2016,6,10,3,13,472
547820,2017,5,37,24,61,8754
547900,2016,8,96,23,119,5864
547960,2016,5,244,227,471,337145
547970,2017,5,12,7,19,589
547980,2016,7,32,1,33,663
547990,2016,5,6,4,10,982
548050,2016,7,11,2,13,674
548080,2016,6,16,6,22,34392
548130,2017,7,17,1,18,2558
548230,2016,8,51,7,58,6681
548280,2018,6,10,3,13,1358
548330,2016,7,44,1,45,3098
548340,2016,8,204,12,216,7617
548350,2017,3,1,9,10,197
548370,2017,5,105,119,224,6721
548450,2018,7,14,2,16,586
548500,2017,7,27,6,33,1158
548650,2017,6,25,8,33,1212
548680,2017,7,36,6,42,5475
548710,2016,5,6,7,13,73852
548720,2017,7,10,1,11,355
548840,2017,8,100,8,108,5557
548860,2016,6,21,6,27,691
549100,2017,6,38,10,48,4521
549190,2017,7,16,1,17,518
549240,2017,5,46,20,66,13770
549260,2017,8,218,32,250,9501
549400,2016,7,13,3,16,767
549670,2016,4,7,11,18,985
549740,2016,8,47,4,51,1494
549770,2016,4,13,34,47,2074
549860,2016,8,324,31,355,21217
549950,2017,5,11,5,16,269
550010,2016,8,664,134,798,147158
550080,2017,8,618,78,696,28801
550240,2016,5,15,8,23,474
550310,2016,8,218,23,241,9227
550340,2017,8,81,15,96,4748
550360,2017,5,30,13,43,1591
550400,2017,7,21,1,22,1999
550440,2017,5,5,6,11,1431
550450,2016,5,12,7,19,1548
550580,2017,8,62,14,76,42922
550590,2017,8,103,4,107,3783
550650,2019,6,20242,6951,27193,5223468
550810,2016,8,52,3,55,4141
550840,2021,8,777,117,894,25427
550990,2017,7,37,2,39,825
551050,2017,6,27,10,37,6869
551110,2016,8,441,49,490,47511
551170,2018,5,316,182,498,62165
551190,2016,8,53,9,62,1887
551320,2016,5,9,4,13,278
551450,2017,8,141,25,166,4900
551520,2016,7,31,6,37,12104
551550,2018,4,26,54,80,152900
551580,2016,7,44,5,49,1148
551630,2017,5,11,7,18,1423
551650,2017,6,11,4,15,234
551700,2018,8,161,39,200,7574
551720,2016,6,22,9,31,2013
551730,2017,8,712,169,881,44585
551770,2017,8,437,83,520,18320
552030,2017,6,91,29,120,3388
552060,2016,7,40,3,43,3071
552110,2018,6,255,70,325,41861
552130,2016,4,40,66,106,7268
552160,2016,8,59,6,65,8019
552230,2016,6,9,3,12,506
552300,2016,7,8,2,10,673
552370,2017,7,14,1,15,252
552390,2017,7,23,3,26,4655
552410,2016,5,31,17,48,8095
552440,2017,8,232,19,251,26129
552450,2017,8,294,60,354,30378
552460,2017,8,76,11,87,9757
552500,2018,6,13543,4365,17908,1252257
552580,2016,5,10,5,15,2624
552590,2017,8,1549,97,1646,92659
552610,2016,7,11,2,13,381
552620,2018,8,281,43,324,12292
552700,2017,8,699,157,856,51651
552720,2016,6,7,3,10,1446
552780,2016,6,26,9,35,122688
552900,2017,7,21,3,24,20244
552910,2017,4,7,16,23,917
552920,2018,6,222,73,295,17933
552970,2017,8,120,20,140,8385
552990,2017,6,5075,1801,6876,1015572
553000,2016,4,7,14,21,2678
553210,2017,5,422,189,611,41196
553260,2017,5,343,212,555,33291
553340,2017,8,104,15,119,23019
553450,2016,5,19,13,32,3613
553470,2017,6,12,5,17,544
553590,2016,8,57,3,60,9521
553610,2016,6,12,5,17,556
553640,2016,8,14985,1299,16284,437615
553690,2017,6,8,3,11,429
553760,2017,7,44,1,45,937
553780,2016,7,12,1,13,5347
553790,2016,8,510,84,594,84282
553800,2016,5,23,13,36,2441
553820,2016,6,17,7,24,34743
553950,2017,7,42,3,45,973
553960,2017,5,176,258,434,30047
554150,2017,7,35,3,38,1884
554220,2017,7,40,8,48,2369
554280,2018,7,24,3,27,505
554310,2016,6,183,72,255,20329
554330,2017,7,21,3,24,3651
554510,2017,5,241,154,395,21405
554600,2017,8,130,10,140,12968
554620,2017,8,16040,1084,17124,467572
554640,2016,6,279,89,368,63972
554680,2016,5,9,4,13,608
554750,2017,5,93,46,139,3690
554770,2017,4,4,12,16,4686
554800,2016,8,53,12,65,7953
554810,2017,7,30,5,35,1559
554870,2017,7,13,1,14,625
555010,2017,5,37,16,53,1669
555050,2017,8,106,15,121,5545
555060,2016,8,66,9,75,8544
555150,2017,8,637,157,794,28735
555210,2016,8,2456,285,2741,164544
555220,2017,8,5805,339,6144,244747
555260,2017,5,38,32,70,164114
555280,2017,5,19,17,36,4822
555290,2016,7,35,6,41,2037
555310,2018,7,22,3,25,1364
555320,2016,8,57,6,63,4725
555400,2017,8,110,23,133,4651
555450,2017,5,72,108,180,20556
555510,2018,5,189,105,294,15800
555570,2016,5,11579,12174,23753,3888922
555600,2017,7,21,1,22,427
555610,2016,8,63,12,75,6977
555640,2016,6,124,34,158,18127
555710,2016,6,98,29,127,18858
555720,2016,7,29,6,35,1281
555730,2016,6,11,3,14,300
555750,2016,5,188,102,290,15081
555830,2017,5,8,8,16,23818
555850,2016,5,13,6,19,31359
555880,2018,8,760,54,814,43163
555890,2017,5,15,7,22,4977
555950,2017,8,634,35,669,32270
556160,2016,5,57,76,133,149079
556190,2016,7,16,2,18,678
556250,2017,7,13,3,16,4282
556280,2016,6,121,45,166,82514
556340,2017,8,92,18,110,8829
556480,2017,5,16,18,34,867
556710,2016,7,12,3,15,267
556740,2018,6,106,27,133,3101
556780,2017,5,33,15,48,1368
556820,2017,6,490,172,662,23348
556840,2017,5,13,19,32,508
556870,2016,5,107,57,164,70634
556890,2016,7,29,5,34,775
557040,2016,8,242,34,276,10553
557400,2017,8,1220,154,1374,141990
557580,2019,6,55,20,75,8049
557600,2017,9,2939,80,3019,81431
557680,2016,5,87,64,151,267647
557700,2016,6,7,3,10,1196
557770,2016,6,13,5,18,2472
557790,2016,7,13,1,14,49822
557810,2016,5,267,229,496,131966
557830,2017,7,16,2,18,44359
557860,2016,7,10,1,11,213
557880,2017,5,81,53,134,6011
557890,2016,8,75,9,84,6131
557960,2017,4,4,8,12,544
558110,2017,6,82,23,105,6717
558260,2018,6,151,47,198,4443
558320,2017,7,19,3,22,2731
558340,2017,5,31,26,57,7104
558410,2016,7,13,2,15,1575
558420,2017,8,1636,197,1833,62348
558450,2017,8,113,15,128,4776
558490,2017,7,25,5,30,3547
558750,2018,7,9,1,10,671
558780,2017,6,10,4,14,2378
558790,2017,8,46,5,51,6955
558850,2016,5,14,8,22,868
558870,2016,4,23,44,67,3428
558990,2017,9,1170,22,1192,90685
559030,2018,7,15,1,16,317
559130,2017,6,25,10,35,2342
559210,2017,9,1406,38,1444,44680
559310,2017,5,55,35,90,6159
559340,2018,5,98,84,182,4694
559450,2016,6,7,3,10,3958
559610,2017,9,616,27,643,19978
559650,2020,8,1427,134,1561,161055
559870,2017,6,64,22,86,7092
559900,2016,5,75,34,109,993
559910,2017,6,144,58,202,10227
559960,2017,8,71,4,75,4454
560000,2017,8,132,5,137,8177
560010,2016,5,6,4,10,156
560050,2016,8,51,6,57,5009
560130,2018,8,2523,487,3010,203867
560220,2016,7,25,3,28,5559
560250,2017,5,42,21,63,6260
560260,2016,8,1833,186,2019,202966
560510,2017,7,12,2,14,313
560710,2016,5,13,8,21,14947
560720,2017,8,66,3,69,7601
560730,2017,5,23,26,49,5793
560740,2017,6,31,9,40,5929
560750,2017,7,37,9,46,6045
560760,2017,5,22,18,40,5560
560770,2016,6,7,3,10,447
560820,2017,5,20,12,32,5558
561000,2016,7,18,1,19,2545
561010,2017,7,8,2,10,181
561190,2016,7,29,3,32,1309
561230,2016,6,14,4,18,1104
561340,2016,8,97,16,113,31024
561420,2017,5,8,9,17,2827
561450,2017,6,18,6,24,2220
561510,2017,7,13,1,14,403
561590,2017,5,18,11,29,5865
561600,2017,6,248,64,312,20607
561610,2017,5,156,79,235,17029
561740,2017,8,140,24,164,6431
561770,2017,6,146,43,189,6461
562050,2016,6,41,12,53,4164
562090,2017,5,8,7,15,542
562220,2016,9,3835,187,4022,152851
562230,2018,8,190,19,209,8694
562250,2017,7,32,5,37,1366
562260,2017,7,28,4,32,5217
562280,2017,7,17,1,18,614
562290,2017,5,9,5,14,4655
562310,2017,7,9,1,10,301
562320,2016,7,29,5,34,2447
562330,2017,7,32,6,38,32267
562340,2017,5,32,37,69,2359
562360,2016,8,324,40,364,48265
562410,2017,8,537,47,584,24566
562430,2018,5,49,31,80,187222
562480,2017,8,50,2,52,4157
562490,2017,8,65,12,77,31660
562500,2018,8,884,88,972,16131
562520,2016,5,31,35,66,124879
562570,2016,8,105,26,131,6691
562590,2017,5,980,494,1474,362859
562660,2016,7,29,5,34,9676
562690,2016,4,6,16,22,3830
562730,2020,5,8,10,18,57016
563120,2017,5,56,49,105,267723
563130,2016,6,14,4,18,539
563150,2017,7,29,5,34,19248
563190,2017,7,23,4,27,1055
563250,2017,7,9,2,11,3206
563410,2021,7,10,1,11,225
563520,2017,7,16,4,20,15816
563550,2017,7,37,4,41,1457
563560,2017,8,6180,400,6580,1788990
563750,2016,5,44,27,71,4172
563810,2017,7,30,1,31,595
563860,2017,6,8,3,11,187
564010,2016,4,57,115,172,9877
564050,2018,8,475,22,497,24052
564070,2017,4,5,9,14,363
564150,2017,8,133,26,159,7580
564160,2017,7,40,1,41,1789
564210,2017,7,10,2,12,38302
564230,2017,8,884,82,966,48027
564470,2017,7,21,5,26,917
564710,2017,8,2918,197,3115,497334
564750,2017,6,19,6,25,8798
564940,2017,7,23,1,24,795
564950,2017,5,11,16,27,662
565110,2016,7,13,1,14,25646
565120,2018,8,145,34,179,3057
565380,2016,6,27,9,36,14694
565390,2017,8,57,3,60,2633
565660,2017,5,20,9,29,6765
565720,2016,8,182,34,216,15981
565980,2017,5,10,5,15,1007
566160,2017,8,743,48,791,45977
566190,2017,5,21,13,34,1463
566350,2017,6,7,3,10,476
566410,2017,4,3,9,12,960
566430,2017,6,18,5,23,39439
566530,2017,8,125,22,147,12177
566550,2016,5,14,16,30,1281
566670,2017,8,78,5,83,48105
566750,2017,7,15,2,17,263
566780,2017,7,37,8,45,1955
566870,2016,7,12,2,14,1078
566880,2017,7,19,2,21,3664
567030,2017,8,136,6,142,3050
567040,2016,4,12,22,34,6617
567060,2017,6,93,25,118,23372
567140,2018,7,10,1,11,50306
567200,2017,7,17,4,21,2720
567210,2016,7,38,5,43,37493
567260,2017,4,16,58,74,2711
567280,2016,8,430,50,480,78780
567290,2016,8,712,67,779,116068
567320,2017,5,42,33,75,2470
567370,2017,8,58,2,60,3878
567480,2017,5,11,6,17,292
567580,2016,8,186,46,232,65299
567640,2017,8,2129,366,2495,73449
567670,2017,8,179,13,192,17842
567680,2017,5,63,60,123,88028
567780,2017,6,18,6,24,5080
567800,2016,8,80,9,89,8734
567890,2017,7,12,1,13,1550
568030,2016,7,15,1,16,911
568090,2016,8,1012,122,1134,70929
568130,2017,6,10,3,13,39742
568180,2017,7,11,1,12,102
568320,2017,8,216,14,230,13506
568340,2016,5,34,23,57,1344
568370,2016,7,25,2,27,605
568440,2017,8,98,22,120,7798
568470,2017,6,12,5,17,15960
568500,2016,7,12,2,14,1370
568570,2016,6,1343,479,1822,139115
568610,2016,7,23,2,25,2169
568750,2017,6,113,40,153,11327
568770,2017,9,1563,52,1615,90875
568780,2017,6,15,6,21,29850
568860,2016,6,14,5,19,26230
568920,2017,7,19,1,20,191
569210,2017,5,6,5,11,61332
569290,2017,7,37,9,46,790
569340,2017,6,51,15,66,1081
569380,2016,7,10,1,11,1393
569420,2017,7,11,1,12,408
569430,2017,5,21,10,31,509
569480,2017,8,4597,811,5408,563737
569570,2017,7,38,4,42,2895
569610,2016,6,105,36,141,62738
569630,2017,6,43,11,54,3252
569720,2018,8,56,4,60,15982
569770,2017,6,132,43,175,6213
569800,2017,6,48,13,61,4126
569810,2017,7,28,2,30,2662
569860,2017,8,1680,100,1780,98491
569970,2017,5,61,50,111,11393
570050,2017,5,52,35,87,2997
570350,2016,5,18,9,27,3826
570420,2017,5,87,50,137,10109
570460,2018,8,870,137,1007,72566
570490,2016,7,38,2,40,1433
570710,2018,4,22,74,96,1967
570770,2017,6,425,112,537,32019
570780,2017,6,645,212,857,36800
570790,2017,4,7,12,19,1190
570840,2017,8,1829,119,1948,113411
570890,2016,5,13,12,25,5156
570910,2016,3,2,13,15,2440
570940,2018,5,5162,2702,7864,348944
570970,2017,5,60,27,87,2374
570980,2017,8,373,32,405,7725
571260,2017,8,981,211,1192,61260
571310,2017,9,1051,39,1090,64596
571340,2017,5,23,17,40,2654
571350,2017,8,259,59,318,37573
571520,2016,5,9,4,13,2874
571530,2017,8,503,28,531,24628
571720,2017,5,47,23,70,5527
571740,2017,6,1746,466,2212,537751
571880,2017,9,630,12,642,10988
572000,2016,6,44,15,59,12018
572020,2017,7,25,1,26,969
572240,2017,7,13,2,15,1797
572300,2017,6,42,15,57,2483
572410,2017,6,2673,937,3610,220307
572520,2017,6,493,204,697,173823
572580,2017,5,6,6,12,322
572660,2017,6,34,10,44,17932
573060,2017,8,98,23,121,4167
573070,2017,7,16,3,19,922
573080,2017,8,61,14,75,1550
573120,2018,8,233,50,283,17655
573130,2017,8,194,29,223,12818
573170,2017,8,203,4,207,9485
573210,2016,5,18,13,31,22443
573260,2017,4,3,7,10,1599
573370,2018,7,15,2,17,488
573490,2019,8,141,20,161,10577
573520,2017,7,36,2,38,803
573600,2017,5,39,20,59,6858
573660,2017,5,17,20,37,1175
573680,2017,4,30,69,99,4604
573770,2017,8,189,8,197,13769
573780,2017,6,58,22,80,5335
573800,2017,6,28,9,37,3177
574030,2016,5,57,39,96,64459
574050,2017,6,350,147,497,39238
574070,2017,5,92,57,149,20864
574200,2018,7,28,6,34,1479
574260,2017,6,37,11,48,6170
574270,2017,7,38,7,45,6127
574310,2017,8,310,19,329,9891
574440,2017,5,32,17,49,16118
574560,2018,6,114,32,146,8334
574580,2016,6,35,13,48,47859
574640,2017,6,91,39,130,261546
574860,2017,5,8,11,19,934
574940,2017,8,61,9,70,3384
575010,2016,6,65,21,86,6449
575050,2017,8,385,23,408,12604
575330,2017,8,122,16,138,29344
575340,2018,6,11,4,15,597
575400,2017,8,54,11,65,2898
575450,2017,7,12,1,13,318
575480,2017,8,62,3,65,1376
575510,2017,6,203,81,284,59076
575550,2017,8,2284,222,2506,161623
575570,2017,6,76,31,107,72689
575580,2017,6,35,9,44,6324
575590,2017,7,29,1,30,1872
575630,2017,5,17,14,31,89681
575640,2017,8,2857,423,3280,148929
575650,2017,8,110,11,121,4081
575670,2017,7,16,3,19,3042
575700,2017,5,86,70,156,80271
575720,2017,5,597,358,955,60107
575820,2018,8,60,4,64,938
575830,2017,5,67,44,111,34272
575840,2017,5,47,32,79,190798
575850,2019,5,14,8,22,1060
575860,2017,5,42,63,105,220222
575880,2017,7,19,4,23,4074
575890,2017,7,9,2,11,46680
575940,2017,8,52,6,58,2846
575950,2017,5,128,72,200,14192
575960,2017,5,32,16,48,1876
575970,2018,8,58,6,64,2628
575990,2017,7,12,1,13,274
576030,2017,8,151,17,168,8041
576050,2017,5,22,22,44,51164
576130,2017,8,109,20,129,223530
576260,2017,6,74,30,104,7991
576280,2017,7,28,3,31,2016
576310,2017,5,88,82,170,65704
576370,2017,7,10,2,12,549
576380,2017,5,11,6,17,7007
576390,2019,4,5,10,15,38464
576400,2017,6,56,19,75,4676
576420,2017,7,33,1,34,666
576470,2017,6,342,104,446,161925
576540,2017,5,36,19,55,115251
576620,2017,7,34,4,38,2487
576660,2017,4,9,14,23,74874
576670,2018,7,8,2,10,2009
576770,2017,8,792,58,850,35746
576810,2017,8,76,18,94,6091
576860,2017,5,150,146,296,32178
576980,2017,6,69,20,89,10318
577180,2017,8,72,18,90,1958
577210,2017,6,18,7,25,1942
577230,2021,6,784,228,1012,33293
577290,2017,7,43,4,47,1871
577460,2017,5,97,82,179,14576
577480,2017,8,97,4,101,10764
577490,2017,7,21,1,22,2291
577580,2017,7,14,2,16,2066
577670,2018,6,101,43,144,12602
577690,2017,8,224,21,245,12669
577730,2017,6,66,20,86,8408
577740,2017,5,60,31,91,22702
577760,2017,7,14,1,15,51544
577910,2017,7,29,3,32,861
577940,2017,8,990,124,1114,73990
578080,2017,5,394617,372037,766654,36604134
578080,2017,5,394617,372037,766654,36604134
578210,2020,8,167,13,180,4683
578310,2017,8,5914,1476,7390,860262
578330,2017,6,581,228,809,57413
578470,2017,6,16,6,22,4481
578590,2017,5,10,6,16,615
578690,2020,7,12,1,13,325
578720,2017,5,158,99,257,3769
578830,2017,6,25,10,35,3530
578850,2017,8,634,63,697,25163
578870,2017,7,12,2,14,729
578900,2017,8,136,2,138,3182
578920,2017,5,12,8,20,600
578930,2017,8,74,2,76,2172
579020,2017,5,236,108,344,20279
579110,2017,8,82,7,89,4386
579130,2018,5,9,7,16,579
579180,2018,5,464,298,762,8874
579210,2017,5,4,6,10,264
579230,2017,8,79,9,88,105070
579820,2017,5,59,49,108,5896
579840,2019,6,47,15,62,4750
579950,2017,8,1143,172,1315,69783
580040,2017,6,238,85,323,21064
580170,2018,5,325,143,468,22124
580200,2017,8,1284,285,1569,89457
580320,2017,5,8,4,12,422
580420,2017,6,39,14,53,36997
580520,2017,6,15,6,21,390
580560,2017,5,15,18,33,4831
580570,2017,5,9,6,15,561
580590,2017,7,38,1,39,4639
580680,2017,5,6,6,12,2450
580710,2017,6,121,33,154,9653
580720,2017,8,220,39,259,15890
580820,2019,6,26,7,33,2227
580890,2017,5,38,18,56,1943
580950,2017,4,5,8,13,320
581030,2017,4,74,118,192,166434
581060,2017,5,53,24,77,2674
581100,2017,5,21,26,47,74134
581130,2017,6,610,182,792,60536
581220,2017,5,40,48,88,4268
581300,2017,5,90,83,173,5889
581310,2017,5,28,18,46,992
581370,2017,5,50,27,77,10260
581380,2017,5,10,9,19,33336
581520,2017,6,86,33,119,29679
581600,2017,5,10,13,23,44339
581650,2017,8,64,16,80,5964
581670,2017,5,27,24,51,221047
581760,2017,8,116,12,128,7599
581970,2017,6,44,18,62,14417
581980,2017,4,10,22,32,37242
582160,2017,8,24697,4063,28760,1030581
582270,2017,8,1271,236,1507,103451
582290,2020,5,6,8,14,23427
582330,2022,8,224,36,260,13332
582370,2017,7,11,2,13,346
582500,2017,8,6664,521,7185,810432
582550,2017,6,1325,343,1668,205391
582560,2017,8,118,4,122,3018
582610,2017,5,6,6,12,179
582620,2017,8,107,25,132,10191
582660,2017,5,7048,3356,10404,1413060
582890,2020,8,243,55,298,16033
582980,2017,7,21,3,24,1911
582990,2017,6,38,11,49,1673
583040,2017,8,94,22,116,10846
583090,2017,7,25,1,26,1029
583150,2017,6,22,9,31,1576
583270,2017,8,60,3,63,3664
583470,2017,8,1138,77,1215,62739
583490,2017,6,94,29,123,35873
583590,2017,5,29,13,42,1778
583760,2017,8,637,39,676,77971
583890,2017,8,75,7,82,1771
583930,2017,8,77,12,89,13560
584100,2017,6,17,6,23,18237
584150,2018,5,8,4,12,277
584220,2017,8,67,15,82,7602
584370,2017,8,90,21,111,6588
584400,2017,8,6322,666,6988,168633
584800,2017,6,35,14,49,20734
584890,2018,6,147,44,191,19272
584940,2017,5,13,9,22,848
584980,2017,8,2938,310,3248,114798
584990,2018,8,47,6,53,1086
585080,2017,5,60,78,138,8244
585180,2017,8,141,3,144,7382
585290,2017,5,68,30,98,2972
585550,2017,8,745,158,903,203548
585690,2017,5,163,75,238,54622
585830,2017,5,47,52,99,20784
585840,2017,8,403,100,503,11072
585880,2017,8,86,9,95,6022
585890,2017,8,241,13,254,5216
585900,2017,6,303,94,397,13567
585910,2017,8,104,9,113,6369
585950,2017,8,123,8,131,12729
585970,2017,5,15,7,22,28904
585990,2017,7,28,7,35,1845
586030,2017,6,719,218,937,156784
586060,2017,5,28,17,45,3579
586140,2017,8,1535,183,1718,98966
586150,2017,4,3,8,11,2304
586160,2017,4,3,7,10,24119
586170,2018,6,21,6,27,23312
586200,2018,5,305,190,495,19108
586240,2017,8,116,11,127,2830
586310,2017,8,80,17,97,4069
586320,2017,7,15,1,16,590
586340,2017,7,29,2,31,1914
586350,2017,8,97,4,101,8382
586380,2017,6,256,100,356,187583
586390,2017,8,47,3,50,788
586450,2017,7,11,1,12,640
586600,2017,4,4,14,18,15330
586660,2017,7,38,2,40,911
586750,2017,5,109,71,180,5353
586770,2017,6,9,3,12,332
586830,2017,6,14,5,19,1451
586880,2017,8,237,5,242,14552
586950,2018,8,110,11,121,9794
586960,2017,8,280,37,317,60440
586970,2017,6,91,27,118,47096
587000,2017,8,403,53,456,22912
587100,2017,8,172,14,186,11563
587180,2018,7,44,5,49,930
587260,2017,8,226,20,246,10220
587290,2017,5,28,16,44,2523
587390,2018,5,6,9,15,27185
587400,2017,7,24,5,29,1055
587420,2017,6,231,84,315,15666
587430,2017,8,411,29,440,40604
587450,2017,5,445,207,652,31561
587460,2017,5,55,41,96,15365
587490,2017,5,13,13,26,655
587570,2017,6,37,15,52,4246
587810,2017,4,18,41,59,56426
587860,2017,6,190,61,251,56023
588040,2017,9,2665,120,2785,56625
588080,2017,7,18,3,21,564
588110,2017,6,63,25,88,3641
588120,2022,5,42,22,64,1189
588160,2018,5,192,283,475,24569
588180,2017,8,169,25,194,68317
588190,2017,5,118,87,205,12837
588240,2017,8,134,21,155,92533
588340,2017,5,20,16,36,880
588430,2017,8,16096,2741,18837,3371793
588540,2017,6,11,4,15,608
588560,2018,7,35,5,40,5399
588620,2017,7,22,3,25,1634
588650,2018,9,15661,669,16330,834231
588690,2017,8,751,48,799,44119
588710,2017,8,46,4,50,25384
588730,2017,8,228,8,236,7371
588750,2017,5,10,11,21,1140
588880,2017,7,11,1,12,4224
588890,2017,6,32,13,45,2334
588920,2017,5,14,12,26,2747
588950,2017,8,541,62,603,53976
588970,2017,8,916,113,1029,36745
589060,2017,7,13,1,14,358
589150,2017,6,16,6,22,1186
589220,2018,5,26,17,43,2706
589250,2020,7,29,5,34,1715
589320,2017,5,136,118,254,19874
589360,2018,8,1685,294,1979,124778
589380,2017,7,8,2,10,844
589420,2017,8,127,15,142,52412
589430,2017,4,4,16,20,41351
589460,2017,6,71,22,93,26167
589470,2017,7,19,3,22,1969
589480,2017,7,28,1,29,538
589510,2017,8,73,8,81,6780
589530,2017,8,166,27,193,8472
589590,2017,8,1656,98,1754,152040
589640,2017,6,25,8,33,2862
589670,2020,8,90,20,110,3013
589690,2017,6,23,8,31,5434
589730,2017,5,16,9,25,4877
589740,2017,5,18,23,41,1198
589780,2018,8,1068,83,1151,32942
589860,2017,7,41,1,42,1913
589870,2017,8,1410,203,1613,496965
590270,2017,6,15,4,19,431
590370,2017,6,9,3,12,547
590590,2018,8,199,6,205,4161
590690,2018,8,346,32,378,16043
590970,2017,5,73,85,158,3580
591000,2018,8,57,3,60,1405
591350,2017,6,19,5,24,844
591370,2019,8,537,93,630,53365
591420,2017,8,1451,207,1658,86040
591560,2017,8,52,9,61,221001
591630,2018,8,388,12,400,13214
591680,2018,8,53,1,54,6251
591740,2017,5,515,762,1277,351470
591750,2018,7,44,5,49,1204
591960,2017,5,842,395,1237,193034
591990,2017,5,9,5,14,223
592030,2017,6,63,16,79,9215
592120,2017,7,8,2,10,419
592130,2017,6,10,3,13,543
592200,2017,7,12,3,15,30291
592240,2017,7,14,2,16,619
592300,2017,8,50,2,52,1673
592340,2017,5,47,32,79,2045
592390,2017,5,64,44,108,3264
592550,2017,5,15,11,26,1176
592620,2017,7,8,2,10,349
592660,2017,5,8,4,12,1035
592730,2017,5,32,14,46,19319
592750,2017,7,21,1,22,791
592780,2017,5,7,8,15,4052
593070,2017,7,8,2,10,2057
593280,2017,9,1788,71,1859,73199
593330,2017,5,62,33,95,7550
593410,2017,6,13,4,17,1271
593490,2017,6,90,32,122,8760
593600,2019,5,1949,1143,3092,256179
593670,2017,7,21,2,23,34169
593680,2017,7,27,1,28,3261
593700,2017,7,34,5,39,984
593850,2017,7,36,8,44,1064
594130,2019,7,24,1,25,545
594300,2017,8,42,9,51,8571
594310,2017,5,13,6,19,2994
594320,2018,7,26,1,27,1117
594360,2017,7,8,2,10,335
594370,2017,6,36,10,46,4259
594490,2017,8,154,26,180,43126
594570,2017,8,11698,1225,12923,955731
594660,2017,6,33,9,42,2797
594680,2017,8,118,12,130,2520
594750,2017,7,40,3,43,907
595010,2018,6,9,3,12,683
595030,2017,4,4,10,14,200
595090,2017,6,52,21,73,3096
595110,2018,8,49,12,61,1607
595120,2017,6,88,23,111,3771
595140,2017,8,781,51,832,44541
595260,2018,6,29,8,37,608
595420,2017,5,80,36,116,8997
595430,2017,8,195,9,204,5012
595440,2017,8,295,59,354,145377
595460,2017,8,131,22,153,79368
595520,2018,8,1211,186,1397,110374
595550,2017,5,48,26,74,5438
595660,2017,5,17,8,25,1499
595730,2018,8,48,5,53,3081
595740,2017,6,132,47,179,5050
595770,2018,8,67,15,82,5796
595780,2017,5,5,5,10,125192
595920,2017,5,18,11,29,990
595960,2017,7,29,6,35,1137
596080,2017,7,19,2,21,270
596240,2018,5,31,25,56,587
596540,2017,5,12,9,21,1802
596590,2017,8,64,5,69,123339
596630,2017,7,27,3,30,1457
596650,2017,5,441,216,657,125288
596740,2018,5,13,6,19,608
596890,2017,7,15,2,17,1658
596910,2017,7,36,3,39,2139
596950,2017,5,33,15,48,4044
597030,2018,8,67,8,75,1826
597150,2017,8,403,42,445,18994
597170,2021,9,1177,40,1217,84077
597200,2017,6,14,4,18,527
597220,2017,9,2171,49,2220,162678
597230,2018,8,130,2,132,5113
597240,2017,5,14,14,28,629
597590,2017,7,19,1,20,564
597700,2017,8,164,10,174,6584
597840,2017,6,125,47,172,26040
597860,2017,7,16,2,18,348
597920,2017,4,8,14,22,765
598060,2020,8,128,14,142,5727
598070,2017,8,137,13,150,22237
598330,2020,6,1079,296,1375,105710
598350,2017,7,25,4,29,513
598440,2017,6,148,55,203,7448
598480,2017,6,51,16,67,4122
598490,2018,8,67,4,71,4355
598610,2017,6,11,3,14,450
598670,2017,7,18,1,19,675
598690,2017,6,83,34,117,2958
598700,2018,8,991,91,1082,42487
598820,2017,5,40,32,72,13642
598840,2017,7,9,1,10,4200
598880,2018,7,34,1,35,375
598940,2017,6,37,12,49,12398
598960,2018,8,799,115,914,39069
599010,2018,4,20,44,64,7068
599060,2017,5,15,19,34,11991
599460,2017,8,751,169,920,71843
599510,2017,7,8,2,10,1853
599560,2017,6,44,17,61,5176
599630,2017,5,9,4,13,1962
599750,2017,8,485,97,582,45176
599880,2017,5,15,13,28,8514
599960,2017,6,122,38,160,3741
600210,2017,5,22,12,34,140831
600280,2017,6,32,13,45,4878
600310,2017,6,19,5,24,42250
600370,2017,8,456,8,464,13467
600410,2017,6,17,5,22,2831
600460,2018,8,81,17,98,3172
600630,2017,5,58,30,88,10808
600740,2017,5,7,6,13,10416
600750,2017,5,195,196,391,72588
601010,2017,6,108,38,146,70809
601020,2017,5,7,7,14,563
601240,2017,5,11,6,17,4934
601380,2018,4,31,54,85,1437
601430,2017,8,6688,553,7241,227653
601500,2017,5,11,6,17,535
601510,2017,8,4939,1221,6160,1461356
601530,2017,8,222,23,245,16715
601570,2017,7,18,4,22,5092
601640,2017,5,29,26,55,92281
601770,2017,8,161,25,186,8582
601790,2017,7,20,4,24,2631
601810,2017,8,217,20,237,4836
601870,2017,5,9,7,16,3237
601920,2017,7,9,1,10,305
601930,2017,7,20,4,24,23821
602070,2017,7,34,1,35,1161
602120,2017,7,46,1,47,4126
602480,2018,7,35,4,39,1665
602520,2017,9,6265,154,6419,220127
602590,2017,6,23,9,32,718
602890,2017,5,351,157,508,175952
602930,2017,5,27,19,46,23958
603020,2018,6,68,25,93,3121
603060,2017,7,11,1,12,39375
603090,2017,6,7,3,10,30707
603100,2017,8,75,16,91,5352
603120,2017,5,20,26,46,2543
603130,2017,5,55,27,82,5231
603140,2017,8,123,20,143,14432
603150,2017,4,16,25,41,87818
603220,2017,7,12,1,13,61829
603250,2017,5,10,10,20,8266
603260,2017,8,395,45,440,22860
603330,2018,8,47,4,51,1577
603350,2017,8,100,22,122,10311
603360,2017,5,33,32,65,56349
603400,2018,6,30,12,42,1482
603420,2017,7,19,2,21,1013
603530,2017,8,213,18,231,6894
603550,2017,3,1,9,10,535
603750,2017,4,40,69,109,122213
603800,2017,6,70,26,96,10868
603810,2017,8,46,5,51,1514
603840,2017,6,11,3,14,316
603870,2017,7,14,1,15,340
603940,2017,8,94,22,116,9778
603960,2017,8,354,3,357,10880
604000,2017,7,41,6,47,2919
604010,2017,7,19,3,22,2376
604170,2017,7,28,5,33,2034
604240,2019,8,320,45,365,19017
604450,2017,8,3589,346,3935,60338
604490,2017,5,615,301,916,22151
604740,2017,6,87,33,120,3345
604780,2017,6,152,53,205,101408
604950,2017,5,9,10,19,2029
604980,2017,7,16,2,18,472
605210,2017,7,12,2,14,18238
605250,2017,7,16,1,17,371
605310,2017,5,28,16,44,1081
605610,2017,8,437,47,484,43349
605990,2017,8,131,5,136,9897
606000,2018,7,38,6,44,1373
606150,2018,6,1261,407,1668,99719
606190,2017,7,16,2,18,750
606330,2017,6,94,25,119,227633
606370,2017,5,58,42,100,3940
606480,2017,8,121,2,123,4818
606510,2017,8,85,8,93,4750
606690,2017,7,38,4,42,10986
606710,2017,8,108,6,114,4498
606730,2017,5,102,48,150,34563
606800,2020,6,1119,310,1429,127687
606860,2017,5,95,48,143,4944
606890,2018,8,79,7,86,3392
606950,2017,5,15,10,25,1616
607040,2017,7,10,2,12,1623
607210,2017,5,10,8,18,336
607400,2017,8,94,7,101,2019
607660,2017,6,28,10,38,2797
607760,2017,7,12,1,13,315
607880,2017,8,424,87,511,23646
607890,2017,8,1995,418,2413,114714
608530,2017,5,81,54,135,1994
608540,2017,5,6,4,10,34379
608660,2017,7,41,2,43,25642
608760,2017,7,36,6,42,21557
608800,2017,6,388,113,501,197414
608990,2017,5,122,117,239,31410
609150,2017,6,390,148,538,42781
609170,2017,5,25,11,36,1436
609320,2018,8,1483,115,1598,39420
609410,2017,7,43,5,48,1498
609490,2018,8,319,23,342,21152
609720,2018,7,10,2,12,182
609760,2017,7,20,2,22,1817
609940,2017,6,427,171,598,96484
610080,2017,8,1588,339,1927,486185
610130,2017,8,84,21,105,149881
610180,2017,8,170,32,202,124954
610310,2017,8,91,11,102,3275
610350,2017,5,12,9,21,827
610360,2017,8,986,81,1067,67435
610380,2017,5,76,46,122,10705
610500,2017,6,143,41,184,6559
610610,2017,7,15,3,18,737
610660,2018,5,8,7,15,736
610670,2017,5,34,43,77,153968
610680,2017,6,50,15,65,2664
610750,2017,6,106,43,149,41646
610810,2017,5,243,136,379,96091
610840,2017,7,44,1,45,3530
610960,2017,8,569,76,645,24175
611040,2018,5,88,45,133,6689
611060,2018,7,41,6,47,1020
611140,2017,5,11,10,21,14925
611160,2020,8,155,8,163,7352
611320,2017,7,27,1,28,4380
611500,2022,5,8546,3790,12336,1146284
611620,2018,6,62,17,79,1138
611630,2017,7,21,3,24,366
611660,2017,6,2248,949,3197,133476
611670,2018,8,1692,239,1931,99326
611750,2017,5,50,41,91,2993
611770,2020,7,28,5,33,6891
611790,2022,8,1585,302,1887,209324
611800,2017,5,148,91,239,7871
611850,2017,7,21,3,24,697
611960,2018,7,36,1,37,32770
611980,2017,8,678,56,734,30552
612020,2017,8,816,114,930,168990
612100,2017,8,71,5,76,4039
612110,2017,8,191,34,225,15063
612170,2017,8,70,12,82,2997
612250,2017,4,5,9,14,49524
612310,2017,7,16,1,17,706
612370,2017,8,138,8,146,5116
612390,2018,8,95,12,107,3309
612470,2018,8,487,53,540,52272
612510,2017,6,33,13,46,45443
612590,2017,7,30,3,33,9543
612610,2017,4,31,57,88,20678
612620,2017,6,115,31,146,17912
612670,2017,7,33,8,41,1059
612720,2017,6,188,49,237,15787
612740,2017,8,65,10,75,2328
612810,2017,5,8,10,18,764
612820,2018,5,35,17,52,1749
612880,2017,6,8845,3403,12248,549457
612930,2019,8,520,88,608,28865
613010,2017,5,52,25,77,45681
613020,2017,7,10,1,11,374
613100,2018,6,2747,746,3493,351645
613130,2017,7,25,1,26,3064
613190,2018,8,143,14,157,4371
613210,2017,7,31,2,33,2127
613270,2017,5,94,84,178,6664
613390,2017,8,97,6,103,3435
613450,2017,8,84,8,92,2174
613470,2017,8,79,7,86,3481
613670,2017,8,143,34,177,3160
613730,2017,6,527,176,703,46193
613790,2017,5,13,6,19,2272
613830,2018,5,426,220,646,19214
613860,2017,6,15,6,21,432
614030,2017,6,86,25,111,21488
614140,2017,5,11,7,18,356
614570,2017,8,2134,396,2530,167394
614630,2018,6,154,39,193,12406
614660,2018,7,18,3,21,23758
614860,2017,6,115,40,155,7635
614890,2017,6,27,9,36,1646
614900,2017,5,19,15,34,4113
614910,2017,8,270,39,309,16640
614950,2018,8,73,5,78,5206
614960,2017,7,38,3,41,2109
614970,2017,5,24,11,35,2151
615010,2017,8,68,6,74,2220
615090,2017,7,37,7,44,8219
615180,2017,8,47,9,56,2835
615340,2017,5,32,35,67,8367
615350,2017,7,36,8,44,3009
615400,2018,4,28,43,71,16569
615490,2017,6,9,3,12,2374
615610,2017,9,1473,28,1501,103156
615670,2017,7,35,6,41,2081
615970,2017,5,60,42,102,5393
616000,2017,8,80,4,84,2318
616030,2017,7,22,1,23,45927
616240,2017,5,47,36,83,8106
616250,2018,8,419,12,431,7433
616740,2017,8,207,21,228,3069
616880,2017,7,18,1,19,3583
617030,2017,5,79,60,139,7571
617060,2017,7,9,2,11,289
617160,2017,8,786,133,919,35043
617420,2017,5,23,16,39,33367
617440,2017,8,131,5,136,4520
617480,2018,8,444,41,485,22559
617610,2017,7,45,4,49,2987
617630,2017,5,16,8,24,554
617680,2018,6,11,4,15,1611
617700,2017,8,216,39,255,16792
617710,2017,5,41,34,75,35152
617820,2017,7,37,2,39,773
617830,2017,8,1306,158,1464,158697
618050,2017,5,41,48,89,5926
618080,2018,8,344,70,414,54678
618140,2018,5,21,12,33,3054
618270,2018,6,16,6,22,714
618310,2017,8,53,12,65,7646
618360,2017,7,19,4,23,2299
618370,2017,7,23,1,24,645
618470,2017,7,16,1,17,600
618490,2017,5,11,11,22,3855
618510,2017,8,197,14,211,15556
618550,2018,7,35,1,36,738
618610,2017,6,64,27,91,21739
618630,2017,6,9,3,12,225
618640,2017,7,14,3,17,503
618690,2017,7,39,3,42,2073
618720,2017,8,168,6,174,11663
618950,2017,8,84,3,87,2383
618970,2017,8,224,28,252,10737
619080,2018,4,1515,2692,4207,248224
619280,2017,8,153,20,173,10062
619290,2018,8,226,29,255,16298
619340,2017,5,24,11,35,42590
619350,2017,7,13,3,16,699
619400,2017,4,57,108,165,265237
619600,2017,6,22,9,31,5620
619780,2018,5,492,471,963,39484
619810,2017,7,25,1,26,1377
619870,2017,7,44,3,47,718
619880,2017,6,458,134,592,29556
619890,2017,7,24,2,26,50016
620170,2017,7,31,4,35,1296
620190,2018,8,121,24,145,8571
620210,2018,8,66,4,70,1761
620220,2018,8,67,9,76,1723
620590,2018,8,766,184,950,42933
620650,2018,7,39,1,40,1000
620700,2017,5,21,19,40,1204
620710,2017,7,20,3,23,2737
621010,2017,7,15,1,16,752
621020,2018,5,47,24,71,2431
621050,2017,5,11,15,26,1372
621080,2017,8,48,3,51,4745
621220,2018,6,268,71,339,16117
621780,2017,5,6,4,10,1051
621810,2017,8,79,16,95,3658
621830,2017,5,534,229,763,37674
621850,2017,7,13,1,14,554
621880,2018,5,98,134,232,48008
621930,2018,8,87,12,99,5393
621940,2018,7,33,6,39,2517
621970,2018,6,25,7,32,731
622020,2017,5,14,7,21,657
622060,2017,8,65,14,79,8359
622080,2017,4,6,15,21,2260
622170,2017,5,188,97,285,28254
622370,2017,5,92,43,135,7074
622420,2018,8,49,11,60,995
622460,2018,8,103,15,118,9308
622650,2017,8,6341,815,7156,721168
622700,2018,5,8,4,12,2471
622770,2018,6,120,37,157,9852
622870,2019,8,89,5,94,17578
622880,2017,6,21,9,30,1040
622890,2017,7,21,1,22,306
622910,2018,7,19,3,22,521
622920,2017,5,25,29,54,33008
623070,2017,6,34,12,46,2725
623080,2017,9,750,9,759,9520
623090,2017,8,78,18,96,3009
623160,2017,7,15,1,16,830
623170,2017,7,16,1,17,551
623380,2017,7,18,1,19,1827
623550,2017,5,31,25,56,52456
623640,2018,8,59,6,65,1897
623810,2017,5,46,20,66,1150
623900,2017,5,12,8,20,1129
623940,2017,8,2479,140,2619,106377
624120,2017,5,50,41,91,148748
624270,2017,8,159,20,179,5882
624320,2018,7,27,2,29,827
624430,2017,5,9,8,17,566
624680,2017,6,12,5,17,747
624710,2017,7,11,1,12,1306
624830,2017,7,26,2,28,695
624970,2018,8,181,21,202,10304
625040,2017,5,11,6,17,6069
625120,2017,7,26,4,30,3019
625320,2017,7,11,1,12,457
625370,2017,5,26,19,45,27424
625430,2017,5,282,149,431,94612
625470,2017,8,103,8,111,35120
625680,2018,7,28,2,30,614
625700,2017,6,10,3,13,714
625730,2018,7,31,2,33,820
625770,2017,7,15,2,17,1208
625830,2018,7,21,1,22,589
625910,2017,7,36,1,37,2332
625980,2017,8,136,3,139,3618
625990,2017,7,25,3,28,1809
626010,2017,6,106,43,149,49370
626160,2017,5,10,5,15,2465
626200,2017,4,20,53,73,1458
626250,2017,7,18,4,22,1318
626510,2017,6,62,16,78,12577
626580,2017,7,32,7,39,2785
626600,2017,8,46,9,55,2787
626610,2018,6,294,120,414,11868
626630,2017,5,10,6,16,1197
626690,2018,6,3668,1313,4981,183822
627070,2017,7,37,6,43,2840
627270,2017,8,2242,476,2718,121107
627450,2017,5,22,31,53,2326
627460,2017,5,8,5,13,15006
627620,2017,5,45,52,97,15307
627670,2017,7,30,1,31,2876
627690,2020,8,1855,431,2286,247248
627820,2017,5,34,15,49,3963
627910,2017,5,48,44,92,1770
628290,2018,8,112,15,127,7639
628460,2017,7,32,2,34,1037
628530,2017,5,9,4,13,5221
628660,2017,7,44,5,49,2049
628750,2017,8,239,47,286,95040
628770,2018,8,320,29,349,27467
628800,2017,8,78,2,80,2073
628890,2017,4,89,202,291,31392
628900,2017,5,42,37,79,5291
628920,2017,8,65,8,73,3569
628950,2017,6,73,31,104,3642
629000,2017,8,196,17,213,11300
629030,2017,4,22,73,95,18689
629220,2018,8,229,50,279,7985
629400,2017,5,6,4,10,178
629430,2017,7,29,1,30,383
629540,2017,7,33,5,38,4641
629650,2017,8,174,6,180,2817
629690,2017,8,261,25,286,13404
629770,2017,8,160,19,179,13382
629840,2017,6,274,70,344,5644
629860,2017,7,16,3,19,1195
629960,2017,6,139,45,184,8478
630020,2017,7,22,3,25,1427
630030,2018,8,90,16,106,4981
630050,2017,6,19,5,24,496
630060,2017,8,308,9,317,5330
630160,2017,7,16,2,18,1361
630310,2017,8,122,23,145,3767
631490,2017,7,23,2,25,468
631510,2018,8,547,105,652,45280
631540,2017,5,54,63,117,7336
631660,2017,6,52,18,70,26322
631770,2017,7,21,2,23,2360
631830,2018,6,13,4,17,1423
631900,2017,8,116,5,121,4761
631920,2017,7,16,4,20,2397
631980,2017,8,81,11,92,4656
631990,2017,6,15,4,19,518
632000,2017,8,198,36,234,15007
632020,2018,6,35,12,47,1234
632050,2017,5,8,6,14,596
632070,2017,8,286,64,350,8547
632100,2019,5,14,8,22,316
632170,2018,6,20,6,26,774
632290,2017,7,13,3,16,1731
632350,2018,8,2064,268,2332,80900
632800,2017,7,41,6,47,824
632840,2017,7,12,3,15,629
633060,2018,6,274,78,352,22373
633130,2017,5,211,135,346,37907
633360,2018,8,528,130,658,22088
633440,2017,7,15,3,18,553
633460,2017,8,1725,292,2017,77223
633580,2017,6,8,3,11,1047
633950,2017,5,101,47,148,4000
634090,2018,5,14,11,25,610
634120,2017,5,34,27,61,1468
634160,2017,8,266,8,274,16435
634180,2017,6,23,9,32,1589
634200,2017,7,23,4,27,28387
634340,2018,7,28,1,29,5143
634700,2017,5,96,69,165,2086
635200,2017,6,636,171,807,61231
635260,2017,8,1857,215,2072,92953
635310,2017,8,103,16,119,9568
635320,2017,8,1185,138,1323,60590
635410,2017,8,40,10,50,4282
635550,2017,7,36,8,44,1059
635670,2017,6,64,25,89,3222
635730,2017,8,3579,498,4077,175982
635900,2018,6,17,6,23,381
635940,2017,8,252,2,254,6547
636070,2018,7,8,2,10,235
636100,2018,8,284,33,317,10679
636150,2017,8,181,34,215,40035
636170,2017,5,23,11,34,1977
636230,2018,5,10,8,18,626
636330,2017,6,12,4,16,697
636390,2017,7,33,3,36,953
636400,2017,6,25,10,35,33664
636450,2017,8,449,42,491,24921
636570,2017,8,137,34,171,5326
637060,2017,6,32,13,45,3843
637090,2018,6,5448,1396,6844,289619
637100,2017,5,1524,784,2308,34165
637120,2018,7,12,1,13,346
637650,2018,8,7397,1666,9063,489872
637670,2018,5,729,432,1161,35434
637850,2017,8,2759,166,2925,172944
637880,2017,8,100,5,105,2971
638000,2019,8,110,6,116,14129
638070,2018,6,160,52,212,13203
638110,2017,8,224,36,260,37048
638160,2017,6,215,76,291,17271
638720,2018,5,7,4,11,871
638850,2022,6,228,67,295,12477
639130,2017,8,171,13,184,11599
639170,2017,8,839,80,919,44575
639270,2017,8,156,4,160,6452
639300,2017,5,40,19,59,3970
639450,2017,7,25,5,30,3343
639470,2017,8,66,14,80,1829
639650,2017,8,440,23,463,87854
639720,2017,8,48,9,57,2823
639770,2017,7,19,1,20,788
639780,2017,9,1045,49,1094,63624
639790,2017,9,5024,155,5179,219114
639840,2017,6,12,5,17,1195
640050,2017,5,171,145,316,4905
640150,2018,5,258,270,528,76904
640210,2018,8,47,9,56,3040
640300,2017,7,25,4,29,1222
640310,2020,4,32,60,92,2055
640380,2017,8,146,4,150,8556
640590,2017,8,126,25,151,24671
640850,2018,5,23,10,33,458
640890,2017,7,17,1,18,261
640970,2017,6,62,16,78,2277
640990,2017,8,67,6,73,2822
641910,2018,5,20,11,31,1418
641980,2017,7,42,7,49,1286
641990,2017,8,3340,830,4170,489056
642000,2017,7,21,4,25,9801
642090,2017,8,234,17,251,18348
642170,2017,7,21,3,24,1836
642520,2017,5,32,25,57,1955
642560,2017,8,270,17,287,20849
642580,2018,8,41,9,50,1210
642650,2017,7,29,1,30,655
642730,2017,7,18,1,19,536
642830,2018,6,14,4,18,10080
643270,2017,9,3506,180,3686,259813
643590,2017,5,14,10,24,1362
643610,2017,7,32,7,39,2066
643700,2017,6,23,9,32,1025
643870,2017,8,209,13,222,5258
643880,2017,8,281,11,292,12328
643900,2017,7,33,4,37,669
643960,2017,8,73,14,87,4084
643980,2018,6,120,51,171,20923
644080,2017,8,60,13,73,6430
644130,2018,4,8,28,36,344
644200,2017,8,93,20,113,3284
644290,2020,5,275,172,447,12034
644380,2017,5,7,4,11,513
644390,2017,8,159,29,188,20735
644480,2018,6,116,42,158,5859
644550,2017,8,198,20,218,4526
644560,2018,9,9352,278,9630,456954
644640,2018,5,134,96,230,15532
644760,2017,5,6,7,13,1556
644930,2019,8,8157,1302,9459,755147
645090,2017,8,1180,104,1284,68054
645260,2017,5,327,170,497,210108
645340,2017,5,20,9,29,2249
645380,2018,7,17,3,20,395
645450,2017,7,32,6,38,894
645460,2017,6,26,11,37,1531
645630,2017,6,6637,1995,8632,491057
645690,2017,8,116,9,125,3765
645820,2017,8,59,1,60,1645
645860,2017,6,7,3,10,341
645920,2017,7,38,7,45,1133
646010,2018,6,12,5,17,331
646050,2018,4,14,26,40,846
646200,2017,8,523,96,619,34702
646210,2018,7,17,1,18,261
646280,2017,7,12,1,13,1109
646380,2017,7,9,1,10,260
646470,2017,7,31,5,36,881
646500,2018,8,138,19,157,9431
646570,2019,9,13118,503,13621,1122489
646600,2017,6,64,23,87,2090
646960,2017,5,17,17,34,2641
647040,2017,7,40,6,46,1565
647050,2017,5,8,6,14,743
647280,2017,4,6,17,23,903
647830,2017,6,530,153,683,72405
647990,2017,7,14,1,15,715
648070,2017,5,14,10,24,431
648350,2018,6,5158,2022,7180,481240
648390,2018,9,2360,123,2483,124969
648430,2018,5,657,446,1103,203204
648550,2017,6,8,3,11,139
648570,2017,6,11,3,14,768
648630,2017,5,9,13,22,1085
648750,2017,7,25,6,31,2347
648780,2017,6,22,7,29,1378
648800,2022,8,5524,1208,6732,810826
648810,2017,6,15,6,21,799
649170,2017,7,26,5,31,241
649360,2017,7,19,3,22,320
649450,2018,7,27,6,33,1096
649510,2017,4,3,7,10,307
649640,2017,6,82,31,113,2895
649670,2017,5,14,10,24,739
649790,2017,6,54,21,75,4947
649810,2017,6,38,11,49,4131
649880,2017,5,19,12,31,66128
649900,2017,5,150,116,266,55135
649990,2017,7,18,2,20,423
650000,2017,5,730,476,1206,34257
650070,2017,7,46,3,49,3036
650110,2017,5,93,67,160,8280
650220,2017,8,107,16,123,32237
650350,2017,5,72,46,118,4603
650440,2017,6,147,47,194,9613
650490,2017,4,25,47,72,3607
650570,2017,8,50,1,51,1072
650680,2017,5,21,11,32,1887
650750,2017,7,40,6,46,1631
650780,2017,8,247,17,264,7494
650810,2018,5,4,6,10,326
650860,2017,5,18,11,29,501
650940,2019,8,55,3,58,2855
651340,2017,7,28,6,34,2023
651470,2017,6,69,21,90,12075
651550,2017,6,10,3,13,397
651660,2017,6,220,59,279,72923
651680,2018,7,11,2,13,221
652050,2021,7,13,1,14,10680
652190,2017,6,53,15,68,5736
652230,2017,4,8,20,28,1220
652340,2017,7,22,1,23,295
652530,2017,7,9,1,10,54
652550,2017,2,20,102,122,4368
652570,2017,7,13,1,14,1159
652980,2017,8,4570,742,5312,412731
653120,2018,5,79,113,192,18960
653190,2017,7,15,2,17,357
653210,2017,5,16,8,24,2020
653220,2017,8,147,36,183,49886
653760,2017,6,14,6,20,369
653940,2017,8,55,11,66,7456
653950,2017,8,328,17,345,4639
654020,2017,7,15,2,17,599
654050,2017,8,261,37,298,25451
654080,2017,7,11,1,12,245
654220,2018,7,36,7,43,2194
654260,2017,8,306,51,357,7527
654300,2017,5,16,16,32,3345
654440,2017,8,57,5,62,2079
654470,2018,5,40,20,60,1118
654550,2018,7,42,1,43,383
654610,2017,7,9,2,11,974
654660,2017,5,8,6,14,306
654710,2017,6,27,7,34,795
654750,2017,7,10,2,12,253
654850,2017,5,140,68,208,7125
654880,2017,8,2556,304,2860,306906
654900,2017,8,238,23,261,10235
654970,2017,4,3,8,11,9025
655000,2017,6,20,8,28,955
655020,2017,7,22,2,24,1294
655080,2017,8,73,12,85,2382
655100,2017,8,156,20,176,6427
655170,2017,5,11,12,23,956
655250,2017,5,7,10,17,393
655380,2018,7,30,1,31,937
655460,2017,5,15,22,37,1290
655610,2017,5,6,9,15,556
655660,2017,7,8,2,10,5112
655700,2017,3,3,22,25,3848
655730,2017,8,66,9,75,2733
655760,2017,5,11,5,16,406
655770,2017,8,100,3,103,3956
655790,2017,5,58,33,91,16008
655910,2017,7,37,1,38,677
655930,2017,4,8,17,25,1165
656040,2017,7,25,3,28,1092
656140,2017,5,84,71,155,3423
656200,2017,5,607,456,1063,28861
656210,2017,6,55,21,76,2894
656440,2018,5,8,4,12,247
656450,2017,6,28,12,40,946
656460,2017,5,38,17,55,2885
656510,2018,5,18,16,34,1590
656550,2017,8,68,3,71,1673
656570,2017,7,25,1,26,1378
656600,2017,6,114,34,148,5646
656610,2017,4,17,39,56,43888
656680,2017,4,11,40,51,4533
656880,2017,7,24,1,25,746
656970,2017,7,46,2,48,1571
657040,2017,6,26,8,34,4552
657050,2017,8,70,13,83,3237
657090,2019,8,55,8,63,2084
657120,2017,7,28,5,33,4312
657200,2017,6,4896,1558,6454,1199631
657260,2017,6,26,7,33,1072
657280,2017,7,40,2,42,4227
657290,2017,7,17,4,21,984
657440,2017,6,34,9,43,1710
657470,2017,5,18,15,33,2405
657590,2017,5,19,11,30,39627
657630,2017,6,226,63,289,11409
657690,2017,8,71,5,76,2178
657700,2017,6,10,4,14,11880
658060,2017,7,9,1,10,686
658160,2017,8,196,34,230,15489
658230,2017,7,12,1,13,216
658260,2017,8,258,50,308,7398
658320,2017,6,181,77,258,61133
658430,2017,5,7,4,11,971
658490,2017,5,30,15,45,1716
658530,2017,7,30,1,31,2296
658560,2017,9,545,27,572,35459
658570,2017,6,287,78,365,16740
658610,2017,4,21,50,71,2369
658630,2022,5,148,71,219,3540
658660,2017,5,15,17,32,564
658790,2017,7,41,4,45,798
658970,2018,5,42,34,76,12744
658980,2017,5,337,214,551,35163
659040,2017,7,14,1,15,125
659110,2018,8,43,7,50,1271
659130,2017,5,20,12,32,1449
659190,2017,8,249,54,303,10354
659260,2017,7,10,2,12,5550
659460,2017,4,5,9,14,93855
659480,2017,8,55,12,67,1636
659560,2017,5,8,4,12,275
659920,2018,5,31,14,45,1708
659950,2017,6,10,3,13,327
660070,2017,7,12,1,13,624
660160,2017,8,171,16,187,9727
660290,2017,7,16,4,20,682
660320,2017,5,8,4,12,697
660340,2017,5,15,18,33,2957
660990,2017,4,27,43,70,1225
661000,2017,6,98,31,129,5170
661030,2018,7,10,1,11,295
661040,2017,6,50,19,69,2856
661120,2017,7,20,4,24,7215
661280,2017,6,31,9,40,1591
661430,2017,8,109,9,118,5150
661460,2017,5,4,6,10,260
661480,2017,7,20,2,22,317
661740,2017,6,42,14,56,1671
661790,2018,8,239,25,264,6467
661830,2017,6,27,7,34,5126
661920,2018,6,96,30,126,9953
661960,2017,5,49,24,73,13533
661990,2017,8,47,8,55,5712
662190,2017,7,29,3,32,4850
662200,2017,7,20,1,21,466
662210,2017,8,87,3,90,1277
662230,2017,7,19,4,23,827
662320,2017,5,634,644,1278,304620
662470,2017,6,10,3,13,6909
662540,2017,8,53,5,58,2059
662680,2020,7,18,1,19,542
662840,2018,7,21,3,24,909
662910,2017,6,22,6,28,492
662920,2017,7,20,3,23,1039
663130,2017,7,15,3,18,700
663210,2018,7,25,1,26,1962
663240,2017,8,74,8,82,1085
663300,2018,6,234,62,296,7560
663370,2017,7,21,1,22,1397
663380,2017,6,1001,264,1265,38661
663390,2017,5,407,375,782,100170
663540,2017,6,10,4,14,361
663920,2017,5,7,5,12,337
664000,2021,8,47,7,54,1758
664090,2017,8,202,24,226,11342
664140,2017,7,10,1,11,208
664180,2017,8,485,8,493,14899
664250,2017,7,9,1,10,343
664290,2017,4,7,11,18,933
664320,2017,5,24,11,35,3661
664420,2017,5,6,6,12,315
664430,2017,5,713,753,1466,62152
664610,2017,8,63,9,72,3028
664620,2017,5,20,11,31,989
664650,2017,5,13,6,19,551
664750,2018,8,72,2,74,3063
665030,2017,7,29,6,35,836
665090,2017,6,1216,316,1532,32165
665120,2017,8,122,25,147,7040
665140,2017,5,8,4,12,459
665270,2017,8,226,7,233,3091
665490,2017,8,857,114,971,84239
665590,2017,6,9,3,12,710
665650,2017,7,8,2,10,3525
665670,2017,4,3,7,10,242
665890,2017,6,74,24,98,28789
665920,2018,7,32,4,36,4570
665960,2017,5,15,12,27,528
666050,2017,7,13,1,14,859
666100,2018,8,56,3,59,2979
666140,2019,8,4488,342,4830,249441
666220,2017,8,3404,378,3782,780433
666250,2017,5,20,10,30,1015
666260,2017,5,8,11,19,7567
666310,2018,5,16,12,28,726
666330,2017,8,53,10,63,2792
666570,2018,6,169,52,221,19521
666600,2017,7,8,2,10,89
666610,2017,7,28,3,31,2140
666820,2019,7,38,5,43,2367
666860,2017,6,355,143,498,113414
666940,2018,6,28,11,39,451
667010,2017,7,25,2,27,360
667120,2017,4,12,24,36,8755
667130,2017,6,17,6,23,1103
667160,2017,7,9,2,11,503
667220,2017,7,14,3,17,222
667360,2017,4,9,17,26,1160
667420,2017,5,19,12,31,3126
667600,2017,8,357,18,375,13770
667790,2018,7,9,2,11,152
667810,2018,6,65,21,86,2413
667870,2017,8,529,94,623,87665
667890,2018,6,1245,504,1749,324662
667920,2017,5,23,20,43,4125
668210,2017,8,302,34,336,12444
668280,2017,7,14,1,15,310
668590,2018,8,50,2,52,857
668630,2017,8,8726,812,9538,289264
668670,2017,5,8,5,13,214
668830,2017,5,24,23,47,888
669050,2017,8,130,14,144,16030
669320,2019,6,171,51,222,4549
669380,2017,7,26,3,29,460
669390,2017,7,26,4,30,408
669630,2017,6,75,19,94,4945
669660,2017,6,55,23,78,1896
669960,2017,6,10,3,13,174
670100,2017,5,11,6,17,415
670160,2017,8,353,19,372,5150
670370,2017,3,2,15,17,516
670440,2017,6,11,4,15,887
670500,2017,5,32,17,49,16143
670850,2017,7,8,2,10,209
670900,2017,5,136,92,228,9069
671090,2017,8,62,9,71,2517
671170,2017,8,59,8,67,2569
671200,2017,6,23,8,31,761
671240,2017,6,34,10,44,1999
671260,2017,6,43,18,61,3740
671270,2017,7,10,2,12,187
671390,2017,8,142,30,172,4982
671440,2019,8,360,79,439,33988
671650,2017,7,29,2,31,542
671670,2017,5,7,6,13,461
671720,2018,8,246,46,292,37131
671800,2017,6,195,54,249,22787
671810,2017,4,5,8,13,193
672020,2017,7,27,4,31,2106
672230,2017,7,24,6,30,589
672250,2017,7,9,1,10,202
672380,2017,5,4,6,10,263
672590,2018,7,44,5,49,2057
672650,2017,7,33,4,37,10586
672680,2017,5,398,413,811,143568
672730,2017,8,244,12,256,43923
672860,2017,5,46,33,79,3500
673000,2017,8,259,36,295,14217
673130,2019,8,276,2,278,4774
673190,2018,8,50,6,56,1394
673210,2021,6,47,20,67,2594
673260,2017,6,54,18,72,3191
673300,2017,8,51,3,54,1199
673480,2018,7,9,1,10,247
673600,2017,8,47,7,54,3934
673660,2017,5,38,20,58,1316
673820,2017,6,9,3,12,393
673850,2017,7,28,6,34,407
673950,2018,8,1441,157,1598,113593
673980,2017,7,24,1,25,256
674220,2017,5,13,14,27,672
674250,2017,7,20,1,21,319
674310,2017,7,31,5,36,1289
674520,2017,8,357,15,372,9613
674750,2017,8,478,116,594,83678
674850,2017,8,61,2,63,1404
674940,2017,8,15215,1442,16657,2007237
674960,2017,7,29,6,35,1552
675010,2017,8,3214,760,3974,319213
675030,2017,7,28,2,30,543
675130,2017,5,10,5,15,207
675230,2017,5,30,19,49,4652
675260,2017,8,1578,268,1846,80154
675490,2018,7,15,1,16,1059
675630,2017,5,166,149,315,44304
675720,2017,5,16,12,28,994
675730,2017,7,21,5,26,254
675940,2017,6,47,20,67,3095
675950,2017,4,3,7,10,233
675960,2017,6,9,3,12,248
675990,2017,7,10,2,12,560
676000,2017,6,23,8,31,727
676090,2018,8,81,17,98,1504
676240,2017,7,28,1,29,662
676420,2017,8,147,9,156,6268
676430,2017,8,201,23,224,10033
676440,2018,7,20,2,22,592
676450,2017,6,13,5,18,515
676480,2017,8,54,7,61,1760
676490,2017,4,8,29,37,9503
676630,2017,7,46,3,49,1569
676700,2018,7,18,3,21,632
676720,2017,5,8,10,18,858
676760,2019,5,30,17,47,1277
676770,2017,8,329,61,390,49147
676820,2017,9,721,29,750,17064
676830,2019,7,14,1,15,575
676910,2017,7,14,3,17,762
677020,2017,8,45,7,52,6234
677030,2017,7,22,4,26,306
677040,2018,6,15,6,21,303
677060,2017,7,23,4,27,1389
677120,2018,8,800,189,989,107314
677160,2018,6,726,233,959,87152
677280,2017,7,44,5,49,788
677330,2017,7,20,4,24,369
677380,2019,7,21,2,23,3543
677650,2017,6,9,3,12,554
677720,2017,7,20,4,24,633
677730,2017,7,12,3,15,2370
677820,2017,5,7,8,15,318
677870,2017,4,2,8,10,253
677880,2017,4,11,21,32,2246
677910,2017,7,19,2,21,548
678190,2017,5,45,59,104,5916
678230,2017,6,9,3,12,1354
678240,2017,5,8,5,13,615
678290,2017,7,14,3,17,356
678310,2017,7,28,1,29,725
678520,2017,8,220,13,233,14148
678560,2017,6,284,72,356,6607
678800,2017,8,1294,309,1603,337896
678820,2017,7,21,3,24,7778
678890,2018,4,10,24,34,1187
678950,2018,8,6043,1265,7308,444795
678970,2017,7,36,7,43,2975
679190,2017,6,32,11,43,1056
679430,2017,7,10,1,11,154
679470,2017,7,12,3,15,384
679530,2017,5,5,5,10,859
679660,2017,8,59,11,70,2951
679770,2017,7,17,2,19,1217
679860,2017,5,14,9,23,54287
680310,2017,5,55,70,125,28888
680330,2018,5,20,9,29,491
680340,2017,8,60,15,75,1643
680360,2018,8,344,35,379,25181
680390,2018,8,50,4,54,696
680480,2017,8,64,5,69,3623
680550,2017,6,12,4,16,67
680620,2017,7,16,3,19,463
680700,2018,7,39,1,40,1927
680860,2018,8,44,10,54,2653
680980,2017,6,182,48,230,8974
681060,2017,7,29,7,36,2607
681100,2017,6,19,6,25,724
681140,2017,5,17,23,40,2093
681160,2017,4,12,19,31,3165
681240,2017,7,40,1,41,892
681280,2019,8,396,36,432,16951
681330,2018,8,65,3,68,2945
681340,2017,7,14,2,16,269
681390,2020,8,266,23,289,15876
681460,2018,7,16,1,17,265
681480,2017,4,4,10,14,207
681500,2017,4,38,70,108,22978
681520,2017,5,16,11,27,562
681620,2017,7,22,2,24,546
681630,2017,7,8,2,10,168
681660,2018,5,2721,3491,6212,192188
681780,2017,4,9,31,40,3268
681800,2017,7,24,2,26,597
682130,2017,8,154,30,184,8557
682470,2018,7,25,1,26,596
682480,2018,8,66,11,77,1932
682500,2018,5,6,9,15,565
682570,2018,6,106,40,146,6093
682590,2017,7,13,3,16,516
682610,2017,7,21,3,24,739
682620,2018,5,11,11,22,68
682630,2018,7,12,2,14,937
682670,2018,7,20,1,21,168
682780,2017,7,21,2,23,379
682810,2017,7,23,2,25,582
682910,2017,5,29,23,52,2316
683280,2017,8,62,13,75,4684
683530,2017,5,7,8,15,730
683600,2017,4,3,8,11,588
683670,2017,7,23,2,25,2653
683730,2017,5,6,4,10,228
683760,2017,7,15,1,16,382
683790,2017,5,8,4,12,417
684050,2018,5,23,15,38,747
684060,2017,7,9,2,11,1065
684130,2017,3,1,10,11,231
684210,2018,6,51,17,68,13387
684270,2017,8,129,5,134,8049
684410,2017,8,982,109,1091,155331
684530,2017,7,28,1,29,3312
684580,2019,5,372,207,579,30627
684680,2017,7,46,1,47,1912
684820,2017,4,7,13,20,2497
684870,2017,7,13,1,14,278
684940,2017,6,9,3,12,413
685310,2017,6,138,43,181,34903
685340,2019,6,193,49,242,18115
685400,2018,8,99,1,100,2204
685420,2017,5,63,45,108,12199
685680,2017,8,115,14,129,9331
685690,2018,8,117,12,129,4838
685750,2017,5,19,20,39,6304
685790,2017,5,28,34,62,1226
685950,2017,5,74,38,112,1885
685990,2017,4,20,39,59,1285
686110,2017,7,39,5,44,2745
686200,2018,8,259,22,281,14448
686360,2017,7,20,5,25,752
686500,2017,5,16,9,25,531
686550,2017,5,10,6,16,1211
686570,2017,6,46,19,65,1053
686740,2017,5,10,9,19,681
686760,2017,7,32,5,37,688
686900,2017,6,34,10,44,5666
687260,2017,8,355,30,385,17784
687310,2017,7,15,3,18,168
687480,2017,5,7,6,13,1536
687490,2017,5,13,9,22,1496
687540,2017,6,23,7,30,2833
687560,2017,6,10,3,13,10370
687750,2017,5,61,46,107,4993
687830,2017,8,98,3,101,1803
687890,2017,7,12,2,14,646
687920,2018,8,333,72,405,21756
688260,2017,5,33,15,48,926
688380,2017,7,18,1,19,488
688400,2017,7,14,2,16,508
688450,2017,7,8,2,10,108
688480,2017,5,162,93,255,15182
688570,2017,5,20,10,30,1183
688680,2017,7,12,3,15,303
688690,2017,8,52,8,60,1346
688800,2018,7,12,3,15,241
688880,2017,5,15,11,26,439
689000,2017,7,10,1,11,155
689040,2018,7,9,2,11,334
689070,2017,8,141,11,152,4182
689090,2017,8,581,71,652,43986
689160,2017,6,9,3,12,320
689180,2017,6,12,5,17,1548
689350,2017,4,17,31,48,1139
689360,2017,4,29,59,88,3717
689400,2017,8,72,12,84,6866
689650,2017,5,84,70,154,5868
689700,2018,8,85,16,101,3010
689900,2017,8,121,5,126,3023
689910,2017,8,150,8,158,5443
690060,2017,5,106,68,174,26701
690120,2021,8,54,10,64,1253
690130,2017,7,10,2,12,240
690150,2018,7,39,4,43,1333
690240,2017,5,11,6,17,1490
690350,2017,6,35,9,44,569
690460,2017,5,15,9,24,1276
690510,2019,6,520,147,667,20212
690560,2017,8,49,6,55,1122
690610,2018,6,30,11,41,13012
690620,2018,7,27,5,32,592
690630,2018,7,15,1,16,848
690710,2017,7,15,1,16,423
690740,2017,5,36,18,54,1946
690810,2017,5,111,60,171,10157
690930,2017,8,340,42,382,16080
691080,2017,5,32,20,52,518
691240,2017,7,13,3,16,200
691250,2017,7,15,1,16,327
691390,2020,8,92,23,115,3754
691450,2017,8,201,4,205,8620
691540,2017,5,41,28,69,34393
691630,2015,6,71,28,99,3355
691690,2018,8,680,144,824,23369
691830,2018,8,65,5,70,4984
692030,2018,4,55,126,181,3650
692200,2017,5,12,10,22,970
692590,2017,5,8,9,17,271
692920,2017,6,335,114,449,62689
692930,2017,7,29,7,36,1127
693180,2017,5,13,7,20,40836
693250,2017,5,9,13,22,883
693670,2017,5,28,17,45,525
693700,2018,7,44,1,45,1694
693750,2019,5,57,32,89,4232
693880,2017,5,8,7,15,1296
693890,2017,5,8,5,13,1254
694070,2018,6,7,3,10,972
694090,2018,8,53,9,62,2740
694130,2017,5,46,66,112,48796
694370,2017,7,38,4,42,1308
694480,2020,6,15,5,20,927
694490,2017,4,13,21,34,1634
694790,2017,7,13,3,16,429
694930,2018,7,10,2,12,285
694950,2017,7,20,4,24,494
694980,2017,5,43,21,64,1835
695100,2018,8,65,11,76,3054
695110,2017,7,12,1,13,662
695360,2018,5,16,16,32,2797
695450,2018,5,13,6,19,271
695600,2018,6,96,27,123,10068
695630,2017,5,200,277,477,8808
695650,2017,5,64,30,94,1884
695920,2018,8,390,79,469,35448
695970,2018,8,68,4,72,2403
696140,2017,8,83,8,91,5019
696170,2018,6,1213,513,1726,40229
696180,2018,5,72,34,106,3315
696250,2017,5,7,6,13,408
696360,2017,5,51,28,79,7535
696400,2017,5,9,13,22,1807
696460,2017,8,47,5,52,1138
696480,2017,8,275,61,336,16161
696530,2018,8,81,8,89,1600
696560,2017,7,28,7,35,1040
696590,2017,8,113,22,135,5832
696940,2017,6,30,11,41,1253
697010,2018,5,74,66,140,3673
697020,2018,4,4,9,13,1061
697370,2018,7,14,2,16,376
697610,2017,8,116,13,129,25787
697650,2018,7,29,1,30,869
697850,2017,4,6,13,19,1374
697870,2018,5,7,5,12,181
697930,2017,5,20,16,36,2131
698050,2018,7,38,4,42,1868
698110,2018,6,15,4,19,365
698300,2017,8,44,11,55,1813
698330,2017,7,35,7,42,846
698450,2018,7,20,1,21,418
698740,2017,5,49,22,71,5957
698830,2017,5,18,14,32,1210
699080,2017,7,32,4,36,933
699100,2017,5,7,4,11,755
699180,2018,7,40,1,41,486
699240,2017,7,17,4,21,1842
699480,2017,5,8,11,19,394
699550,2017,5,12,15,27,739
699590,2017,5,11,7,18,11412
699600,2017,8,52,2,54,3256
699700,2018,8,73,17,90,3645
699750,2017,7,26,4,30,661
699780,2017,7,16,3,19,1351
699940,2017,6,19,6,25,752
700170,2017,7,42,7,49,20390
700330,2017,8,6743,1433,8176,973512
700440,2017,5,11,6,17,431
700480,2017,6,75,22,97,16199
700510,2017,7,9,1,10,136
700520,2018,7,17,1,18,334
700660,2017,6,40,17,57,1683
700740,2017,5,15,12,27,1421
700770,2018,6,27,11,38,1235
701280,2017,6,8,3,11,317
701290,2017,7,9,1,10,313
701540,2017,5,14,8,22,2203
701720,2017,6,40,17,57,1315
701740,2017,5,9,4,13,173
701760,2018,6,21,6,27,771
701860,2017,7,25,5,30,1435
701930,2017,8,345,1,346,6680
702110,2017,8,48,10,58,2832
702120,2018,5,101,92,193,5227
702190,2017,5,27,19,46,857
702200,2017,5,29,32,61,2872
702320,2017,5,95,90,185,59173
702600,2017,7,39,3,42,856
702700,2018,5,45,50,95,1903
702810,2018,8,633,44,677,144867
702890,2019,6,674,222,896,30089
702940,2018,7,10,1,11,61
703060,2018,6,13,5,18,2886
703120,2018,6,7,3,10,306
703180,2017,7,20,4,24,867
703210,2017,7,13,3,16,510
703400,2018,5,21,12,33,457
703500,2017,7,17,1,18,357
703530,2017,5,6,6,12,2592
703620,2017,7,32,3,35,841
703630,2017,7,23,3,26,400
703700,2017,6,1321,378,1699,65517
703760,2017,5,8,6,14,1788
703840,2018,8,178,18,196,10702
703870,2017,6,14,6,20,776
703920,2017,4,9,21,30,19662
703950,2017,6,311,112,423,166288
704040,2017,5,129,80,209,57843
704200,2018,7,40,3,43,1454
704360,2018,8,51,5,56,1083
704640,2018,7,38,2,40,962
704680,2017,7,19,4,23,1151
704690,2017,6,73,27,100,6142
704830,2017,5,62,48,110,5625
704840,2017,8,97,5,102,1762
704860,2018,7,17,1,18,538
705050,2018,4,6,10,16,922
705070,2017,5,19,21,40,2429
705090,2017,5,8,5,13,1165
705120,2017,8,1689,131,1820,193429
705240,2017,7,14,1,15,515
705250,2017,6,11,3,14,243
705260,2017,5,7,6,13,410
705300,2017,4,6,10,16,549
705380,2018,7,19,1,20,467
705450,2017,7,37,3,40,1107
705620,2018,7,26,4,30,720
705640,2017,5,14,7,21,412
705670,2018,7,15,1,16,362
705710,2017,4,13,39,52,2745
705750,2017,7,23,4,27,836
706020,2019,6,230,93,323,11574
706130,2017,8,67,3,70,1256
706280,2017,7,14,2,16,370
706320,2017,5,10,6,16,1258
706330,2017,5,9,5,14,1110
706490,2018,5,35,22,57,1654
706520,2018,6,34,13,47,359
706920,2017,7,24,1,25,431
706960,2018,6,21,7,28,1248
707010,2018,6,584,219,803,33966
707230,2017,7,10,2,12,250
707300,2018,6,188,58,246,5616
707590,2017,8,42,9,51,1488
707720,2017,5,6,4,10,216
707870,2017,6,59,22,81,1981
708150,2018,7,9,1,10,680
708260,2017,7,39,4,43,868
708300,2017,7,22,3,25,810
708310,2018,7,27,5,32,739
708340,2017,7,31,5,36,6467
708420,2018,5,145,68,213,78218
708430,2017,5,12,12,24,661
708580,2017,8,91,20,111,5489
708640,2017,7,15,1,16,186
708680,2017,7,42,2,44,11816
708760,2018,7,21,1,22,367
708820,2018,7,15,2,17,1505
708850,2017,7,15,2,17,399
708920,2017,7,22,3,25,5718
708930,2017,4,5,10,15,316
708950,2017,7,18,3,21,461
708970,2020,7,26,3,29,170
709050,2018,3,3,19,22,135
709140,2018,6,11,4,15,109
709190,2017,5,11,6,17,583
709380,2017,5,20,15,35,975
709410,2017,5,18,15,33,1777
709560,2017,5,8,5,13,146
709700,2017,5,19,17,36,1229
709780,2017,5,24,28,52,1358
709840,2017,5,22,32,54,1614
709870,2018,5,8,12,20,979
710030,2017,8,171,20,191,10347
710070,2017,7,12,2,14,221
710110,2017,6,10,4,14,1179
710120,2017,6,12,4,16,1157
710190,2018,7,33,2,35,357
710470,2018,8,174,16,190,5102
710520,2017,7,12,2,14,191
710610,2018,8,71,13,84,5116
710760,2017,7,25,5,30,1394
710780,2017,6,48,18,66,4338
710880,2017,4,3,9,12,917
711070,2017,5,18,26,44,1630
711320,2017,5,31,17,48,1600
711450,2017,5,8,4,12,369
711560,2017,6,24,7,31,2390
711660,2018,8,490,84,574,26542
711750,2018,6,207,88,295,12057
711930,2018,4,10,17,27,613
712000,2017,5,27,23,50,1745
712010,2017,5,13,6,19,590
712060,2018,7,31,3,34,4188
712090,2017,5,13,8,21,1454
712100,2018,5,2258,1570,3828,224856
712150,2017,5,8,6,14,369
712380,2017,7,31,3,34,647
712390,2017,8,44,10,54,12608
712650,2017,7,8,2,10,174
712730,2017,8,423,10,433,15552
712770,2017,7,37,8,45,8161
712790,2017,7,37,9,46,3562
712870,2018,7,30,6,36,623
712970,2017,7,14,1,15,236
712980,2017,6,12,4,16,260
713050,2017,8,62,13,75,1758
713080,2017,4,3,11,14,352
713160,2017,7,27,1,28,526
713220,2018,7,12,3,15,194
713420,2018,5,19,10,29,1063
713450,2018,7,9,1,10,8220
713530,2017,8,76,7,83,1735
713650,2017,5,215,117,332,19363
713680,2017,5,51,38,89,2809
714010,2018,6,92,30,122,5420
714020,2018,6,203,61,264,28475
714050,2017,5,10,13,23,4154
714240,2017,7,29,6,35,1532
714280,2017,8,74,2,76,1410
714510,2017,5,7,7,14,305
714640,2018,5,18,12,30,531
714730,2018,5,9,7,16,469
715010,2017,8,203,5,208,15092
715050,2018,6,67,22,89,6314
715060,2017,4,12,21,33,1602
715290,2017,5,9,6,15,1967
715310,2017,5,110,75,185,39504
715440,2017,7,9,1,10,929
715470,2017,5,9,5,14,640
715510,2017,6,44,14,58,1786
715520,2018,5,19,9,28,1132
715650,2018,8,122,17,139,3616
715660,2020,6,22,7,29,559
715690,2017,5,28,16,44,2232
715800,2018,5,11,8,19,727
715840,2017,5,21,15,36,1065
715980,2017,5,17,25,42,1225
716010,2018,7,26,1,27,355
716040,2018,5,10,5,15,362
716070,2017,7,19,1,20,310
716260,2017,8,95,10,105,36966
716330,2017,6,10,3,13,403
716340,2017,8,66,1,67,2112
716400,2017,7,19,3,22,476
716600,2017,4,7,15,22,1052
716630,2017,5,45,37,82,4683
716650,2017,8,116,1,117,1214
716680,2017,7,35,3,38,331
716760,2018,7,10,2,12,4995
716770,2018,6,19,8,27,390
717120,2018,5,13,7,20,424
717190,2017,6,12,4,16,3374
717310,2018,7,23,2,25,655
717330,2018,7,8,2,10,2616
717610,2018,7,42,4,46,1555
717640,2017,8,328,56,384,66897
717820,2017,6,14,4,18,373
717850,2018,7,18,1,19,259
717950,2017,6,76,20,96,2704
717990,2017,5,52,28,80,11312
718010,2018,7,35,4,39,565
718180,2017,8,76,12,88,5027
718200,2017,7,46,1,47,1022
718220,2017,5,9,9,18,1568
718270,2018,5,6,7,13,1059
718320,2017,6,45,17,62,3678
718330,2017,8,120,22,142,5390
718370,2017,5,77,43,120,4100
718500,2017,6,28,9,37,9224
718560,2018,7,34,5,39,8547
718650,2019,8,201,36,237,18941
718660,2017,5,10,6,16,407
718670,2018,6,678,182,860,51608
718720,2017,7,21,1,22,855
718960,2017,7,12,2,14,114
719120,2017,4,19,41,60,2943
719410,2017,8,69,3,72,593
719470,2017,4,4,8,12,352
719610,2017,5,33,33,66,1566
719640,2017,5,72,74,146,67624
719730,2018,5,22,22,44,15738
719800,2018,7,25,2,27,437
720150,2017,8,84,14,98,2139
720250,2018,8,409,96,505,46315
720280,2017,8,1765,251,2016,66259
720670,2017,8,48,5,53,1918
721350,2017,7,18,3,21,223
721430,2017,6,24,10,34,1085
721760,2017,7,13,3,16,449
721940,2017,5,5,7,12,673
721950,2017,5,12,6,18,305
722040,2017,6,8,3,11,332
722180,2021,8,109,21,130,3086
722230,2017,5,201,91,292,17035
722250,2017,6,22,9,31,901
722330,2018,8,52,1,53,287
722660,2019,7,24,6,30,1578
722730,2017,8,414,7,421,12270
722750,2017,5,25,18,43,10604
722760,2017,6,11,3,14,478
722870,2017,7,36,2,38,476
722890,2018,7,25,5,30,514
722920,2018,7,15,2,17,306
722990,2017,7,18,1,19,515
723090,2017,8,391,10,401,24016
723270,2017,8,164,14,178,3859
723610,2017,7,35,7,42,12468
723760,2017,5,11,9,20,623
723780,2017,5,1115,1129,2244,594344
723820,2017,7,18,1,19,595
723890,2017,7,32,3,35,926
724250,2018,5,62,31,93,3771
724350,2017,6,43,13,56,4368
724430,2018,4,7,11,18,1144
724470,2018,8,50,8,58,3314
724710,2018,5,11,8,19,419
724740,2017,8,229,57,286,9051
725340,2017,8,473,60,533,29426
725400,2017,5,19,21,40,751
725970,2017,7,13,3,16,198
726020,2017,6,13,4,17,595
726070,2017,4,9,21,30,840
726120,2017,6,19,8,27,563
726200,2017,7,33,5,38,680
726230,2017,7,14,1,15,1116
726250,2017,8,66,3,69,2127
726260,2017,7,13,1,14,202
726320,2017,7,14,3,17,410
726340,2017,7,25,1,26,612
726390,2017,8,226,38,264,42180
726510,2018,7,14,1,15,267
726600,2017,5,13,15,28,835
726760,2017,5,29,19,48,1231
726800,2017,5,23,18,41,820
726910,2017,8,156,28,184,59331
726950,2018,5,19,23,42,1216
727100,2018,7,21,2,23,332
727180,2018,6,21,7,28,732
727190,2018,5,8,4,12,344
727220,2017,5,8,4,12,249
727290,2017,7,15,1,16,206
727310,2017,6,15,4,19,5440
727340,2017,7,25,1,26,642
727460,2017,6,22,8,30,1521
727480,2017,7,27,2,29,430
727510,2017,7,38,1,39,937
727530,2017,5,17,8,25,5297
727550,2017,6,15,6,21,219
727730,2017,7,28,7,35,883
727760,2018,7,20,3,23,1012
728070,2017,7,15,3,18,1321
728420,2017,5,9,4,13,300
728440,2017,8,72,10,82,2348
728630,2018,6,7,3,10,40
728730,2018,8,481,97,578,105272
728870,2017,7,27,5,32,286
728990,2017,5,12,15,27,1093
729060,2018,6,43,11,54,1344
729090,2018,4,6,12,18,522
729330,2017,5,27,26,53,2626
729460,2017,5,9,4,13,584
729530,2017,5,43,19,62,2550
729570,2017,7,19,4,23,582
729580,2017,5,22,13,35,6533
729670,2017,4,13,24,37,5032
729720,2017,6,38,10,48,2628
730050,2018,8,53,7,60,1827
730290,2018,7,9,1,10,308
730410,2017,5,138,79,217,8646
730920,2017,7,25,1,26,301
731230,2017,5,19,14,33,1644
731880,2017,5,39,23,62,2418
731920,2017,5,50,59,109,3951
731940,2017,7,22,4,26,791
732090,2017,4,5,8,13,482
732370,2018,6,387,109,496,22701
732430,2017,9,3555,115,3670,184213
732520,2018,6,11,4,15,988
732810,2018,8,205,13,218,4181
732840,2017,5,10,5,15,822
733050,2017,8,90,9,99,4381
733070,2017,8,123,9,132,6771
733250,2017,7,13,2,15,641
733300,2018,7,45,1,46,954
733340,2018,8,55,3,58,3752
733430,2017,5,9,9,18,552
733460,2021,8,52,10,62,7824
733740,2018,8,76,5,81,6618
733990,2017,8,811,47,858,39373
734120,2017,6,47,20,67,1506
734540,2017,5,11,5,16,404
734570,2018,6,35,11,46,633
734590,2018,5,40,54,94,1378
734700,2017,7,17,2,19,250
734750,2017,6,625,172,797,184035
734910,2017,8,361,32,393,60835
734920,2018,8,94,4,98,3492
735060,2019,7,16,3,19,170
735260,2017,5,10,5,15,417
735280,2017,6,103,42,145,19275
735350,2017,6,37,13,50,842
735410,2017,5,6,6,12,336
735450,2017,6,40,16,56,31616
735500,2018,6,31,8,39,900
735570,2017,8,544,39,583,60531
735850,2018,5,162,86,248,48114
736110,2017,5,14,8,22,482
736200,2017,7,19,3,22,425
736430,2017,5,6,7,13,263
736570,2018,8,73,4,77,3126
736810,2018,6,29,12,41,3741
736860,2017,5,34,20,54,3030
736930,2017,5,14,7,21,1703
737260,2017,5,7,9,16,416
737530,2018,5,9,12,21,6138
737690,2017,6,13,4,17,456
737710,2018,7,39,2,41,863
737810,2017,5,10,5,15,584
737870,2017,7,39,5,44,2319
737930,2018,7,8,2,10,335
738000,2017,6,16,6,22,764
738020,2017,7,31,7,38,1933
738500,2017,5,73,91,164,39676
738560,2017,7,8,2,10,217
738610,2017,6,78,26,104,8193
738760,2017,6,12,5,17,255
738880,2018,5,21,19,40,1885
738920,2018,5,14,21,35,783
739050,2018,8,106,7,113,655
739190,2018,8,51,3,54,914
739210,2017,7,20,2,22,773
739410,2017,6,8,3,11,6952
739690,2017,5,14,7,21,492
739850,2017,7,10,1,11,310
739980,2017,8,62,3,65,2257
740000,2017,7,26,2,28,237
740090,2017,5,8,6,14,1081
740200,2018,8,288,47,335,133570
740230,2018,7,34,2,36,1766
740260,2017,8,898,86,984,18594
740290,2017,8,120,24,144,2646
740400,2017,7,11,1,12,435
740410,2017,7,19,2,21,682
740470,2017,6,347,115,462,49221
740570,2017,7,42,7,49,1449
740600,2017,5,56,28,84,1886
741100,2017,4,5,9,14,258
741260,2018,6,527,215,742,34253
741450,2017,4,17,43,60,2609
741500,2017,5,87,46,133,4697
741670,2017,8,310,58,368,11292
742170,2018,8,45,10,55,7035
742230,2017,6,21,9,30,542
742250,2018,8,215,12,227,4384
742460,2019,8,69,7,76,3534
742480,2018,7,42,5,47,778
742540,2017,6,13,4,17,420
742630,2017,5,22,11,33,7636
743110,2017,7,9,2,11,310
743190,2018,5,21,10,31,5962
743370,2017,5,138,83,221,71139
743450,2018,8,859,97,956,103873
743640,2017,5,111,75,186,5470
743860,2018,4,223,488,711,12676
744040,2019,7,17,4,21,437
744050,2018,8,47,4,51,2188
744190,2018,9,691,36,727,52637
744420,2017,6,61,24,85,1326
744430,2017,8,61,13,74,1620
744570,2017,8,69,11,80,7448
744590,2017,6,13,4,17,210
744940,2017,5,14,10,24,498
745000,2018,7,41,7,48,1373
745030,2017,7,15,1,16,434
745130,2017,5,6,5,11,1003
745330,2018,8,45,5,50,2334
745370,2017,6,17,7,24,854
745380,2017,5,5,5,10,311
745400,2018,7,19,1,20,279
745500,2017,4,7,14,21,803
745510,2017,6,29,12,41,1440
745670,2017,4,9,24,33,1856
745740,2017,6,63,25,88,4761
745810,2018,8,52,9,61,595
745890,2018,8,90,3,93,1305
745930,2017,6,13,4,17,333
745940,2018,6,22,8,30,32396
745960,2017,8,124,7,131,3249
746010,2018,5,6,7,13,2484
746140,2018,6,115,48,163,6743
746350,2017,5,17,9,26,915
746400,2018,8,59,2,61,1213
746410,2017,6,27,7,34,605
746570,2017,6,20,6,26,358
746620,2017,7,42,4,46,2126
746660,2018,7,9,1,10,364
746710,2018,8,100,6,106,7580
746930,2019,8,543,108,651,34977
746940,2018,8,61,7,68,3464
747190,2017,5,11,6,17,547
747310,2017,5,19,12,31,2079
747320,2018,7,25,2,27,1023
747330,2017,6,14,4,18,353
747340,2017,8,200,29,229,8727
747470,2018,7,42,1,43,526
747590,2017,5,32,17,49,2462
747640,2018,7,12,1,13,203
747770,2017,5,14,7,21,1382
747850,2020,4,9,14,23,233
747910,2017,5,13,11,24,2533
747990,2017,6,10,3,13,208
748430,2017,5,8,4,12,654
748480,2017,6,19,6,25,2110
748490,2018,9,518,19,537,17349
748610,2017,5,15,8,23,3022
748890,2017,8,56,2,58,3472
748930,2017,5,8,4,12,163
749270,2017,5,9,8,17,862
749340,2017,6,13,4,17,643
749370,2018,5,13,11,24,510
749410,2018,7,19,3,22,628
749540,2022,6,57,22,79,2589
749670,2017,7,15,3,18,622
749730,2018,7,17,2,19,376
749800,2018,5,37,29,66,1735
749850,2018,7,24,6,30,1584
749880,2017,7,32,8,40,1047
749920,2018,5,16,7,23,807
749990,2017,7,12,1,13,964
750070,2018,5,11,13,24,730
750330,2017,6,16,6,22,435
750660,2017,7,40,4,44,469
750900,2017,4,2,8,10,264
750960,2017,7,35,3,38,551
751200,2017,5,8,5,13,215
751250,2018,7,22,4,26,475
751280,2017,7,45,2,47,541
751330,2018,5,8,4,12,291
751340,2018,6,25,8,33,1102
751500,2017,6,97,33,130,6476
751690,2017,8,345,36,381,125741
752020,2018,5,11,7,18,386
752300,2017,6,10,4,14,168051
752380,2018,7,26,5,31,541
752500,2017,8,53,11,64,1209
752570,2018,6,44,13,57,811
752600,2018,7,30,2,32,319
752700,2017,6,14,6,20,596
753060,2017,5,15,8,23,4578
753110,2018,5,40,45,85,1280
753230,2018,6,179,75,254,5019
753380,2017,5,7,5,12,709
753420,2018,8,1163,159,1322,129464
753440,2017,7,11,1,12,121
753610,2018,5,39,43,82,29152
753660,2018,7,40,6,46,1031
753900,2018,6,28,9,37,1925
753920,2017,5,6,7,13,585
753960,2017,5,7,4,11,73
754020,2018,6,15,5,20,266
754120,2017,5,12,8,20,2503
754340,2018,6,7,3,10,305
754540,2017,7,39,2,41,1151
754800,2017,6,14,4,18,886
754810,2017,8,128,24,152,14378
755350,2017,5,9,12,21,399
755560,2017,7,13,1,14,530
755570,2018,5,22,10,32,993
755890,2017,8,44,9,53,1455
755980,2018,8,97,8,105,1081
756190,2017,4,7,11,18,641
756240,2018,7,27,3,30,538
756260,2017,5,14,13,27,784
756440,2017,7,44,4,48,3659
756490,2018,6,17,6,23,836
756500,2018,5,7,6,13,857
756590,2018,8,204,15,219,6383
756700,2017,7,30,3,33,511
756880,2017,5,31,26,57,2453
757130,2018,4,156,272,428,75371
757330,2017,8,74,2,76,3876
757350,2018,7,30,5,35,1074
757450,2017,7,14,3,17,1160
757810,2018,5,68,73,141,28269
757860,2017,5,13,6,19,512
757870,2017,7,18,2,20,198
758050,2018,5,9,11,20,514
758100,2018,6,39,14,53,2566
758150,2018,6,8,3,11,200
758190,2018,8,701,86,787,54479
758320,2018,6,15,5,20,1254
758370,2018,8,275,28,303,20486
758400,2017,5,6,4,10,276
758410,2018,5,55,27,82,2015
758470,2017,4,6,10,16,435
758500,2017,8,136,5,141,4557
758530,2018,8,443,17,460,30242
758570,2018,7,25,2,27,65124
758920,2017,5,6,5,11,835
758980,2018,6,39,16,55,12192
759000,2018,7,30,3,33,701
759010,2018,5,8,9,17,1293
759500,2017,6,10,3,13,584
759540,2018,8,62,5,67,709
759610,2017,5,16,23,39,834
759640,2018,7,27,2,29,425
759870,2017,4,6,21,27,414
759940,2017,8,276,40,316,6322
760030,2018,7,17,1,18,155
760330,2018,8,106,1,107,2661
760350,2017,7,16,3,19,1339
760460,2018,5,27,20,47,1783
760490,2017,5,12,11,23,154
760550,2018,8,65,10,75,953
760560,2017,5,19,18,37,879
760800,2018,6,32,10,42,1235
760890,2018,8,132,2,134,2924
761030,2018,8,73,14,87,6572
761070,2018,8,66,6,72,5779
761170,2018,8,61,13,74,5142
761280,2017,6,33,9,42,8139
761440,2017,3,1,9,10,387
761630,2017,4,5,8,13,299
761660,2017,4,3,9,12,560
761760,2018,6,19,7,26,318
761790,2018,6,12,5,17,1070
761890,2018,6,402,163,565,31979
762380,2018,5,7,4,11,359
762480,2018,6,25,10,35,1457
762520,2018,5,6,6,12,791
762590,2018,6,37,11,48,2177
763050,2017,7,12,2,14,513
763070,2017,6,15,6,21,584
763090,2017,5,8,9,17,8173
763210,2017,7,22,2,24,318
763360,2017,6,13,5,18,697
763400,2017,4,10,16,26,758
763610,2018,7,10,2,12,1021
763730,2018,5,9,5,14,653
763760,2017,7,16,4,20,676
763770,2018,7,23,4,27,269
763870,2017,7,13,2,15,478
763930,2017,7,26,1,27,1530
764300,2018,6,38,10,48,3457
764410,2018,5,26,16,42,881
764430,2017,6,10,4,14,949
764470,2017,6,10,3,13,221
764490,2018,6,11,4,15,692
764500,2017,6,42,18,60,1298
764510,2018,8,60,8,68,5313
764570,2018,8,49,9,58,13454
764580,2018,6,10,3,13,483
764590,2018,6,23,7,30,515
765460,2018,5,8,4,12,401
765590,2018,7,14,1,15,852
765640,2017,8,165,7,172,2313
765650,2018,6,89,35,124,19279
766280,2018,8,375,11,386,4751
766320,2018,7,38,7,45,3683
766570,2021,5,310,170,480,61943
766630,2018,7,34,5,39,676
766730,2018,8,67,2,69,1526
766940,2018,7,14,1,15,7001
767050,2017,5,7,5,12,252
767200,2018,7,14,1,15,266
767340,2018,6,8,3,11,288
767500,2017,6,21,6,27,238
768300,2017,5,20,10,30,989
768750,2018,5,121,140,261,17165
768840,2017,5,21,14,35,9126
769080,2017,5,16,7,23,271
769110,2019,5,13,14,27,592
769200,2018,5,11,15,26,375
769360,2018,6,31,11,42,1003
769550,2017,7,26,2,28,684
769910,2018,7,10,1,11,438
769940,2018,5,9,5,14,1454
770100,2018,8,79,14,93,10185
770270,2018,5,4,6,10,118
770400,2017,4,13,27,40,657
770440,2018,5,43,27,70,2229
771010,2018,7,30,1,31,779
771060,2018,5,230,107,337,50757
771240,2018,8,52,2,54,1249
771320,2018,5,8,6,14,639
771350,2018,5,39,31,70,2613
771370,2018,3,6,34,40,370
771410,2018,7,26,4,30,960
771610,2018,5,9,10,19,1040
771710,2018,7,40,4,44,1584
771840,2018,7,42,4,46,830
771920,2018,6,42,14,56,1090
771950,2018,6,11,3,14,542
772070,2018,6,147,60,207,53571
772080,2018,5,6,4,10,175
772090,2018,7,10,1,11,282
772200,2018,7,13,1,14,1568
772470,2018,7,14,1,15,499
772480,2018,7,22,3,25,2103
772540,2018,5,688,504,1192,257046
772600,2018,6,7,3,10,1344
772610,2018,7,35,1,36,828
772700,2018,6,67,21,88,7388
772990,2018,5,25,11,36,318
773130,2018,7,18,2,20,211
773170,2018,5,8,12,20,907
773390,2018,5,43,32,75,4651
773430,2018,7,31,2,33,393
773540,2019,6,18,5,23,810
773580,2018,8,64,9,73,2357
773640,2018,3,2,14,16,330
773650,2018,3,2,12,14,520
773670,2018,8,150,3,153,3315
774091,2018,8,186,9,195,7409
774221,2018,7,15,1,16,271
774261,2018,5,29,13,42,1027
774351,2018,6,67,27,94,3568
774441,2018,5,11,6,17,842
774561,2018,7,39,2,41,1264
774781,2018,6,9,3,12,516
774811,2018,5,387,216,603,12622
774911,2018,5,34,18,52,771
775530,2018,8,54,3,57,1771
775800,2018,6,67,24,91,620
775900,2018,5,103,59,162,6901
776160,2018,5,9,4,13,85
776190,2018,6,21,9,30,4139
776340,2018,5,40,26,66,2521
776370,2018,7,28,3,31,932
776490,2018,8,1432,232,1664,54617
776540,2018,7,15,3,18,430
776550,2018,5,8,11,19,526
776670,2018,5,7,8,15,620
776720,2018,7,20,1,21,250
776890,2018,4,12,20,32,1665
776960,2018,5,37,23,60,3979
777020,2018,5,17,15,32,1079
777050,2018,5,25,14,39,4736
777160,2018,7,35,5,40,2039
777200,2018,8,84,2,86,2925
777220,2018,7,35,1,36,615
777240,2018,8,114,13,127,2481
777400,2018,6,22,7,29,434
777430,2019,7,14,3,17,980
777560,2018,5,7,5,12,586
777790,2018,8,57,2,59,1154
777820,2018,7,8,2,10,4165
778050,2018,6,38,10,48,1193
778150,2018,7,27,1,28,1099
778230,2018,6,10,4,14,32844
778330,2018,8,81,3,84,1186
778410,2018,5,11,5,16,577
778570,2018,7,18,2,20,143
778610,2018,8,185,10,195,6792
778700,2018,6,1021,289,1310,108351
778840,2019,7,24,1,25,17430
778930,2018,6,28,12,40,1696
779320,2018,7,11,1,12,219
779330,2018,6,120,46,166,5787
779360,2018,7,16,1,17,643
779420,2018,5,34,26,60,1903
779570,2018,5,11,5,16,647
779700,2018,7,13,3,16,208
780210,2018,6,56,21,77,6908
780280,2018,8,49,6,55,2518
780390,2018,7,27,4,31,697
780500,2018,7,24,3,27,769
780580,2018,5,26,16,42,1099
780750,2018,5,15,10,25,827
781100,2018,5,6,7,13,433
781440,2018,8,465,19,484,33265
781520,2018,4,5,9,14,1436
781950,2018,7,8,2,10,146
782100,2018,7,8,2,10,693
782570,2018,8,80,20,100,2760
782690,2018,5,161,70,231,10722
783050,2018,8,53,7,60,7890
783200,2018,8,54,7,61,2262
783240,2018,4,59,136,195,31836
783420,2018,5,6,4,10,176
783440,2018,7,18,1,19,199
783810,2018,8,178,37,215,4659
783940,2018,7,26,5,31,1557
784940,2018,5,49,61,110,4249
785110,2018,5,23,10,33,675
785130,2018,8,60,9,69,20097
785640,2018,7,15,3,18,348
785660,2020,5,17,22,39,1832
785670,2018,5,9,11,20,1209
785780,2018,6,52,14,66,4903
785840,2018,8,185,45,230,7893
785880,2018,8,49,9,58,1815
785890,2018,7,39,1,40,537
786410,2018,5,56,25,81,9883
786510,2018,7,17,3,20,261
786580,2018,6,125,40,165,6343
786630,2018,7,33,3,36,4188
786650,2018,7,18,1,19,267
786670,2018,4,5,15,20,65550
786750,2018,4,3,10,13,454
786910,2018,7,22,5,27,431
786990,2018,7,13,2,15,536
787040,2018,6,16,6,22,1029
787220,2018,8,41,9,50,8169
787400,2018,8,241,50,291,12787
787550,2018,5,13,8,21,709
787710,2018,7,11,1,12,1260
787970,2018,7,13,3,16,511
788150,2018,7,28,3,31,474
788210,2018,5,50,23,73,3782
788270,2018,8,136,27,163,8386
788320,2018,7,9,2,11,204
788380,2018,7,18,1,19,617
788410,2018,7,26,3,29,677
788480,2018,7,20,1,21,150
788510,2018,4,11,32,43,2135
788610,2018,5,13,6,19,176
788690,2018,8,57,4,61,2155
788740,2018,6,19,7,26,501
788760,2018,7,19,1,20,455
788970,2018,5,18,10,28,2000
789100,2018,4,35,59,94,30494
789260,2018,7,23,3,26,668
789730,2018,6,42,12,54,2088
789880,2018,4,5,9,14,189
789930,2018,5,5,5,10,129
789950,2018,7,31,7,38,842
790160,2018,4,3,7,10,376
790290,2018,7,11,2,13,154
790450,2018,7,25,5,30,11954
790600,2018,5,132,65,197,27544
791160,2018,7,12,2,14,303
791330,2018,8,307,44,351,19491
791700,2018,7,38,3,41,448
791750,2018,7,30,4,34,799
792030,2018,8,108,3,111,2844
792350,2018,7,25,2,27,464
792560,2018,7,13,1,14,290
792650,2018,7,14,2,16,355
792880,2018,5,9,8,17,249
792970,2018,7,9,1,10,331
793050,2018,4,13,26,39,5396
793180,2018,4,3,10,13,399
793200,2018,7,31,6,37,146
793240,2018,7,13,1,14,287
793350,2018,8,308,9,317,10551
793450,2018,7,25,1,26,1106
793600,2018,7,9,1,10,153
793630,2018,7,9,1,10,138
793760,2018,7,10,1,11,568
793990,2018,5,6,4,10,540
794050,2018,3,2,9,11,454
794190,2018,7,14,1,15,430
794760,2018,7,34,4,38,1651
794800,2018,7,40,9,49,5842
794820,2018,5,18,12,30,6530
794860,2019,7,21,2,23,586
795100,2018,8,1933,116,2049,420843
795680,2018,6,13,4,17,507
796360,2018,6,10,3,13,532
796380,2018,7,11,1,12,282
796510,2018,7,14,2,16,756
796600,2018,7,18,4,22,177
796640,2018,5,19,9,28,1866
796650,2018,7,13,3,16,544
796780,2018,7,13,1,14,375
796790,2018,8,113,4,117,1886
797040,2018,4,8,13,21,362
797060,2018,5,7,6,13,805
797090,2018,4,3,8,11,296
797390,2018,8,119,10,129,8236
798240,2018,7,10,1,11,62
798280,2018,8,52,12,64,11545
798380,2018,7,10,1,11,2313
798560,2018,4,5,13,18,491
798940,2018,6,16,6,22,797
799070,2018,8,433,12,445,21014
799110,2018,7,13,1,14,208
799240,2018,4,40,78,118,47244
799730,2018,6,11,3,14,125
799810,2018,6,14,4,18,439
799840,2018,6,12,4,16,315
800050,2018,7,13,2,15,575
800180,2018,7,17,1,18,1366
800560,2018,6,7,3,10,449
800580,2018,6,7,3,10,885
800620,2018,8,63,3,66,1925
801020,2018,5,21,21,42,2464
801060,2018,3,2,12,14,637
801290,2018,7,22,1,23,245
801870,2018,5,12,10,22,792
802190,2018,7,8,2,10,108
802730,2018,8,144,23,167,14258
802880,2018,7,41,1,42,2633
802890,2018,8,100,2,102,2623
803030,2018,8,60,15,75,24261
803080,2018,5,11,7,18,772
803150,2018,7,16,2,18,500
803220,2018,5,27,22,49,12675
803260,2018,7,24,1,25,1586
803850,2018,7,16,1,17,307
804210,2018,4,6,10,16,728
804290,2018,7,16,1,17,5064
804430,2018,5,28,16,44,849
804460,2018,5,11,5,16,140
804730,2018,6,131,48,179,7394
804900,2018,6,22,9,31,10272
805280,2018,7,11,2,13,615
805440,2018,7,10,1,11,1748
805500,2018,5,9,9,18,580
805610,2018,7,25,4,29,183
805660,2018,7,25,4,29,1495
805710,2018,6,17,6,23,182
805820,2018,7,37,1,38,1286
805850,2018,6,1041,277,1318,119509
805870,2018,5,13,11,24,470
805920,2018,7,21,1,22,424
806100,2018,7,37,5,42,1461
806140,2018,5,52,53,105,4351
806770,2018,6,14,5,19,265
806860,2020,5,48,21,69,2517
806960,2018,7,10,2,12,413
807230,2018,7,25,6,31,588
807790,2018,5,6,7,13,313
807920,2018,5,20,18,38,1475
809050,2018,7,14,3,17,1044
809140,2019,8,273,29,302,16764
809210,2018,5,28,14,42,827
809250,2018,8,76,3,79,7444
809320,2018,7,13,2,15,1066
809440,2018,6,82,22,104,5185
809540,2022,7,21,5,26,899
809680,2018,7,18,1,19,118
809850,2018,7,27,3,30,1343
810230,2018,8,145,6,151,9859
810460,2018,5,21,10,31,260
810630,2018,6,8,3,11,2856
810660,2018,7,24,1,25,250
810670,2018,6,309,80,389,16374
810760,2018,5,13,8,21,7891
810780,2018,6,35,11,46,508
811240,2018,7,13,2,15,318
811360,2018,4,12,26,38,4384
811720,2018,7,23,3,26,773
812020,2018,6,29,8,37,760
812070,2021,7,26,5,31,457
812560,2018,7,24,4,28,509
813290,2018,6,28,9,37,1461
813540,2018,8,51,4,55,740
813590,2018,6,13,4,17,110
813700,2018,8,69,13,82,5835
814200,2018,7,25,3,28,9845
814540,2018,8,675,53,728,14163
814900,2018,7,28,6,34,481
815000,2018,8,67,2,69,884
815150,2018,7,18,1,19,554
815450,2018,7,39,1,40,1253
816060,2018,5,5,6,11,225
816080,2018,7,26,3,29,1261
816090,2018,5,497,257,754,77610
816120,2018,7,36,1,37,633
816180,2018,7,24,2,26,292
816190,2018,7,14,2,16,456
816210,2018,7,8,2,10,357
816250,2018,7,10,1,11,440
816270,2018,7,15,1,16,552
816330,2018,5,15,9,24,793
816490,2018,8,63,2,65,2216
816500,2018,7,10,2,12,198
816990,2018,7,17,3,20,260
817200,2018,5,10,5,15,204
817250,2018,5,17,8,25,298
817470,2018,7,8,2,10,158
817510,2018,5,328,157,485,43081
817760,2018,6,24,8,32,3972
817770,2018,6,18,7,25,287
818220,2018,7,8,2,10,2304
818320,2018,8,40,10,50,4022
818440,2018,5,13,9,22,712
818570,2018,7,17,3,20,517
818730,2018,7,17,3,20,1549
819230,2018,8,56,7,63,2188
819480,2018,7,43,2,45,1067
820030,2018,7,31,4,35,1179
820090,2018,5,17,9,26,4265
820240,2018,7,25,5,30,614
820460,2018,6,34,11,45,3557
820580,2018,5,10,12,22,15226
820610,2019,7,33,5,38,919
820710,2018,5,8,11,19,213
820750,2018,4,17,29,46,1858
820760,2018,6,22,7,29,263
820900,2018,7,24,3,27,405
821500,2018,6,50,18,68,1936
821550,2018,6,7,3,10,347
821560,2018,8,67,12,79,1427
821640,2018,8,70,8,78,2593
822530,2018,7,32,4,36,1098
822930,2018,8,153,7,160,6389
823100,2018,5,9,4,13,913
823360,2018,6,11,3,14,711
823700,2018,6,14,4,18,851
823710,2018,4,5,9,14,322
823830,2018,8,115,9,124,14685
823920,2018,7,11,2,13,3552
824190,2018,5,20,19,39,1346
824420,2018,6,19,6,25,3122
824580,2018,5,6,8,14,557
824720,2018,8,84,16,100,5526
825550,2018,6,26,7,33,921
825610,2018,4,12,19,31,2663
825630,2018,9,640,9,649,16306
825930,2018,7,13,2,15,163
827220,2018,6,19,8,27,4201
828150,2018,5,30,19,49,2266
828170,2018,5,20,12,32,6177
828230,2018,5,11,12,23,1928
828350,2019,6,11,3,14,122
828380,2018,6,19,7,26,327
828910,2018,6,8,3,11,263
828950,2018,7,12,1,13,311
828960,2018,4,12,25,37,1094
829250,2018,5,8,9,17,1127
829260,2018,7,12,2,14,279
829370,2018,7,15,1,16,335
829420,2018,5,13,19,32,4234
830710,2018,6,8,3,11,174
831090,2018,7,20,1,21,438
831120,2018,7,10,1,11,239
831230,2018,7,25,3,28,715
831770,2018,7,22,2,24,503
832650,2018,6,11,3,14,259
833010,2018,6,9,3,12,100
833030,2019,7,12,2,14,430
833140,2018,7,9,1,10,362
833910,2018,7,37,4,41,1132
834340,2018,7,10,2,12,2849
834750,2018,5,16,11,27,482
835040,2018,7,13,2,15,821
835530,2018,5,13,9,22,354
836480,2018,5,225,149,374,15463
836490,2018,8,188,9,197,2925
836760,2018,7,29,7,36,1363
836790,2018,7,9,1,10,87
838050,2018,4,3,9,12,603
838270,2018,5,8,11,19,364
838310,2018,9,1114,41,1155,44759
838510,2018,5,33,21,54,3847
838900,2018,5,83,98,181,14732
839260,2018,6,11,4,15,356
839300,2019,7,21,4,25,599
839570,2018,7,12,2,14,228
840060,2018,7,27,3,30,1620
840100,2018,7,16,2,18,737
840310,2018,7,21,1,22,404
840700,2018,6,10,3,13,380
840910,2018,7,13,1,14,64
841120,2018,7,12,3,15,197
841210,2018,8,45,9,54,594
841350,2018,6,19,5,24,3248
841770,2018,8,206,2,208,2126
841840,2018,5,6,9,15,303
842150,2018,5,50,29,79,11736
843010,2018,7,10,1,11,95
843250,2018,7,26,5,31,268
843270,2018,5,6,4,10,8296
843430,2018,7,38,2,40,1033
843660,2018,6,41,11,52,8019
843740,2018,7,10,1,11,189
843890,2018,5,21,18,39,2655
844210,2018,5,16,8,24,942
844380,2018,8,58,8,66,21308
844490,2018,4,5,8,13,523
844930,2018,8,457,13,470,11867
845200,2018,5,6,4,10,2622
845270,2018,7,16,1,17,193
845380,2018,7,17,1,18,238
845400,2018,5,5,7,12,311
845530,2018,4,5,11,16,366
845630,2018,7,13,3,16,273
845730,2018,7,9,2,11,184
846110,2018,8,140,20,160,3427
846200,2018,5,27,16,43,1265
846470,2018,8,167,19,186,4676
846710,2018,7,13,2,15,300
846820,2018,7,15,2,17,547
848200,2018,7,16,1,17,160
849520,2018,7,9,1,10,86
850050,2018,5,9,7,16,439
850060,2018,7,17,2,19,433
850450,2018,6,60,23,83,10263
850630,2018,8,53,4,57,866
850690,2018,4,19,42,61,511
851050,2018,6,21,9,30,252
851530,2018,8,223,11,234,18761
851650,2018,5,15,9,24,5657
851670,2018,7,46,1,47,1171
851810,2018,5,18,9,27,10304
851820,2018,7,36,6,42,1736
853380,2018,7,14,2,16,193
853500,2018,8,131,14,145,2889
855850,2018,7,9,1,10,244
856130,2018,6,50,20,70,855
856440,2018,5,7,9,16,464
856880,2018,5,24,12,36,5573
857010,2018,6,10,3,13,678
857520,2018,7,9,2,11,266
857710,2018,7,8,2,10,139
857940,2018,8,229,15,244,22768
858060,2018,4,27,81,108,32665
858760,2018,8,138,1,139,2188
858780,2018,6,9,3,12,676
859700,2018,6,11,3,14,27608
860530,2018,6,7,3,10,13915
860650,2018,7,17,1,18,339
861180,2018,3,2,13,15,84
861190,2018,5,5,7,12,5280
862580,2018,7,36,7,43,489
862690,2018,8,1191,177,1368,62656
863490,2018,7,10,1,11,1924
864300,2018,7,39,1,40,847
864510,2018,7,16,1,17,1679
864940,2018,4,13,35,48,1019
865180,2018,7,31,5,36,962
866150,2018,3,6,29,35,1231
866510,2018,6,11,3,14,791
867610,2018,5,7,7,14,186
867730,2018,5,9,4,13,229
868230,2018,7,20,4,24,124
869760,2018,8,744,88,832,95199
871870,2018,7,9,1,10,225
872680,2019,7,16,4,20,604
873200,2018,7,40,3,43,838
873610,2018,7,19,1,20,457
874400,2018,6,26,9,35,2607
874650,2018,5,84,53,137,22284
876310,2018,7,17,3,20,146
877190,2018,6,11,3,14,34
877840,2018,7,13,2,15,38
882560,2018,5,6,4,10,51
