id,year,review_score,total_positive,total_negative,total_reviews,Players
200150,2015,5,90,105,195,9354
208650,2015,6,27501,11489,38990,1396715
208750,2015,8,1986,198,2184,172935
214420,2015,6,5571,1928,7499,1922501
222180,2015,6,18,7,25,7251
222440,2015,8,763,59,822,109446
225540,2015,6,26990,10656,37646,2345094
226100,2015,6,455,164,619,66298
226860,2015,6,5533,1669,7202,476035
229580,2015,5,505,351,856,76847
229810,2015,5,269,123,392,71209
230070,2015,8,1488,311,1799,96114
230190,2015,8,3527,631,4158,363113
233450,2015,8,27015,1874,28889,2856218
234140,2015,8,29985,3026,33011,1775140
234630,2015,6,7952,2427,10379,974136
234920,2015,6,316,83,399,40365
235540,2015,8,13067,3206,16273,1843514
235800,2015,8,3338,600,3938,324405
236690,2015,6,2395,903,3298,294476
237350,2015,6,178,64,242,33213
238240,2015,4,906,1471,2377,217625
238370,2015,6,3623,1103,4726,857543
240620,2015,5,122,76,198,26372
242130,2015,5,288,255,543,25982
242680,2015,9,8218,314,8532,492848
242840,2015,8,967,217,1184,75190
242860,2015,8,19702,3714,23416,1149077
243160,2015,8,394,80,474,69255
243970,2015,8,3210,227,3437,393703
244160,2015,8,4919,747,5666,728091
245370,2015,4,297,488,785,231517
246110,2015,6,1017,408,1425,161770
246760,2015,6,940,267,1207,112235
246900,2015,8,5635,431,6066,701439
247080,2015,9,12283,403,12686,1122748
248330,2015,8,485,43,528,41994
249950,2015,8,398,73,471,53741
250070,2015,7,12,2,14,958
250110,2015,9,1183,60,1243,73905
250420,2015,5,2534,1737,4271,934749
250520,2015,8,1244,188,1432,84245
251130,2015,8,2361,165,2526,217211
251290,2015,9,966,21,987,37625
251490,2015,8,251,7,258,13862
252110,2015,9,1506,79,1585,223795
252130,2015,8,601,46,647,61729
252450,2015,5,953,691,1644,79276
253050,2015,6,273,107,380,152
253390,2015,5,108,52,160,26399
254200,2015,6,1555,525,2080,146448
257170,2015,8,830,142,972,112346
258050,2015,5,493,249,742,123764
258910,2015,6,219,63,282,58460
259660,2015,5,193,103,296,34279
260430,2015,5,1957,843,2800,256424
261490,2015,6,495,163,658,57145
261570,2015,9,24272,869,25141,997767
262190,2015,6,118,31,149,5463
262280,2015,6,2702,700,3402,584679
262960,2015,6,761,191,952,50619
263060,2015,8,4662,1069,5731,499027
263640,2015,5,33,49,82,6098
263920,2015,6,193,75,268,16341
264000,2015,5,120,70,190,15950
264380,2015,8,2545,156,2701,194502
265590,2015,6,1302,454,1756,668962
265750,2015,6,926,354,1280,126146
265810,2015,5,287,182,469,30215
265970,2015,5,213,230,443,22318
266310,2015,6,705,243,948,61054
266510,2015,8,7536,681,8217,624982
267750,2015,5,728,384,1112,99330
268320,2015,8,232,22,254,25053
268340,2015,7,14,3,17,3483
268870,2015,5,2134,941,3075,592993
268970,2015,4,8,13,21,1257
269630,2015,5,19,19,38,1771
269650,2015,8,1270,192,1462,78398
269670,2015,8,928,170,1098,116937
269770,2015,8,3070,208,3278,208388
269990,2015,5,59,27,86,13264
270110,2015,5,226,135,361,16101
270150,2015,8,4507,592,5099,468632
270230,2015,8,60,9,69,1831
270450,2015,8,2821,213,3034,396373
270810,2015,5,100,53,153,26195
271360,2015,8,324,80,404,58172
271990,2015,7,34,3,37,5669
272330,2015,8,208,29,237,21381
272890,2015,5,547,381,928,136011
273500,2015,8,750,135,885,93823
273960,2015,5,51,70,121,8049
274170,2015,8,17203,1601,18804,1037686
274190,2015,9,26569,847,27416,1863667
274230,2015,5,1043,471,1514,78090
274350,2015,8,1035,61,1096,59822
274700,2015,8,61,3,64,4166
274920,2015,8,3277,601,3878,589693
275060,2015,4,49,171,220,6894
275100,2015,8,2251,473,2724,239901
275200,2015,8,1016,95,1111,123277
276730,2015,5,37,19,56,7689
276810,2015,5,3366,1444,4810,332983
277520,2015,5,127,96,223,25687
278420,2015,8,61,9,70,6947
278440,2015,6,184,66,250,23817
278570,2015,8,215,50,265,31428
278810,2015,5,76,58,134,11271
278910,2015,8,580,140,720,99790
279140,2015,6,227,71,298,19647
279800,2015,9,692,23,715,67732
279940,2015,8,517,41,558,55530
280010,2015,8,701,167,868,6343
280360,2015,5,198,135,333,25971
280600,2015,8,201,50,251,19696
281940,2015,5,661,450,1111,55156
282050,2015,5,263,259,522,25583
282140,2015,9,13229,550,13779,490677
282210,2015,5,856,1024,1880,195389
282590,2015,8,465,110,575,55309
282620,2015,5,52,33,85,6810
282640,2015,7,34,1,35,867
282780,2015,6,74,31,105,10699
282860,2015,4,52,114,166,6080
282900,2015,9,7771,368,8139,405416
283040,2015,5,37,34,71,33193
283080,2015,8,206,28,234,18210
284160,2015,8,10842,958,11800,804022
284810,2015,8,446,13,459,62726
284990,2015,5,224,121,345,55645
285740,2015,8,520,29,549,65340
285820,2015,8,452,52,504,74233
286160,2015,9,10024,518,10542,2297649
286280,2015,8,138,30,168,9977
286570,2015,5,2877,2156,5033,1022816
287290,2015,6,7586,2177,9763,658030
287600,2015,5,146,69,215,11937
287700,2015,8,32906,4072,36978,1750593
287840,2015,8,170,32,202,11520
287920,2015,5,1236,1225,2461,316391
287980,2015,9,6172,222,6394,547876
288260,2015,6,114,48,162,23909
288930,2015,8,340,74,414,20640
289760,2015,6,401,102,503,78120
290080,2015,5,5737,3072,8809,534443
290300,2015,8,4541,763,5304,378307
290340,2015,8,5668,1191,6859,565864
290490,2015,5,120,166,286,11551
290530,2015,8,261,64,325,31632
290790,2015,5,2170,997,3167,364090
290890,2015,8,575,118,693,62085
291650,2015,8,10429,1532,11961,1275530
292500,2015,8,451,32,483,45170
292600,2015,8,557,31,588,40133
293240,2015,8,383,37,420,30959
293260,2015,8,2839,434,3273,688214
293460,2015,5,86,39,125,7589
293520,2015,6,321,127,448,23901
293600,2015,5,33,40,73,11794
294000,2015,8,226,39,265,43218
294040,2015,6,855,301,1156,169868
294060,2015,6,80,32,112,5793
294190,2015,4,8,13,21,6451
295690,2015,8,1076,127,1203,163254
296490,2015,9,1923,81,2004,149323
296550,2015,8,77,14,91,2775
296710,2015,8,1160,120,1280,86683
296830,2015,5,654,446,1100,88829
296870,2015,8,1367,131,1498,231019
296970,2015,8,1835,123,1958,171206
297000,2015,5,3732,1766,5498,591573
297130,2015,6,2953,829,3782,350359
297740,2015,5,30,24,54,12778
297920,2015,6,178,58,236,42425
298360,2015,8,106,6,112,6827
298630,2015,8,9822,1161,10983,1296849
299090,2015,5,12,14,26,893
299360,2015,6,8995,2615,11610,2434754
299680,2015,6,957,244,1201,30008
300280,2015,6,66,27,93,12687
300340,2015,8,176,23,199,17782
300400,2015,8,76,12,88,6820
300570,2015,8,1330,78,1408,161086
300580,2015,6,308,113,421,80607
300760,2015,5,57,41,98,10825
301050,2015,5,71,33,104,10371
301640,2015,8,6987,1048,8035,939676
301860,2015,6,1665,586,2251,111781
301910,2015,6,4460,1550,6010,536513
301920,2015,8,76,4,80,6056
303260,2015,5,47,47,94,15243
303550,2015,8,165,17,182,11663
304240,2015,8,5151,500,5651,415885
304580,2015,5,104,151,255,22816
304650,2015,8,4703,975,5678,740790
304910,2015,6,140,36,176,13240
304950,2015,8,278,61,339,15364
305380,2015,8,967,92,1059,50345
305500,2015,5,68,51,119,7093
305820,2015,6,36,13,49,8103
306440,2015,5,54,53,107,7711
306670,2015,4,100,331,431,23835
307210,2015,5,44,29,73,10783
307430,2015,6,61,21,82,9755
307580,2015,9,705,35,740,41216
307590,2015,8,201,32,233,28487
307620,2015,5,48,35,83,13265
307670,2015,6,1715,477,2192,203211
307780,2015,6,16573,6213,22786,1455905
308173,2015,6,237,73,310,30126
308440,2015,8,78,7,85,7239
308520,2015,5,36,30,66,5527
308560,2015,6,23,9,32,4835
310060,2015,8,722,118,840,101271
310360,2015,9,1177,47,1224,81099
310470,2015,5,629,844,1473,96203
310490,2015,8,139,23,162,20588
310510,2015,8,857,195,1052,100663
310560,2015,8,14682,1910,16592,1073123
310740,2015,6,150,39,189,17788
310810,2015,6,47,17,64,22108
310850,2015,5,122,178,300,27283
310890,2015,5,384,338,722,58538
311490,2015,5,14,14,28,1262
311730,2015,5,3964,2457,6421,383476
311840,2015,5,26,19,45,9559
311930,2015,8,80,3,83,3644
312230,2015,8,205,50,255,17360
312240,2015,7,15,3,18,1243
312280,2015,6,1164,413,1577,327332
312440,2015,5,19,13,32,2449
312450,2015,6,661,273,934,159890
312530,2015,9,12794,555,13349,1183631
312540,2015,8,371,30,401,36523
312780,2015,6,850,215,1065,84513
312790,2015,5,114,65,179,29936
312840,2015,8,1937,423,2360,138534
312920,2015,6,75,23,98,4406
313010,2015,4,518,1196,1714,105319
313080,2015,5,294,174,468,55442
313810,2015,6,115,46,161,14089
314000,2015,5,682,385,1067,314286
314070,2015,8,593,65,658,57877
314150,2015,5,275,196,471,34406
314410,2015,8,1946,155,2101,257372
314520,2015,5,838,507,1345,89325
314560,2015,5,65,37,102,12976
314660,2015,8,1803,229,2032,204545
314830,2015,5,427,209,636,100193
315060,2015,5,172,89,261,102572
315130,2015,5,26,28,54,3286
315680,2015,4,18,35,53,2633
315860,2015,5,207,90,297,21991
316080,2015,8,95,11,106,15976
316370,2015,5,47,38,85,8044
316610,2015,8,155,7,162,7590
316750,2015,4,86,228,314,11493
316790,2015,8,3633,408,4041,516584
316890,2015,5,184,98,282,19907
316930,2015,5,353,188,541,21849
317100,2015,6,235,69,304,23784
317730,2015,4,32,55,87,1609
317820,2015,6,1108,366,1474,174216
317940,2015,6,116,48,164,6158
318020,2015,5,1216,751,1967,163715
318130,2015,9,1386,47,1433,24068
318230,2015,8,676,159,835,87209
318260,2015,5,64,32,96,5355
318480,2015,7,38,3,41,10477
318860,2015,5,64,34,98,10298
319050,2015,6,686,190,876,79925
319480,2015,8,700,66,766,67316
319570,2015,4,171,261,432,133765
319740,2015,6,240,81,321,20377
319780,2015,4,40,81,121,21582
319830,2015,6,669,174,843,332904
319910,2015,5,3158,1593,4751,392900
320090,2015,7,33,4,37,3307
320140,2015,8,1483,191,1674,136473
320300,2015,8,6925,653,7578,1631855
320340,2015,5,470,472,942,73558
320520,2015,6,75,30,105,15153
320540,2015,6,349,143,492,47118
320610,2015,6,94,27,121,7533
320820,2015,5,654,331,985,43631
321260,2015,5,415,344,759,75018
321330,2015,6,34,11,45,2494
321350,2015,5,16,8,24,1382
321360,2015,6,2390,902,3292,192523
321960,2015,5,1242,1501,2743,174672
322080,2015,6,58,19,77,7121
322210,2015,8,1347,84,1431,68968
322290,2015,8,442,37,479,49773
322440,2015,5,31,27,58,2052
322520,2015,5,490,280,770,58202
322550,2015,6,14,5,19,695
322680,2015,8,530,65,595,35901
322850,2015,5,184,128,312,46324
322900,2015,6,241,99,340,28793
322910,2015,6,1065,439,1504,129644
322920,2015,5,2059,1572,3631,207392
322950,2015,5,33,42,75,3458
322970,2015,5,120,80,200,36981
323040,2015,6,48,15,63,6467
323320,2015,8,3470,327,3797,330240
323380,2015,8,970,74,1044,56854
323450,2015,8,77,13,90,11800
323460,2015,8,248,43,291,38750
323470,2015,8,11590,1535,13125,824682
323580,2015,6,4478,1221,5699,1022556
323630,2015,8,163,12,175,10521
323680,2015,3,7,34,41,1669
323720,2015,6,634,219,853,63723
323900,2015,6,321,105,426,61673
324140,2015,8,182,9,191,15536
324160,2015,9,1568,23,1591,54869
324260,2015,6,421,170,591,43024
324390,2015,8,40,10,50,5299
324400,2015,5,8,10,18,1458
324470,2015,6,126,35,161,7688
324570,2015,8,427,89,516,69530
324710,2015,8,143,12,155,11032
324730,2015,6,19,7,26,4766
325060,2015,8,94,12,106,8338
325120,2015,8,414,58,472,12129
325520,2015,8,278,43,321,18812
325610,2015,6,10499,3484,13983,1331963
325630,2015,5,84,100,184,10190
325790,2015,4,79,121,200,17167
325880,2015,5,34,38,72,3911
326120,2015,8,208,49,257,126956
326340,2015,5,375,171,546,31007
326380,2015,7,33,7,40,3570
326410,2015,8,2048,497,2545,355878
326650,2015,3,6,39,45,1747
326670,2015,5,459,228,687,62016
326950,2015,6,229,86,315,48100
327500,2015,8,62,6,68,5448
327520,2015,6,54,16,70,4732
327640,2015,5,719,418,1137,200818
327670,2015,8,478,110,588,31449
327880,2015,8,378,46,424,21470
327890,2015,6,3567,999,4566,579156
327980,2015,7,16,1,17,3070
328060,2015,5,272,253,525,120018
328650,2015,5,8,5,13,1212
328710,2015,5,67,30,97,3554
328760,2015,8,1115,84,1199,94409
328940,2015,5,259,150,409,40667
329050,2015,8,3639,342,3981,299184
329130,2015,8,1902,135,2037,147501
329240,2015,6,55,17,72,11212
329380,2015,6,617,175,792,261792
329430,2015,6,3238,1036,4274,403911
329440,2015,5,810,478,1288,72200
329460,2015,8,350,34,384,45169
329490,2015,8,2030,372,2402,168948
329790,2015,5,171,100,271,105485
329860,2015,8,716,85,801,67022
330000,2015,5,66,58,124,25903
330180,2015,8,230,52,282,40046
330270,2015,5,162,101,263,24926
330370,2015,6,50,14,64,3878
330390,2015,8,955,92,1047,66929
330450,2015,6,23,7,30,7574
330660,2015,5,46,25,71,23683
330670,2015,7,28,3,31,4134
330820,2015,6,772,200,972,85060
331340,2015,5,99,91,190,20388
331460,2015,8,72,9,81,6967
331570,2015,6,28,8,36,7333
331600,2015,8,3887,785,4672,345720
331720,2015,6,113,30,143,16013
331760,2015,5,47,26,73,17491
331790,2015,5,88,57,145,328357
332200,2015,8,2738,150,2888,173768
332250,2015,8,158,38,196,13827
332330,2015,8,59,11,70,12553
332370,2015,7,9,1,10,488
332380,2015,8,63,10,73,4060
332390,2015,8,103,14,117,7124
332400,2015,8,117,16,133,6889
332530,2015,5,61,36,97,16888
332610,2015,8,122,14,136,4953
332620,2015,5,105,47,152,15196
332630,2015,7,28,5,33,1563
332730,2015,5,15,16,31,852
332790,2015,5,175,222,397,104603
332880,2015,7,20,3,23,1610
333210,2015,5,167,85,252,16431
333250,2015,8,1247,217,1464,67366
333290,2015,7,15,1,16,269
333300,2015,8,520,61,581,31818
333330,2015,6,57,15,72,11842
333390,2015,7,35,8,43,3275
333490,2015,7,24,4,28,6868
333510,2015,7,37,8,45,3322
333580,2015,7,14,2,16,970
333640,2015,9,1121,35,1156,57607
333650,2015,5,25,32,57,6733
333660,2015,5,61,43,104,9378
333730,2015,4,14,22,36,10754
333970,2015,6,74,26,100,14390
333980,2015,8,1875,262,2137,117269
334030,2015,5,175,93,268,81483
334070,2015,5,552,294,846,112315
334100,2015,7,21,3,24,1664
334140,2015,8,77,4,81,3267
334300,2015,8,105,18,123,97493
334420,2015,6,783,227,1010,61009
334560,2015,8,197,30,227,37263
334620,2015,6,29,10,39,7554
334690,2015,6,204,65,269,26497
334830,2015,6,31,11,42,1104
334840,2015,8,48,9,57,12689
334850,2015,5,71,31,102,11532
334960,2015,4,4,8,12,701
335000,2015,8,1586,97,1683,51834
335010,2015,6,37,10,47,7221
335070,2015,6,189,52,241,13437
335190,2015,8,223,47,270,24780
335200,2015,6,40,17,57,7311
335220,2015,5,18,10,28,15131
335240,2015,8,9364,1707,11071,2070157
335300,2015,8,20745,2973,23718,1453157
335450,2015,7,15,1,16,7154
335460,2015,8,51,10,61,19395
335560,2015,7,18,1,19,5932
335660,2015,5,83,45,128,13099
335690,2015,4,20,31,51,12064
335700,2015,5,130,61,191,18226
335830,2015,5,161,86,247,17685
335840,2015,6,108,34,142,22435
335920,2015,8,171,15,186,6733
336020,2015,5,24,29,53,5869
336040,2015,5,121,52,173,44922
336060,2015,6,190,58,248,16257
336080,2015,8,186,46,232,19949
336110,2015,8,89,19,108,12682
336150,2015,6,136,35,171,12181
336200,2015,5,31,18,49,17388
336250,2015,5,44,54,98,12637
336420,2015,6,293,76,369,73833
336710,2015,7,18,4,22,11167
336730,2015,6,18,5,23,10542
336840,2015,7,21,3,24,1041
337070,2015,5,234,109,343,9544
337110,2015,5,31,32,63,5335
337180,2015,5,48,28,76,10776
337210,2015,5,82,52,134,8611
337220,2015,5,35,38,73,5478
337270,2015,8,180,29,209,17032
337280,2015,6,45,16,61,2581
337350,2015,8,156,7,163,6077
337480,2015,6,164,43,207,21407
337670,2015,7,32,1,33,3313
337680,2015,6,82,24,106,14447
337700,2015,5,17,8,25,727
337850,2015,8,112,19,131,22270
337960,2015,8,72,17,89,9847
337970,2015,5,8,5,13,5765
337980,2015,6,75,24,99,6578
338000,2015,8,687,58,745,132342
338050,2015,5,234,117,351,93178
338120,2015,5,132,61,193,26025
338180,2015,5,1408,953,2361,445267
338190,2015,8,164,19,183,16676
338320,2015,6,271,71,342,59406
338420,2015,5,79,37,116,10229
338530,2015,5,154,106,260,274955
338630,2015,5,16,8,24,2873
338890,2015,6,37,13,50,1809
338980,2015,6,90,25,115,14158
339130,2015,8,326,23,349,22482
339160,2015,8,254,48,302,48498
339190,2015,8,462,81,543,34506
339200,2015,8,1136,278,1414,123228
339210,2015,5,94,68,162,22945
339230,2015,5,878,485,1363,73556
339280,2015,6,3346,1048,4394,884685
339290,2015,5,152,78,230,41169
339400,2015,8,1847,315,2162,129309
339460,2015,7,27,4,31,6090
339500,2015,4,3,9,12,3115
339570,2015,8,106,18,124,5548
339600,2015,5,1241,1150,2391,359362
339640,2015,5,72,58,130,8121
339690,2015,7,22,3,25,5339
339700,2015,5,84,51,135,10839
339790,2015,8,263,40,303,32933
339800,2015,9,14868,549,15417,855769
339860,2015,3,7,32,39,45167
339910,2015,8,324,54,378,17727
340050,2015,6,1405,362,1767,173540
340070,2015,5,363,348,711,125900
340170,2015,5,1346,853,2199,164421
340220,2015,4,45,86,131,29819
340250,2015,7,14,1,15,4373
340270,2015,5,310,151,461,25027
340280,2015,8,226,19,245,26528
340320,2015,6,118,49,167,43837
340330,2015,6,16,5,21,5249
340340,2015,8,347,83,430,27311
340360,2015,8,191,30,221,19415
340370,2015,7,10,1,11,300
340380,2015,7,10,2,12,253
340390,2015,7,31,5,36,2885
340450,2015,6,34,11,45,4460
340460,2015,5,302,375,677,71462
340470,2015,5,74,47,121,22219
340480,2015,5,11,6,17,580
340520,2015,8,517,36,553,29519
340600,2015,7,20,4,24,2067
340630,2015,4,34,106,140,4966
340650,2015,5,66,67,133,318054
340720,2015,7,24,3,27,3522
340730,2015,8,699,120,819,78222
340750,2015,5,15,17,32,8466
340830,2015,8,321,65,386,41903
340880,2015,7,21,3,24,986
340960,2015,7,36,6,42,876
341020,2015,6,160,61,221,13320
341030,2015,5,111,71,182,11965
341090,2015,8,188,25,213,36714
341120,2015,8,213,23,236,34233
341150,2015,8,184,22,206,14837
341310,2015,6,1036,366,1402,256746
341360,2015,5,8,7,15,1114
341440,2015,5,36,46,82,3403
341470,2015,6,57,24,81,7733
341500,2015,6,1017,375,1392,264412
341510,2015,7,33,8,41,9708
341530,2015,8,69,17,86,26883
341550,2015,8,347,35,382,26893
341680,2015,8,50,8,58,5581
341690,2015,5,35,16,51,4521
341730,2015,8,266,50,316,27992
341750,2015,5,10,7,17,938
341760,2015,7,15,1,16,828
341780,2015,5,27,19,46,44421
341800,2015,9,4538,78,4616,836026
341820,2015,8,55,10,65,3445
341860,2015,5,110,83,193,29061
341870,2015,6,296,98,394,30643
341930,2015,5,34,32,66,4693
341940,2015,6,4528,1305,5833,240088
341950,2015,6,150,44,194,27616
342020,2015,5,79,55,134,21325
342090,2015,4,20,35,55,12807
342100,2015,7,28,5,33,2078
342200,2015,6,3761,1188,4949,787170
342240,2015,5,12,10,22,9735
342260,2015,6,213,65,278,20728
342280,2015,8,97,14,111,6009
342300,2015,8,606,50,656,54495
342350,2015,8,122,28,150,12851
342450,2015,5,38,40,78,3197
342490,2015,8,134,29,163,6681
342500,2015,4,13,23,36,5481
342520,2015,4,16,54,70,2230
342530,2015,8,60,9,69,2875
342570,2015,4,176,273,449,104751
342580,2015,8,2198,141,2339,163052
342610,2015,8,174,15,189,15290
342620,2015,8,334,64,398,49201
342650,2015,6,28,12,40,11135
342870,2015,4,22,36,58,1296
342920,2015,7,35,2,37,2946
343020,2015,7,9,1,10,4973
343070,2015,5,100,80,180,10027
343090,2015,8,205,29,234,29741
343100,2015,6,796,212,1008,122039
343170,2015,5,20,21,41,5845
343280,2015,5,106,63,169,62971
343340,2015,4,35,59,94,29598
343370,2015,8,88,5,93,4612
343430,2015,7,16,4,20,764
343440,2015,8,513,87,600,69406
343560,2015,8,315,39,354,40072
343570,2015,7,23,2,25,676
343710,2015,5,1507,681,2188,191890
343780,2015,8,1513,132,1645,136685
343930,2015,6,131,54,185,47698
344130,2015,6,205,86,291,129283
344190,2015,6,169,67,236,55658
344230,2015,6,147,41,188,86402
344270,2015,7,13,3,16,1380
344300,2015,5,141,76,217,140919
344340,2015,8,101,22,123,9338
344410,2015,6,165,68,233,16474
344480,2015,8,173,2,175,9334
344500,2015,5,95,57,152,14507
344770,2015,9,1564,29,1593,50759
344840,2015,5,98,127,225,19612
344850,2015,6,932,294,1226,227897
344860,2015,8,190,13,203,14530
344880,2015,5,47,26,73,18139
344890,2015,5,24,21,45,2040
344910,2015,5,349,205,554,139973
344960,2015,7,9,2,11,204
345060,2015,8,142,33,175,18427
345080,2015,6,97,36,133,14214
345090,2015,8,279,66,345,33457
345120,2015,8,334,42,376,47724
345180,2015,8,3812,482,4294,453908
345200,2015,8,252,26,278,30997
345220,2015,5,397,228,625,185890
345340,2015,6,14,4,18,1723
345350,2015,8,1894,458,2352,232259
345390,2015,8,1593,204,1797,166533
345540,2015,6,81,21,102,9839
345640,2015,5,40,30,70,4810
345660,2015,6,933,325,1258,64247
345710,2015,4,17,49,66,2026
345750,2015,5,49,55,104,11727
345820,2015,8,1276,77,1353,136580
345860,2015,8,168,32,200,25940
346040,2015,4,56,99,155,12234
346090,2015,7,40,4,44,4236
346120,2015,8,2946,508,3454,670347
346180,2015,6,526,142,668,60869
346210,2015,6,79,23,102,136398
346340,2015,6,22,6,28,2422
346370,2015,4,110,371,481,11702
346420,2015,6,193,64,257,28907
346440,2015,6,21,8,29,1859
346450,2015,5,52,26,78,4219
346470,2015,8,279,22,301,23400
346490,2015,5,4,6,10,945
346510,2015,7,30,3,33,2254
346560,2015,8,1214,72,1286,79286
346630,2015,6,253,73,326,95478
346670,2015,4,8,17,25,784
346730,2015,8,756,86,842,40686
346770,2015,8,49,5,54,1587
346780,2015,8,47,4,51,49325
346800,2015,4,23,43,66,1655
346810,2015,8,414,81,495,52321
346830,2015,5,147,85,232,31223
346850,2015,8,283,25,308,35574
346940,2015,8,1973,319,2292,268438
347040,2015,7,40,9,49,15727
347160,2015,8,522,71,593,50672
347400,2015,6,84,22,106,5743
347430,2015,8,1357,247,1604,162472
347440,2015,6,109,43,152,10283
347470,2015,8,52,3,55,2494
347480,2015,5,5,7,12,535
347510,2015,8,222,26,248,34565
347520,2015,7,36,4,40,3831
347560,2015,5,616,289,905,433639
347670,2015,8,365,68,433,18440
347690,2015,5,33,16,49,2100
347710,2015,6,96,27,123,7296
347730,2015,7,34,3,37,2553
347790,2015,6,31,8,39,2448
347830,2015,8,1854,181,2035,136968
348180,2015,5,32,22,54,10323
348200,2015,8,209,32,241,12031
348240,2015,8,168,26,194,10909
348270,2015,5,54,48,102,4606
348280,2015,7,18,4,22,537
348300,2015,8,51,7,58,12364
348340,2015,6,88,35,123,13472
348360,2015,6,402,128,530,60790
348400,2015,5,46,27,73,6943
348430,2015,8,55,1,56,3529
348440,2015,8,72,4,76,3692
348470,2015,6,672,187,859,50954
348490,2015,8,117,27,144,10695
348510,2015,4,156,269,425,40098
348530,2015,5,14,18,32,27165
348540,2015,5,157,72,229,107164
348550,2015,8,588,51,639,98108
348650,2015,4,19,47,66,7177
348700,2015,5,64,42,106,25656
348710,2015,8,1391,130,1521,54545
348730,2015,5,49,69,118,46141
348820,2015,8,164,14,178,15378
348840,2015,7,12,1,13,3912
348980,2015,4,3,11,14,1391
349020,2015,5,27,13,40,6716
349140,2015,6,96,41,137,18778
349190,2015,6,23,9,32,1237
349220,2015,8,414,40,454,37979
349260,2015,5,48,26,74,14958
349460,2015,5,13,8,21,18637
349530,2015,6,19,8,27,1123
349540,2015,4,18,28,46,6477
349550,2015,5,42,27,69,7359
349680,2015,8,195,8,203,16903
349690,2015,7,32,1,33,3790
349760,2015,8,71,1,72,11438
349840,2015,5,19,16,35,3378
349950,2015,4,17,43,60,12773
350010,2015,5,219,268,487,45350
350020,2015,5,128,73,201,36405
350080,2015,8,5425,703,6128,600610
350210,2015,7,34,6,40,2381
350310,2015,5,157,106,263,13303
350490,2015,4,10,17,27,1177
350530,2015,4,49,81,130,18393
350610,2015,7,30,3,33,1698
350620,2015,8,44,7,51,4059
350630,2015,6,53,17,70,5987
350770,2015,5,77,37,114,6074
350780,2015,6,107,30,137,6040
350810,2015,6,533,171,704,157568
350970,2015,8,249,56,305,16926
351050,2015,5,36,17,53,9298
351090,2015,8,320,18,338,28359
351140,2015,5,190,152,342,147269
351150,2015,5,333,150,483,97066
351230,2015,8,108,13,121,6646
351240,2015,7,34,5,39,6241
351250,2015,8,150,24,174,31172
351300,2015,5,67,49,116,7021
351340,2015,6,395,133,528,26335
351400,2015,5,36,36,72,28342
351450,2015,5,60,38,98,11212
351480,2015,8,241,16,257,15054
351490,2015,8,811,184,995,173820
351710,2015,8,1979,153,2132,131949
351800,2015,6,1275,320,1595,141778
351910,2015,5,378,342,720,103074
351970,2015,8,4844,834,5678,410109
352010,2015,5,192,89,281,34686
352070,2015,8,122,9,131,11484
352210,2015,7,15,3,18,1347
352220,2015,8,184,43,227,41509
352400,2015,8,2053,339,2392,343167
352520,2015,8,4018,253,4271,138573
352580,2015,6,44,17,61,4396
352610,2015,8,97,9,106,5853
352620,2015,8,78,14,92,13644
352740,2015,5,11,5,16,916
352760,2015,6,17,6,23,3905
352780,2015,8,176,23,199,9782
352850,2015,5,16,16,32,1914
352900,2015,5,22,21,43,11346
352960,2015,5,68,47,115,9363
353090,2015,8,350,10,360,25441
353330,2015,9,705,37,742,18697
353340,2015,6,19,5,24,695
353550,2015,5,340,164,504,94279
353640,2015,8,1293,153,1446,161824
353940,2015,6,40,15,55,2450
354030,2015,5,25,11,36,9179
354040,2015,7,22,3,25,15585
354050,2015,5,12,9,21,1436
354160,2015,5,225,200,425,36749
354180,2015,5,38,21,59,8943
354200,2015,5,629,412,1041,116828
354230,2015,6,23,7,30,2106
354240,2015,8,2041,338,2379,226838
354650,2015,8,510,93,603,12777
354770,2015,7,18,2,20,686
354930,2015,5,10,7,17,7465
354950,2015,6,45,14,59,8832
354970,2015,5,48,28,76,4047
355050,2015,8,824,76,900,40265
355080,2015,4,6,10,16,2945
355100,2015,5,30,25,55,7749
355130,2015,6,274,89,363,40514
355240,2015,6,144,43,187,19679
355270,2015,8,167,36,203,3816
355410,2015,8,110,22,132,42936
355520,2015,6,230,70,300,56917
355530,2015,8,242,45,287,31002
355630,2015,8,185,15,200,10581
355840,2015,5,8320,7995,16315,2337644
355860,2015,6,221,72,293,15560
355910,2015,7,17,3,20,984
355970,2015,6,307,95,402,20436
355980,2015,9,755,20,775,45531
356000,2015,6,76,22,98,6189
356050,2015,5,575,276,851,46737
356070,2015,8,890,118,1008,19124
356090,2015,7,25,1,26,834
356100,2015,7,40,5,45,2360
356110,2015,7,12,1,13,397
356130,2015,5,307,296,603,176643
356170,2015,7,11,2,13,1366
356310,2015,5,654,668,1322,266981
356420,2015,8,240,38,278,63199
356510,2015,8,557,105,662,4208
356520,2015,8,848,98,946,48284
356530,2015,8,131,15,146,10752
356540,2015,6,19,8,27,6543
356550,2015,6,16,5,21,3253
356560,2015,7,19,4,23,3282
356570,2015,8,4056,566,4622,367745
356790,2015,8,52,7,59,12368
356800,2015,5,9,10,19,1588
356890,2015,6,102,36,138,14833
356910,2015,5,59,27,86,11480
357070,2015,8,1525,158,1683,110025
357200,2015,4,16,37,53,24960
357280,2015,5,314,143,457,112559
357300,2015,8,557,40,597,47703
357320,2015,5,26,18,44,1045
357480,2015,5,1024,741,1765,139766
357600,2015,8,243,12,255,23419
357690,2015,6,24,9,33,747
357720,2015,8,303,34,337,15660
357750,2015,7,17,2,19,506
357780,2015,8,689,157,846,117960
357830,2015,5,24,13,37,4016
357840,2015,5,27,16,43,1270
357890,2015,8,48,4,52,3453
357900,2015,5,499,601,1100,306739
358030,2015,7,25,1,26,993
358070,2015,8,92,6,98,10071
358090,2015,8,1198,259,1457,69125
358650,2015,8,148,22,170,19267
358810,2015,8,84,15,99,6669
358960,2015,8,154,26,180,20642
359050,2015,9,7202,365,7567,401903
359060,2015,4,28,46,74,12124
359190,2015,5,122,69,191,9711
359230,2015,6,506,206,712,46328
359250,2015,5,42,19,61,19479
359260,2015,5,13,9,22,17674
359280,2015,5,45,20,65,8988
359310,2015,8,2510,366,2876,231468
359390,2015,8,1537,92,1629,85901
359400,2015,8,217,10,227,7355
359450,2015,5,12,7,19,2707
359560,2015,6,127,35,162,12473
359580,2015,5,244,148,392,57964
359670,2015,5,9,5,14,3383
359810,2015,5,221,97,318,34300
359900,2015,5,357,262,619,61729
359920,2015,8,169,34,203,11350
359960,2015,5,122,58,180,56825
360010,2015,8,55,10,65,22000
360030,2015,5,16,7,23,2619
360150,2015,5,564,462,1026,94526
360380,2015,5,525,261,786,203135
360390,2015,5,47,35,82,22310
360450,2015,8,122,29,151,14939
360550,2015,8,128,17,145,3693
360580,2015,5,18,20,38,1840
360590,2015,2,14,96,110,13044
360640,2015,8,1513,153,1666,177179
360650,2015,8,646,97,743,111056
360730,2015,6,417,175,592,65569
360740,2015,9,3763,115,3878,287413
360840,2015,8,90,10,100,8176
360870,2015,8,964,190,1154,150511
360940,2015,6,1946,665,2611,169424
361130,2015,5,28,18,46,3042
361160,2015,7,9,2,11,4619
361190,2015,5,252,149,401,110421
361200,2015,5,43,37,80,9409
361360,2015,8,90,12,102,6525
361430,2015,5,18,14,32,2033
361550,2015,6,830,312,1142,35377
361560,2015,4,9,31,40,1159
361630,2015,8,1057,193,1250,146246
361950,2015,7,25,6,31,3487
361990,2015,8,716,64,780,91287
362090,2015,8,180,23,203,18243
362290,2015,8,42,8,50,8764
362410,2015,5,102,50,152,17465
362610,2015,5,104,118,222,164487
362660,2015,5,77,40,117,27355
362680,2015,9,3905,148,4053,186371
362810,2015,8,203,39,242,15647
362830,2015,4,19,32,51,4326
362860,2015,8,68,14,82,4625
363130,2015,5,686,344,1030,37898
363180,2015,6,18,7,25,2721
363240,2015,6,44,16,60,11489
363330,2015,8,359,47,406,46314
363410,2015,6,149,47,196,14231
363430,2015,5,21,31,52,3109
363440,2015,8,1157,275,1432,134259
363460,2015,8,312,54,366,22595
363500,2015,7,25,3,28,1294
363510,2015,5,38,41,79,25664
363580,2015,7,15,3,18,6476
363600,2015,6,903,309,1212,154592
363620,2015,5,419,185,604,92562
363650,2015,5,23,22,45,2652
363790,2015,6,365,99,464,31654
363940,2015,5,31,34,65,9143
363960,2015,4,25,42,67,3700
363980,2015,8,203,34,237,13357
364060,2015,6,21,9,30,2628
364100,2015,6,15,6,21,1069
364130,2015,5,12,7,19,761
364250,2015,7,26,4,30,3123
364350,2015,5,22,16,38,8624
364640,2015,5,196,88,284,22072
364690,2015,4,384,630,1014,144865
364770,2015,7,36,8,44,6045
364790,2015,6,11,3,14,3211
364840,2015,7,23,3,26,2049
364900,2015,4,6,21,27,4511
364930,2015,8,654,47,701,39150
365020,2015,5,279,151,430,17477
365060,2015,7,12,3,15,353
365070,2015,5,450,331,781,66097
365090,2015,7,22,2,24,985
365120,2015,6,52,18,70,5812
365150,2015,5,16,18,34,863
365210,2015,8,65,7,72,4637
365260,2015,8,56,11,67,8090
365280,2015,5,26,23,49,4212
365320,2015,5,71,32,103,2854
365330,2015,5,33,23,56,3223
365340,2015,5,13,14,27,996
365350,2015,8,81,12,93,6309
365450,2015,8,9070,617,9687,877129
365480,2015,5,40,23,63,8987
365500,2015,7,28,4,32,1173
365560,2015,5,66,34,100,7905
365680,2015,5,43,21,64,10880
365760,2015,6,37,14,51,2207
365770,2015,6,410,112,522,82652
365800,2015,5,47,28,75,9022
365860,2015,8,41,10,51,7185
365870,2015,8,74,7,81,4759
365880,2015,6,68,25,93,7992
365900,2015,8,162,17,179,13983
365960,2015,8,763,158,921,75347
366040,2015,8,132,21,153,13305
366210,2015,7,38,7,45,10724
366250,2015,8,966,100,1066,156631
366350,2015,5,11,14,25,779
366510,2015,6,59,23,82,3684
366590,2015,7,25,1,26,1584
366600,2015,5,4,6,10,2252
366860,2015,5,22,11,33,1128
366970,2015,8,188,13,201,12843
367000,2015,8,314,42,356,26547
367030,2015,5,34,15,49,3144
367050,2015,7,10,1,11,324
367110,2015,6,75,23,98,4390
367120,2015,8,1483,237,1720,167485
367260,2015,7,24,6,30,2050
367300,2015,8,93,13,106,14846
367350,2015,8,45,9,54,9988
367430,2015,7,40,3,43,4841
367570,2015,8,709,62,771,40351
367580,2015,9,5799,166,5965,168568
367700,2015,4,13,52,65,3819
367710,2015,5,42,38,80,2290
367780,2015,5,55,36,91,9665
367800,2015,6,7,3,10,442
367990,2015,4,4,15,19,913
368050,2015,6,76,23,99,9023
368140,2015,7,40,9,49,3603
368230,2015,8,7672,1006,8678,1120501
368250,2015,7,23,5,28,3908
368290,2015,5,40,21,61,5513
368310,2015,7,9,2,11,1182
368360,2015,6,3870,1111,4981,578493
368370,2015,8,4432,482,4914,305686
368450,2015,5,107,73,180,8682
368590,2015,5,325,160,485,103455
368610,2015,8,213,17,230,18451
368650,2015,8,500,41,541,37880
368690,2015,5,7,7,14,729
368700,2015,7,15,3,18,5826
368710,2015,6,46,19,65,28945
368720,2015,5,99,71,170,41241
368730,2015,6,1323,337,1660,360564
368760,2015,5,14,13,27,2157
368770,2015,5,19,16,35,3958
368780,2015,5,21,19,40,4960
368830,2015,8,68,12,80,6664
368890,2015,8,81,5,86,5003
368950,2015,8,1442,97,1539,107768
368970,2015,5,17,8,25,28368
368980,2015,5,43,37,80,6567
369000,2015,5,296,128,424,45686
369060,2015,4,11,22,33,7128
369180,2015,5,39,44,83,5238
369290,2015,8,167,38,205,22320
369310,2015,7,17,1,18,7528
369360,2015,4,11,24,35,15153
369400,2015,6,707,206,913,137568
369420,2015,8,397,29,426,34059
369570,2015,6,29,10,39,937
369580,2015,8,2287,323,2610,90470
369890,2015,6,112,42,154,21388
370020,2015,9,608,30,638,33996
370050,2015,7,35,2,37,29200
370070,2015,8,124,28,152,22616
370080,2015,7,42,5,47,2636
370090,2015,5,239,105,344,69101
370150,2015,8,85,3,88,5119
370170,2015,5,14,9,23,32197
370220,2015,5,18,27,45,1219
370240,2015,5,3504,3436,6940,469791
370300,2015,8,56,11,67,11092
370360,2015,9,2216,76,2292,235754
370460,2015,8,232,33,265,40038
370480,2015,8,92,8,100,9170
370550,2015,8,71,8,79,10378
370590,2015,5,33,21,54,15145
370600,2015,5,24,27,51,1203
370640,2015,5,21,12,33,3847
370920,2015,8,78,13,91,8291
371000,2015,5,21,21,42,9091
371100,2015,8,128,22,150,17787
371120,2015,5,51,33,84,7703
371180,2015,8,423,47,470,34774
371220,2015,5,49,43,92,6791
371280,2015,5,12,9,21,2629
371300,2015,8,109,26,135,9793
371320,2015,7,20,1,21,3577
371330,2015,6,227,80,307,150672
371410,2015,5,8,11,19,4868
371420,2015,6,534,160,694,92319
371450,2015,6,143,42,185,18264
371460,2015,6,61,26,87,52886
371500,2015,8,345,38,383,16916
371530,2015,7,18,1,19,846
371550,2015,6,126,32,158,15551
371570,2015,6,770,252,1022,154692
371890,2015,6,81,28,109,10250
371900,2015,5,27,13,40,25675
371970,2015,8,923,112,1035,96949
372150,2015,4,8,25,33,6688
372250,2015,7,24,5,29,1901
372380,2015,6,44,17,61,2777
372740,2015,4,14,32,46,5450
372780,2015,5,27,20,47,2070
372800,2015,6,1530,396,1926,368618
372820,2015,5,69,76,145,29213
372830,2015,8,81,18,99,8899
372930,2015,8,117,13,130,10774
372940,2015,8,155,5,160,10456
372960,2015,7,19,1,20,1470
372970,2015,7,30,7,37,2957
373290,2015,5,38,33,71,32468
373360,2015,5,86,47,133,19151
373390,2015,9,1454,49,1503,24239
373420,2015,8,8398,866,9264,1501547
373600,2015,7,39,4,43,7751
373610,2015,8,60,13,73,8356
373620,2015,7,32,7,39,10994
373630,2015,7,23,5,28,5732
373970,2015,8,242,23,265,42227
374060,2015,6,136,44,180,8898
374410,2015,8,209,11,220,18734
374640,2015,4,24,45,69,3663
374680,2015,5,8,4,12,285
374830,2015,6,199,50,249,71784
374950,2015,5,37,46,83,4981
374990,2015,5,5,5,10,399
375000,2015,5,7,4,11,2467
375010,2015,5,140,63,203,223594
375030,2015,6,147,37,184,5971
375040,2015,5,24,17,41,6906
375120,2015,8,159,30,189,15551
375130,2015,8,209,9,218,10854
375170,2015,6,26,7,33,4909
375290,2015,6,18,6,24,13579
375320,2015,5,40,28,68,39391
375330,2015,5,27,27,54,3871
375420,2015,5,18,9,27,7592
375430,2015,5,6,4,10,3169
375460,2015,4,500,762,1262,174632
375520,2015,6,106,27,133,50494
375600,2015,6,617,233,850,146974
375710,2015,5,219,124,343,41204
375770,2015,5,25,11,36,12680
375790,2015,5,13,8,21,6094
375820,2015,8,1842,119,1961,211410
375840,2015,8,174,27,201,26825
375850,2015,5,40,39,79,74862
375910,2015,5,1752,1067,2819,200623
375950,2015,8,4856,494,5350,587504
376150,2015,4,13,30,43,1508
376300,2015,8,1761,134,1895,136267
376560,2015,8,77,14,91,5536
376680,2015,6,70,29,99,11482
376870,2015,6,5121,1664,6785,346763
377070,2015,7,21,3,24,3170
377080,2015,8,260,20,280,26704
377190,2015,7,31,7,38,8326
377200,2015,7,11,1,12,647
377280,2015,6,17,5,22,1235
377310,2015,5,143,105,248,342253
377330,2015,8,566,74,640,74268
377450,2015,8,68,2,70,8444
377470,2015,5,75,44,119,10804
377550,2015,6,18,5,23,969
377860,2015,9,699,21,720,41705
377870,2015,8,338,56,394,27685
377900,2015,6,459,148,607,65176
377970,2015,5,137,59,196,12001
378030,2015,7,39,5,44,1890
378080,2015,8,56,12,68,11922
378100,2015,5,228,268,496,207618
378270,2015,5,222,109,331,103963
378280,2015,5,19,20,39,971
378370,2015,5,1712,1120,2832,371579
378630,2015,6,41,13,54,3066
378660,2015,5,792,419,1211,35018
378720,2015,8,2237,204,2441,176523
378750,2015,8,91,5,96,9605
378770,2015,8,70,4,74,4448
378830,2015,5,25,14,39,6074
378850,2015,8,56,10,66,1798
379290,2015,5,58,60,118,39922
379320,2015,6,66,18,84,30416
379340,2015,5,5,5,10,222
379390,2015,7,11,2,13,550
379520,2015,7,27,4,31,2828
379530,2015,8,84,21,105,12085
379640,2015,8,197,18,215,13614
379760,2015,7,42,6,48,1112
379990,2015,4,12,31,43,6901
380020,2015,5,509,220,729,122540
380150,2015,8,830,179,1009,47422
380210,2015,5,12,9,21,3776
380360,2015,6,578,202,780,197435
380540,2015,5,23,17,40,1089
380550,2015,5,46,27,73,30753
380560,2015,5,14,8,22,1375
380690,2015,5,12,11,23,6212
380700,2015,5,23,16,39,9629
380990,2015,5,17,16,33,1157
381050,2015,6,42,17,59,1651
381090,2015,5,26,21,47,2223
381100,2015,8,194,37,231,12945
381130,2015,4,10,29,39,623
381140,2015,5,164,73,237,32780
381170,2015,5,29,28,57,23756
381220,2015,5,35,28,63,9844
381260,2015,5,101,45,146,9754
381560,2015,5,327,333,660,72142
381610,2015,7,29,7,36,6413
381780,2015,8,930,90,1020,92477
381850,2015,5,20,11,31,1206
381870,2015,8,82,13,95,27725
381900,2015,8,72,16,88,7050
381910,2015,6,19,5,24,2390
381990,2015,6,522,219,741,215886
382070,2015,6,54,18,72,6820
382080,2015,5,116,112,228,62752
382130,2015,6,30,11,41,1711
382140,2015,6,768,261,1029,71382
382160,2015,4,19,52,71,5663
382180,2015,6,38,16,54,2693
382270,2015,7,12,1,13,549
382300,2015,5,262,202,464,96909
382490,2015,8,4808,287,5095,884002
382890,2015,6,420,156,576,55096
382900,2015,6,750,213,963,103271
382920,2015,8,53,11,64,6684
383240,2015,5,11,14,25,3625
383330,2015,5,144,87,231,311967
383460,2015,8,211,23,234,22763
383540,2015,6,19,6,25,1856
383630,2015,6,31,12,43,4476
383670,2015,6,24,8,32,5421
383690,2015,8,117,18,135,8330
383700,2015,6,33,12,45,2575
383710,2015,4,16,26,42,8497
383720,2015,5,43,20,63,9081
383750,2015,6,51,17,68,6858
383950,2015,6,30,11,41,2699
384000,2015,6,218,72,290,12762
384010,2015,6,23,9,32,3691
384110,2015,8,632,92,724,64735
384120,2015,5,29,14,43,3926
384210,2015,5,8,5,13,1617
384280,2015,8,104,9,113,2868
384300,2015,6,5244,1782,7026,272887
384310,2015,6,241,70,311,29571
384320,2015,5,35,33,68,4533
384360,2015,6,512,162,674,66008
384590,2015,7,20,1,21,616
384630,2015,9,929,47,976,71175
384680,2015,8,354,28,382,20887
384690,2015,8,57,1,58,8179
384700,2015,6,19,5,24,5235
384890,2015,7,18,3,21,1875
384920,2015,4,11,33,44,191
384990,2015,6,62,16,78,8752
385060,2015,7,29,4,33,1485
385070,2015,6,170,67,237,310592
385250,2015,8,323,5,328,11841
385360,2015,5,46,34,80,11067
385440,2015,6,34,10,44,2489
385490,2015,5,59,52,111,21051
385590,2015,6,121,35,156,8988
385600,2015,5,18,25,43,5010
385690,2015,7,31,1,32,2743
385710,2015,8,1115,231,1346,114325
385770,2015,8,3353,418,3771,826505
385800,2015,8,9810,633,10443,565127
385830,2015,5,249,312,561,89348
385860,2015,5,26,13,39,7894
385890,2015,5,210,266,476,121739
385960,2015,3,2,12,14,827
386070,2015,8,4386,1050,5436,569681
386110,2015,3,6,35,41,31960
386160,2015,6,51,19,70,17304
386280,2015,5,105,93,198,7127
386290,2015,6,51,16,67,6532
386330,2015,3,2,14,16,707
386350,2015,6,55,19,74,7009
386400,2015,6,57,18,75,5362
386420,2015,6,119,30,149,34234
386480,2015,6,830,299,1129,42735
386510,2015,5,85,61,146,61080
386520,2015,8,131,17,148,9949
386540,2015,4,21,39,60,8005
386560,2015,8,96,10,106,4071
386590,2015,6,525,225,750,58812
386640,2015,5,112,91,203,24927
386700,2015,6,104,42,146,23181
386840,2015,7,34,4,38,5918
386870,2015,5,47,33,80,4283
386900,2015,8,101,7,108,5335
386990,2015,6,137,49,186,13779
387010,2015,5,91,41,132,12355
387060,2015,8,96,20,116,19096
387070,2015,2,17,81,98,8665
387240,2015,8,75,10,85,10440
387270,2015,5,10,5,15,1018
387430,2015,5,20,9,29,2434
387840,2015,8,268,65,333,58034
387850,2015,6,46,14,60,12250
387870,2015,8,89,21,110,9626
387930,2015,5,152,125,277,92279
387970,2015,5,402,460,862,143286
388050,2015,5,44,35,79,124050
388060,2015,5,284,159,443,99503
388080,2015,8,897,188,1085,36755
388260,2015,7,25,4,29,1689
388360,2015,6,49,21,70,5591
388410,2015,6,4015,1284,5299,560050
388420,2015,8,239,26,265,45498
388430,2015,6,50,16,66,3261
388440,2015,5,15,16,31,12226
388450,2015,8,77,3,80,2932
388490,2015,5,168,134,302,53036
388500,2015,4,5,17,22,5511
388620,2015,8,248,43,291,26669
388720,2015,7,39,9,48,2083
388800,2015,8,629,102,731,40371
388970,2015,8,91,17,108,6609
389310,2015,5,43,21,64,9273
389400,2015,6,83,21,104,117046
389650,2015,8,119,6,125,8855
389740,2015,4,7,25,32,1491
389810,2015,5,39,42,81,31443
389840,2015,5,35,27,62,2821
389850,2015,8,68,5,73,6532
389870,2015,5,156,69,225,20939
390200,2015,5,97,53,150,21880
390210,2015,5,44,21,65,2632
390290,2015,8,436,45,481,33682
390520,2015,8,865,109,974,54274
390570,2015,5,53,61,114,145725
390610,2015,8,174,9,183,10150
390670,2015,5,2590,1116,3706,661286
390870,2015,5,34,24,58,8414
390890,2015,8,106,7,113,6204
390920,2015,7,35,5,40,4080
391100,2015,5,9,6,15,692
391170,2015,8,254,32,286,24917
391180,2015,6,26,9,35,8607
391210,2015,7,18,4,22,6689
391250,2015,8,76,8,84,2925
391260,2015,6,700,253,953,259225
391340,2015,5,36,50,86,16546
391390,2015,7,26,2,28,5494
391490,2015,8,143,21,164,14024
391630,2015,5,18,14,32,3995
391660,2015,5,65,30,95,281562
391960,2015,6,14,4,18,7495
392020,2015,8,141,10,151,7109
392070,2015,8,105,19,124,9281
392450,2015,8,445,60,505,42391
392600,2015,7,24,1,25,1725
392620,2015,7,13,3,16,671
392720,2015,7,11,1,12,83
392780,2015,5,16,7,23,10102
392820,2015,5,125,128,253,65781
392940,2015,8,105,21,126,8796
392950,2015,8,3466,379,3845,111305
393150,2015,6,48,15,63,23356
393240,2015,5,13,9,22,2530
393600,2015,6,14,6,20,3828
393610,2015,8,80,16,96,5801
393920,2015,5,84,75,159,12237
393980,2015,6,405,130,535,29924
394140,2015,8,67,14,81,84569
394220,2015,8,94,20,114,9049
394280,2015,5,108,76,184,25140
394290,2015,8,71,5,76,7511
394390,2015,7,16,2,18,440
394450,2015,5,324,177,501,31231
394510,2015,8,11171,970,12141,972013
394550,2015,8,63,7,70,2741
394600,2015,6,126,45,171,13415
394770,2015,5,14,21,35,2083
394870,2015,6,477,196,673,119891
395140,2015,8,67,8,75,13082
395160,2015,6,299,127,426,24453
395170,2015,8,3946,258,4204,176148
395200,2015,6,899,258,1157,121232
395400,2015,5,14,17,31,5700
395420,2015,6,82,30,112,16767
395520,2015,8,2211,289,2500,284121
395580,2015,7,14,2,16,712
395860,2015,8,137,27,164,13040
395900,2015,5,57,33,90,7538
395920,2015,5,18,10,28,2149
396030,2015,5,141,66,207,49900
396090,2015,6,145,48,193,15478
396160,2015,5,278,310,588,203725
396230,2015,8,135,26,161,5886
396790,2015,6,427,117,544,92056
396800,2015,8,269,37,306,31102
396850,2015,5,26,39,65,39122
396860,2015,8,133,22,155,4524
396930,2015,6,13,5,18,660
397200,2015,4,9,14,23,805
397240,2015,5,7,4,11,413
397270,2015,8,843,57,900,43213
397330,2015,8,89,14,103,9043
397340,2015,8,3862,361,4223,314932
397400,2015,7,15,1,16,459
397460,2015,8,452,24,476,299913
397500,2015,6,363,107,470,195993
397570,2015,8,154,32,186,21358
397580,2015,4,31,73,104,19168
397690,2015,8,273,59,332,17786
397780,2015,8,87,16,103,5915
397940,2015,6,80,24,104,66074
397960,2015,7,8,2,10,684
397970,2015,6,16,5,21,1361
397990,2015,8,73,14,87,7931
398020,2015,5,10,9,19,377
398100,2015,8,356,84,440,34077
398110,2015,5,10,11,21,1962
398180,2015,5,136,62,198,14748
398450,2015,8,182,44,226,31425
398460,2015,8,109,9,118,2744
398480,2015,5,7,4,11,1821
398530,2015,5,10,7,17,449
398710,2015,8,4499,288,4787,352371
398830,2015,5,7,5,12,31527
398940,2015,7,26,3,29,4561
398960,2015,6,17,6,23,1468
398970,2015,4,8,21,29,37965
398980,2015,8,154,17,171,3094
399000,2015,5,26,15,41,47245
399040,2015,8,66,11,77,8738
399070,2015,8,280,42,322,14404
399140,2015,7,33,4,37,5238
399640,2015,8,354,21,375,19170
399670,2015,8,2028,287,2315,110360
399790,2015,5,384,395,779,215948
399890,2015,6,137,38,175,32135
399910,2015,7,40,3,43,14646
399920,2015,5,22,14,36,7054
400130,2015,5,8,5,13,527
400160,2015,8,284,28,312,23635
400170,2015,6,1010,377,1387,184404
400200,2015,5,52,24,76,3186
400380,2015,5,9,11,20,16447
400580,2015,8,141,9,150,11211
400660,2015,8,325,34,359,22576
401120,2015,8,52,8,60,10262
401190,2015,5,1566,873,2439,129812
401290,2015,7,42,3,45,1796
401330,2015,5,32,17,49,2383
401840,2015,8,62,14,76,13199
402020,2015,6,1523,651,2174,66541
402030,2015,5,40,18,58,3962
402120,2015,8,227,40,267,19603
402160,2015,5,152,126,278,7872
402170,2015,5,26,31,57,51628
402300,2015,5,42,22,64,4589
402390,2015,7,20,3,23,2797
402670,2015,5,11,15,26,1625
402840,2015,8,1591,304,1895,379611
403070,2015,7,30,3,33,1507
403120,2015,6,155,62,217,45340
403180,2015,8,170,37,207,36322
403190,2015,6,3793,1101,4894,361192
403200,2015,4,19,44,63,455
403230,2015,7,15,3,18,1008
403510,2015,6,143,37,180,27325
403680,2015,5,6,8,14,424
403700,2015,8,190,30,220,10509
403780,2015,7,31,1,32,2173
403830,2015,8,228,13,241,9927
403880,2015,5,44,37,81,9365
404030,2015,7,19,1,20,2622
404050,2015,5,95,42,137,16342
404100,2015,7,29,6,35,1957
404580,2015,5,80,36,116,16901
404660,2015,5,19,9,28,18612
404860,2015,7,17,4,21,2402
405610,2015,5,160,128,288,85532
405650,2015,8,154,38,192,11253
405780,2015,6,101,38,139,6345
405820,2015,9,1387,60,1447,75696
405950,2015,8,361,23,384,76293
406150,2015,9,9772,472,10244,205520
406650,2015,6,39,11,50,3559
406730,2015,5,35,28,63,29760
406920,2015,7,24,1,25,1075
407020,2015,8,133,32,165,9837
407230,2015,6,381,155,536,254231
407290,2015,6,83,28,111,12852
407300,2015,6,393,101,494,41424
407380,2015,7,35,1,36,2628
407420,2015,5,227,264,491,3497
407600,2015,5,29,28,57,2931
407620,2015,5,73,81,154,8541
407680,2015,5,58,34,92,25982
408000,2015,8,221,52,273,16840
408170,2015,7,21,1,22,685
408280,2015,8,597,94,691,16801
408400,2015,8,49,11,60,1896
408750,2015,7,23,5,28,8851
408770,2015,6,86,35,121,9571
409070,2015,6,21,8,29,6433
409100,2015,8,750,125,875,39880
409160,2015,8,6829,448,7277,387663
409360,2015,5,21,11,32,1030
409370,2015,5,15,11,26,5364
409380,2015,8,190,32,222,50302
409450,2015,8,305,49,354,30224
409510,2015,4,507,1137,1644,235724
409600,2015,6,70,28,98,52889
410110,2015,8,2402,437,2839,221369
410150,2015,7,32,3,35,4248
410430,2015,6,347,120,467,27957
410440,2015,6,31,8,39,5844
410470,2015,6,11,3,14,2484
410850,2015,5,634,289,923,60732
410890,2015,8,255,9,264,28301
410910,2015,7,20,4,24,2626
411390,2015,7,11,1,12,1440
411560,2015,8,984,155,1139,78406
411570,2015,8,102,10,112,6903
411590,2015,8,60,11,71,3983
411630,2015,5,7,6,13,338
411680,2015,8,49,9,58,5442
411690,2015,5,12,6,18,1260
411760,2015,8,233,41,274,21774
412010,2015,5,21,11,32,914
412170,2015,6,176,51,227,300130
412230,2015,6,40,12,52,6172
412250,2015,5,15,10,25,5548
412270,2015,8,69,10,79,7377
412410,2015,5,31,18,49,2585
412520,2015,6,228,61,289,16747
412670,2015,8,187,4,191,10841
412730,2015,4,48,87,135,10660
412770,2015,8,246,48,294,26400
412970,2015,5,9,5,14,674
413490,2015,5,6,5,11,107
413680,2015,5,136,63,199,15124
413710,2015,5,480,328,808,69108
413760,2015,5,13,19,32,1168
414060,2015,5,10,11,21,3330
414260,2015,6,24,9,33,2345
414660,2015,8,232,36,268,32897
414950,2015,6,96,38,134,6419
415030,2015,6,339,96,435,55894
415400,2015,8,146,28,174,8296
415420,2015,8,1188,83,1271,66370
415830,2015,8,50,6,56,51907
415850,2015,8,211,39,250,11118
415890,2015,5,10,10,20,1980
415910,2015,7,39,4,43,4442
415920,2015,8,96,3,99,2392
415990,2015,7,19,3,22,1479
416130,2015,6,1567,433,2000,433025
416260,2015,4,17,43,60,1462
416290,2015,5,21,25,46,12815
416350,2015,5,24,29,53,17448
416370,2015,5,37,25,62,20130
416380,2015,6,71,22,93,6348
416550,2015,8,117,9,126,9322
416630,2015,5,45,52,97,13835
416640,2015,6,85,23,108,7163
416670,2015,5,164,132,296,35451
416770,2015,8,478,38,516,27127
417060,2015,5,10,6,16,2776
417350,2015,3,1,9,10,255
417860,2015,8,22767,2904,25671,1689541
417980,2015,8,44,9,53,6636
417990,2015,8,293,72,365,8473
418040,2015,8,421,36,457,31245
418110,2015,6,115,44,159,20945
418150,2015,8,102,20,122,5983
418160,2015,7,38,8,46,114665
418300,2015,8,305,43,348,21925
418310,2015,5,13,9,22,37003
418910,2015,5,86,65,151,12114
419090,2015,8,41,9,50,18191
419500,2015,8,51,3,54,20300
420070,2015,5,56,27,83,7200
420270,2015,5,67,45,112,15201
420740,2015,8,1181,110,1291,127552
420770,2015,6,121,37,158,20548
421260,2015,8,95,3,98,8234
421630,2015,8,112,4,116,5551
421810,2015,6,235,73,308,25907
421890,2015,5,24,18,42,1720
421900,2015,5,24,15,39,4506
422250,2015,5,275,200,475,221079
423120,2015,8,193,22,215,8663
423320,2015,8,64,15,79,6836
423440,2015,7,32,2,34,2376
423740,2015,6,25,10,35,5647
423880,2015,8,5747,648,6395,21187
424060,2015,4,8,13,21,1109
424170,2015,6,37,10,47,6039
424210,2015,6,11,3,14,1919
424750,2015,7,9,1,10,183
426330,2015,8,121,13,134,8355
426590,2015,5,34,29,63,1820
427780,2015,6,231,61,292,55706
428040,2015,7,19,1,20,1247
428460,2015,7,35,5,40,4151
428510,2015,6,34,10,44,44601
428760,2015,5,22,19,41,7584
429470,2015,8,665,96,761,198916
429950,2015,4,17,46,63,35072
691630,2015,6,71,28,99,3355
